user_id,Recency,Frequency,Monetary,R,F,M,RFM_Score
1515915625353286099,149,1,119.03,1,1,3,5
1515915625353457259,153,1,55.16,1,1,2,4
1515915625353534622,146,3,57.150000000000006,1,3,2,6
1515915625353561691,96,2,345.72,2,2,4,8
1515915625353900095,137,2,57.85,1,2,2,5
1515915625354176736,153,1,236.97,1,1,3,5
1515915625354561351,150,3,155.04,1,3,3,7
1515915625354822642,98,1,120.27,2,1,3,6
1515915625354857951,102,2,210.28,2,2,3,7
1515915625355179497,117,3,271.59000000000003,1,3,3,7
1515915625355398801,90,3,140.76,2,3,3,8
1515915625355421833,147,1,26.46,1,1,1,3
1515915625355635314,99,1,9.84,2,1,1,4
1515915625355805313,101,9,2762.2400000000002,2,4,4,10
1515915625355947830,146,1,25.7,1,1,1,3
1515915625356051774,154,1,43.11,1,1,2,4
1515915625356175149,111,2,1005.74,2,2,4,8
1515915625356207586,117,1,97.46,1,1,3,5
1515915625356582255,152,1,17.19,1,1,1,3
1515915625356679194,108,1,59.32,2,1,2,5
1515915625357004601,152,1,23.57,1,1,1,3
1515915625357132768,152,1,49.57,1,1,2,4
1515915625357619595,132,1,5.0,1,1,1,3
1515915625357781243,156,1,75.67,1,1,2,4
1515915625358197368,152,1,32.22,1,1,1,3
1515915625358482476,158,1,19.49,1,1,1,3
1515915625358835858,146,1,21.75,1,1,1,3
1515915625358848040,140,2,52.38,1,2,2,5
1515915625359453928,108,1,193.54,2,1,3,6
1515915625359833886,101,1,52.44,2,1,2,5
1515915625360911267,126,1,21.21,1,1,1,3
1515915625361197730,157,1,92.05,1,1,3,5
1515915625361283252,146,1,59.3,1,1,2,4
1515915625362073398,153,2,298.1,1,2,4,7
1515915625362094991,148,2,44.44,1,2,2,5
1515915625362159861,74,1,60.54,2,1,2,5
1515915625363018099,156,1,115.71,1,1,3,5
1515915625363419728,155,3,678.16,1,3,4,8
1515915625363633555,153,1,1062.89,1,1,4,6
1515915625363789844,147,1,257.87,1,1,3,5
1515915625364062846,112,5,649.03,2,4,4,10
1515915625364257701,146,3,163.49,1,3,3,7
1515915625364909178,111,1,23.17,2,1,1,4
1515915625365836405,152,1,96.35,1,1,3,5
1515915625365972094,152,1,122.86,1,1,3,5
1515915625366127971,145,1,86.4,1,1,2,4
1515915625366186412,155,1,43.11,1,1,2,4
1515915625367150883,153,5,475.62,1,4,4,9
1515915625367438020,137,2,151.06,1,2,3,6
1515915625367976920,76,1,38.75,2,1,2,5
1515915625368097063,146,1,26.46,1,1,1,3
1515915625368479327,119,5,376.45000000000005,1,4,4,9
1515915625368532072,104,4,104.76,2,3,3,8
1515915625369332561,146,1,16.65,1,1,1,3
1515915625369530324,119,1,1209.98,1,1,4,6
1515915625370042064,156,2,69.3,1,2,2,5
1515915625371158307,154,5,273.42,1,4,3,8
1515915625371361093,147,2,651.9,1,2,4,7
1515915625372644538,153,2,230.2,1,2,3,6
1515915625372908425,146,1,15.1,1,1,1,3
1515915625373009890,151,1,41.32,1,1,2,4
1515915625373342675,136,1,107.16,1,1,3,5
1515915625373568793,147,1,30.4,1,1,1,3
1515915625374448787,144,1,123.73,1,1,3,5
1515915625376375077,111,2,165.04,2,2,3,7
1515915625376498441,154,1,15.1,1,1,1,3
1515915625377197718,2,4,102.03,4,3,3,10
1515915625378826284,151,1,191.52,1,1,3,5
1515915625379210214,133,9,1039.79,1,4,4,9
1515915625381017320,93,2,308.64,2,2,4,8
1515915625382330267,49,3,331.89,3,3,4,10
1515915625382617834,150,2,25.4,1,2,1,4
1515915625382902566,154,2,70.2,1,2,2,5
1515915625383237543,26,2,5.72,4,2,1,7
1515915625384451066,135,2,43.019999999999996,1,2,2,5
1515915625384587594,147,1,73.24,1,1,2,4
1515915625384605151,148,1,105.78,1,1,3,5
1515915625384849425,121,2,38.98,1,2,2,5
1515915625385482819,142,8,454.56,1,4,4,9
1515915625385888878,143,10,247.3,1,4,3,8
1515915625386167902,150,1,258.97,1,1,3,5
1515915625386662653,153,1,277.1,1,1,3,5
1515915625387433440,153,1,192.86,1,1,3,5
1515915625387880220,128,4,372.09000000000003,1,3,4,8
1515915625388245854,149,1,19.68,1,1,1,3
1515915625389245441,146,1,243.29,1,1,3,5
1515915625390107328,151,10,1928.6000000000001,1,4,4,9
1515915625390920508,153,2,114.05000000000001,1,2,3,6
1515915625390924808,153,1,93.51,1,1,3,5
1515915625392222852,148,1,22.71,1,1,1,3
1515915625392941295,3,1,20.0,4,1,1,6
1515915625393261992,146,1,26.46,1,1,1,3
1515915625393382317,56,7,1457.71,3,4,4,11
1515915625394069939,72,1,249.02,3,1,3,7
1515915625394528052,116,1,41.75,1,1,2,4
1515915625394646788,145,1,11.9,1,1,1,3
1515915625394835285,154,4,70.48,1,3,2,6
1515915625395096356,134,3,227.01,1,3,3,7
1515915625395198150,156,1,41.75,1,1,2,4
1515915625397409054,153,1,21.02,1,1,1,3
1515915625397701103,146,1,17.62,1,1,1,3
1515915625397702169,149,1,54.78,1,1,2,4
1515915625398592313,147,1,31.43,1,1,1,3
1515915625400324256,140,1,149.7,1,1,3,5
1515915625401378765,152,5,1008.48,1,4,4,9
1515915625401433187,123,2,104.12,1,2,3,6
1515915625401563973,95,15,1762.61,2,4,4,10
1515915625403460003,141,3,421.89,1,3,4,8
1515915625404197931,134,1,115.71,1,1,3,5
1515915625405842034,156,1,107.79,1,1,3,5
1515915625407563599,145,1,43.11,1,1,2,4
1515915625408263671,68,2,80.84,3,2,2,7
1515915625408356834,117,1,55.87,1,1,2,4
1515915625408839802,110,2,136.82,2,2,3,7
1515915625409829783,148,2,655.56,1,2,4,7
1515915625409885754,153,1,9.35,1,1,1,3
1515915625410010194,152,1,42.17,1,1,2,4
1515915625410136555,91,1,21.59,2,1,1,4
1515915625410728920,158,1,14.48,1,1,1,3
1515915625411103417,4,1,344.11,4,1,4,9
1515915625411434590,145,1,16.05,1,1,1,3
1515915625413257995,143,3,69.09,1,3,2,6
1515915625413484349,78,1,73.81,2,1,2,5
1515915625415474736,109,13,3771.67,2,4,4,10
1515915625416060874,118,4,54.48,1,3,2,6
1515915625416649074,153,2,151.34,1,2,3,6
1515915625419970935,137,3,20.37,1,3,1,5
1515915625420104051,157,1,139.86,1,1,3,5
1515915625420145821,138,1,13.29,1,1,1,3
1515915625420716242,117,1,69.08,1,1,2,4
1515915625420909332,157,1,23.4,1,1,1,3
1515915625421333363,146,1,93.4,1,1,3,5
1515915625422203509,156,3,109.31,1,3,3,7
1515915625423620207,146,1,50.32,1,1,2,4
1515915625423788629,9,3,852.9000000000001,4,3,4,11
1515915625423895828,154,2,30.2,1,2,1,4
1515915625425059411,147,5,408.44,1,4,4,9
1515915625427437146,94,1,187.29,2,1,3,6
1515915625428438380,78,1,31.75,2,1,1,4
1515915625430934156,157,2,64.74,1,2,2,5
1515915625431723268,133,2,147.3,1,2,3,6
1515915625432436912,157,1,22.48,1,1,1,3
1515915625432636868,147,3,57.150000000000006,1,3,2,6
1515915625432648860,110,3,465.29999999999995,2,3,4,9
1515915625433260957,137,2,95.8,1,2,3,6
1515915625433262170,148,1,32.22,1,1,1,3
1515915625433494974,145,1,209.4,1,1,3,5
1515915625433660999,48,1,38.44,3,1,2,6
1515915625433847045,153,1,27.62,1,1,1,3
1515915625434896421,103,1,80.03,2,1,2,5
1515915625436259682,152,1,240.11,1,1,3,5
1515915625438177075,144,1,20.32,1,1,1,3
1515915625438232064,148,1,86.76,1,1,2,4
1515915625439475378,147,3,129.32999999999998,1,3,3,7
1515915625440681960,145,1,57.62,1,1,2,4
1515915625442200990,135,1,218.11,1,1,3,5
1515915625442519230,147,2,86.22,1,2,2,5
1515915625444523168,151,1,43.11,1,1,2,4
1515915625445030226,116,1,9.21,1,1,1,3
1515915625445142086,91,1,259.38,2,1,3,6
1515915625445971424,131,2,18.42,1,2,1,4
1515915625446257195,157,5,429.6,1,4,4,9
1515915625447095000,92,2,128.96,2,2,3,7
1515915625447652053,152,1,30.16,1,1,1,3
1515915625448784458,108,2,22.26,2,2,1,5
1515915625449531064,155,2,310.2,1,2,4,7
1515915625450328730,113,4,1918.04,2,3,4,9
1515915625450420744,148,2,122.26,1,2,3,6
1515915625450683751,157,1,357.35,1,1,4,6
1515915625450826262,146,1,30.0,1,1,1,3
1515915625451779549,146,4,468.04,1,3,4,8
1515915625452396195,140,1,25.24,1,1,1,3
1515915625453733905,149,2,56.22,1,2,2,5
1515915625453911815,109,1,60.54,2,1,2,5
1515915625454237078,158,1,41.94,1,1,2,4
1515915625454349734,130,1,13.48,1,1,1,3
1515915625454960223,148,4,459.32,1,3,4,8
1515915625455846276,157,2,86.22,1,2,2,5
1515915625457059599,120,1,111.27,1,1,3,5
1515915625458303287,155,6,65.72,1,4,2,7
1515915625458583458,147,1,16.19,1,1,1,3
1515915625459404369,152,1,210.9,1,1,3,5
1515915625460540267,142,1,41.43,1,1,2,4
1515915625461208186,152,1,204.29,1,1,3,5
1515915625461593155,133,9,3020.8,1,4,4,9
1515915625462038992,120,3,259.44,1,3,3,7
1515915625462138414,150,2,37.26,1,2,2,5
1515915625462335572,147,1,57.14,1,1,2,4
1515915625464284084,134,2,214.32,1,2,3,6
1515915625465639142,118,4,817.16,1,3,4,8
1515915625465740126,102,6,628.26,2,4,4,10
1515915625466016884,158,1,204.29,1,1,3,5
1515915625466195424,142,3,210.51,1,3,3,7
1515915625466235566,150,2,317.89,1,2,4,7
1515915625466366854,152,1,192.86,1,1,3,5
1515915625467000819,114,2,400.7,1,2,4,7
1515915625467132635,130,1,15.7,1,1,1,3
1515915625467267855,154,4,124.75999999999999,1,3,3,7
1515915625467421823,150,4,496.42999999999995,1,3,4,8
1515915625467827145,127,4,612.2,1,3,4,8
1515915625467951113,109,2,406.04,2,2,4,8
1515915625468335169,45,1,49.84,3,1,2,6
1515915625468568154,144,1,16.19,1,1,1,3
1515915625468583481,146,1,187.78,1,1,3,5
1515915625469269159,148,2,64.44,1,2,2,5
1515915625469270684,32,6,1254.3000000000002,4,4,4,12
1515915625469806973,148,3,510.0,1,3,4,8
1515915625470057771,150,3,476.13,1,3,4,8
1515915625470179176,155,1,50.79,1,1,2,4
1515915625470625172,155,1,18.19,1,1,1,3
1515915625470995608,158,1,33.08,1,1,2,4
1515915625471945634,132,3,221.37,1,3,3,7
1515915625472056936,150,1,26.98,1,1,1,3
1515915625472101004,151,2,107.8,1,2,3,6
1515915625472598226,152,1,309.21,1,1,4,6
1515915625472777985,105,1,259.94,2,1,3,6
1515915625472832380,155,2,57.78,1,2,2,5
1515915625473326905,105,3,183.48,2,3,3,8
1515915625473590169,154,2,107.02,1,2,3,6
1515915625473899890,75,3,52.38,2,3,2,7
1515915625473938034,145,6,1951.5,1,4,4,9
1515915625473996480,104,1,85.62,2,1,2,5
1515915625474108059,157,1,25.08,1,1,1,3
1515915625474259296,153,2,350.1,1,2,4,7
1515915625474287927,68,2,182.8,3,2,3,8
1515915625474785243,146,1,15.08,1,1,1,3
1515915625474888347,126,5,1111.57,1,4,4,9
1515915625475025856,144,2,957.5,1,2,4,7
1515915625475083496,148,4,817.16,1,3,4,8
1515915625475606110,15,2,65.96,4,2,2,8
1515915625475652424,154,2,19.68,1,2,1,4
1515915625476087754,145,2,128.96,1,2,3,6
1515915625476168209,142,4,375.6,1,3,4,8
1515915625476588533,136,1,72.38,1,1,2,4
1515915625476662868,42,2,32.38,3,2,2,7
1515915625476932116,150,2,97.46,1,2,3,6
1515915625476938288,154,1,13.02,1,1,1,3
1515915625476991896,148,1,257.87,1,1,3,5
1515915625477767168,151,1,154.78,1,1,3,5
1515915625478408904,140,1,204.29,1,1,3,5
1515915625479288963,151,1,41.27,1,1,2,4
1515915625479434403,153,1,59.95,1,1,2,4
1515915625479832144,78,1,41.52,2,1,2,5
1515915625479966700,117,3,37.769999999999996,1,3,2,6
1515915625480686209,33,1,43.89,4,1,2,7
1515915625480784302,128,1,35.25,1,1,2,4
1515915625480940320,125,1,80.67,1,1,2,4
1515915625481156621,115,1,147.87,1,1,3,5
1515915625481244678,152,1,175.56,1,1,3,5
1515915625481367404,91,2,143.18,2,2,3,7
1515915625481681679,91,2,59.36,2,2,2,6
1515915625481706156,144,2,294.42,1,2,4,7
1515915625482081016,149,1,445.14,1,1,4,6
1515915625482383745,120,2,280.51,1,2,3,6
1515915625483402054,110,11,691.81,2,4,4,10
1515915625483595665,156,1,31.59,1,1,1,3
1515915625484505146,153,1,325.95,1,1,4,6
1515915625485572958,143,2,191.8,1,2,3,6
1515915625486235716,47,2,37.78,3,2,2,7
1515915625486256855,108,1,629.95,2,1,4,7
1515915625486409945,128,1,204.29,1,1,3,5
1515915625486521695,147,3,32.519999999999996,1,3,2,6
1515915625486764209,147,1,48.84,1,1,2,4
1515915625492451814,111,3,412.89,2,3,4,9
1515915625492654760,149,1,257.87,1,1,3,5
1515915625492846959,95,3,264.96,2,3,3,8
1515915625492851884,133,4,344.64,1,3,4,8
1515915625493306533,154,2,122.54,1,2,3,6
1515915625493549689,144,1,16.19,1,1,1,3
1515915625494770987,150,1,134.13,1,1,3,5
1515915625495521173,149,1,10.21,1,1,1,3
1515915625495744028,147,2,98.82,1,2,3,6
1515915625496075071,91,1,205.25,2,1,3,6
1515915625496832955,49,2,515.74,3,2,4,9
1515915625497051174,138,2,609.27,1,2,4,7
1515915625497203757,157,2,51.14,1,2,2,5
1515915625497266977,154,2,151.54000000000002,1,2,3,6
1515915625497290091,156,2,33.78,1,2,2,5
1515915625497826743,158,1,29.52,1,1,1,3
1515915625498093228,133,6,599.52,1,4,4,9
1515915625498133966,153,1,424.48,1,1,4,6
1515915625498376282,124,1,86.51,1,1,2,4
1515915625498875482,10,1,125.86,4,1,3,8
1515915625499086948,146,1,325.25,1,1,4,6
1515915625499087051,150,1,325.25,1,1,4,6
1515915625499632814,146,2,118.27000000000001,1,2,3,6
1515915625499716754,157,1,151.75,1,1,3,5
1515915625500018456,148,1,478.75,1,1,4,6
1515915625500191972,150,1,416.56,1,1,4,6
1515915625501202238,156,1,11.65,1,1,1,3
1515915625503751892,153,4,143.48,1,3,3,7
1515915625503814049,137,1,32.7,1,1,2,4
1515915625503895207,140,2,172.04000000000002,1,2,3,6
1515915625504063355,144,6,1196.22,1,4,4,9
1515915625504663389,137,1,58.11,1,1,2,4
1515915625504784533,14,5,369.05,4,4,4,12
1515915625504813192,122,1,50.6,1,1,2,4
1515915625505008297,153,3,466.29,1,3,4,8
1515915625505559373,154,1,90.63,1,1,2,4
1515915625505654593,146,2,18.81,1,2,1,4
1515915625506619696,29,2,28.34,4,2,1,7
1515915625506722711,153,5,384.90000000000003,1,4,4,9
1515915625506781679,151,1,26.35,1,1,1,3
1515915625506864547,144,1,314.68,1,1,4,6
1515915625506903608,144,12,572.4,1,4,4,9
1515915625507114184,138,2,498.04,1,2,4,7
1515915625507426385,157,1,284.46,1,1,3,5
1515915625507556338,145,2,12.86,1,2,1,4
1515915625507596879,42,3,3900.12,3,3,4,10
1515915625507618984,153,2,58.44,1,2,2,5
1515915625507754425,139,4,415.32,1,3,4,8
1515915625508051478,155,1,14.86,1,1,1,3
1515915625508240652,150,1,51.27,1,1,2,4
1515915625508374573,146,1,21.75,1,1,1,3
1515915625508403543,152,1,10.43,1,1,1,3
1515915625508703225,156,2,65.08,1,2,2,5
1515915625508770501,125,1,196.67,1,1,3,5
1515915625508849099,146,1,15.08,1,1,1,3
1515915625509272045,144,1,127.08,1,1,3,5
1515915625509375068,128,1,16.19,1,1,1,3
1515915625509470353,145,1,215.4,1,1,3,5
1515915625509504933,145,6,125.69999999999999,1,4,3,8
1515915625509561819,130,2,64.92,1,2,2,5
1515915625509562082,152,1,39.51,1,1,2,4
1515915625509677596,71,1,11.43,3,1,1,5
1515915625509729436,149,1,60.06,1,1,2,4
1515915625509808717,117,3,87.66,1,3,2,6
1515915625509890136,32,2,93.84,4,2,3,9
1515915625510154735,130,3,53.91,1,3,2,6
1515915625510314369,147,1,21.21,1,1,1,3
1515915625510452947,150,2,53.34,1,2,2,5
1515915625510668770,34,10,2546.1,4,4,4,12
1515915625510934233,36,1,349.46,3,1,4,8
1515915625511032339,146,5,78.8,1,4,2,7
1515915625511038054,148,1,92.02,1,1,3,5
1515915625511039745,153,1,75.67,1,1,2,4
1515915625511110840,144,1,552.78,1,1,4,6
1515915625511131358,141,2,110.16,1,2,3,6
1515915625511226919,154,2,23.8,1,2,1,4
1515915625511258041,153,3,323.37,1,3,4,8
1515915625511668201,138,1,449.51,1,1,4,6
1515915625512105360,114,1,34.44,1,1,2,4
1515915625512135812,120,1,10.48,1,1,1,3
1515915625512278322,58,1,124.13,3,1,3,7
1515915625512664069,112,2,24.92,2,2,1,5
1515915625513024514,2,4,436.54,4,3,4,11
1515915625513111960,156,1,12.43,1,1,1,3
1515915625513124938,152,1,17.89,1,1,1,3
1515915625513126445,140,4,924.96,1,3,4,8
1515915625513128295,140,2,462.48,1,2,4,7
1515915625513238969,149,1,140.63,1,1,3,5
1515915625513241084,148,2,86.22,1,2,2,5
1515915625513265653,150,1,23.49,1,1,1,3
1515915625513339762,54,2,594.32,3,2,4,9
1515915625513373329,137,3,225.87,1,3,3,7
1515915625513392808,151,1,12.92,1,1,1,3
1515915625513553892,146,4,52.68,1,3,2,6
1515915625513574486,158,5,616.75,1,4,4,9
1515915625513574581,158,1,123.35,1,1,3,5
1515915625513600866,126,8,667.64,1,4,4,9
1515915625513824086,156,2,43.1,1,2,2,5
1515915625514094094,145,1,36.35,1,1,2,4
1515915625514097612,149,1,204.29,1,1,3,5
1515915625514111411,147,1,11.62,1,1,1,3
1515915625514129744,151,1,26.46,1,1,1,3
1515915625514159533,111,1,29.68,2,1,1,4
1515915625514458321,153,1,137.63,1,1,3,5
1515915625514502228,145,2,37.14,1,2,2,5
1515915625514744695,146,1,43.11,1,1,2,4
1515915625514766440,105,4,1123.62,2,3,4,9
1515915625514870210,145,2,101.2,1,2,3,6
1515915625514902385,158,2,387.26,1,2,4,7
1515915625514944899,127,2,603.5799999999999,1,2,4,7
1515915625514969596,153,1,11.13,1,1,1,3
1515915625515080867,155,1,72.38,1,1,2,4
1515915625515148783,155,2,55.24,1,2,2,5
1515915625515223814,135,1,96.37,1,1,3,5
1515915625515318698,155,2,458.76,1,2,4,7
1515915625515426823,134,3,45.71,1,3,2,6
1515915625515455004,126,1,204.29,1,1,3,5
1515915625515476270,153,1,38.25,1,1,2,4
1515915625515574097,153,1,381.62,1,1,4,6
1515915625515626372,53,4,115.76,3,3,3,9
1515915625515698186,139,4,128.68,1,3,3,7
1515915625515708617,157,1,16.19,1,1,1,3
1515915625515983292,151,1,203.02,1,1,3,5
1515915625515985972,82,3,123.55000000000001,2,3,3,8
1515915625516160801,157,1,156.27,1,1,3,5
1515915625516166909,132,1,21.9,1,1,1,3
1515915625516258447,116,1,29.22,1,1,1,3
1515915625516312135,146,1,204.29,1,1,3,5
1515915625516323491,51,1,418.48,3,1,4,8
1515915625516324855,148,1,204.29,1,1,3,5
1515915625516333925,145,1,204.29,1,1,3,5
1515915625516344878,154,1,45.24,1,1,2,4
1515915625516359835,104,5,1021.4499999999999,2,4,4,10
1515915625516373860,41,2,23.26,3,2,1,6
1515915625516401102,148,3,166.35,1,3,3,7
1515915625516401615,133,2,67.3,1,2,2,5
1515915625516422613,140,1,71.38,1,1,2,4
1515915625516424959,153,1,204.29,1,1,3,5
1515915625516434206,140,1,647.29,1,1,4,6
1515915625516447381,150,1,204.29,1,1,3,5
1515915625516465850,123,1,26.19,1,1,1,3
1515915625516476746,129,1,204.29,1,1,3,5
1515915625516477461,154,2,33.78,1,2,2,5
1515915625516490771,153,2,218.73,1,2,3,6
1515915625516508051,146,1,204.29,1,1,3,5
1515915625516609226,116,2,138.29000000000002,1,2,3,6
1515915625516673386,139,1,10.48,1,1,1,3
1515915625516711813,143,2,515.74,1,2,4,7
1515915625516722437,140,3,612.87,1,3,4,8
1515915625516724249,138,1,479.51,1,1,4,6
1515915625516729047,124,1,17.62,1,1,1,3
1515915625516731578,10,2,314.28,4,2,4,10
1515915625516747708,130,6,682.93,1,4,4,9
1515915625516747922,135,2,158.62,1,2,3,6
1515915625516769072,146,3,221.43,1,3,3,7
1515915625516770938,152,2,136.74,1,2,3,6
1515915625516831655,74,2,30.16,2,2,1,5
1515915625516842178,96,1,16.98,2,1,1,4
1515915625516853587,145,1,21.75,1,1,1,3
1515915625516890932,69,1,65.08,3,1,2,6
1515915625516952270,77,4,56.50000000000001,2,3,2,7
1515915625516964063,127,1,61.43,1,1,2,4
1515915625517047900,35,2,457.58,4,2,4,10
1515915625517182992,127,1,29.22,1,1,1,3
1515915625517202747,131,1,15.32,1,1,1,3
1515915625517204454,59,2,81.26,3,2,2,7
1515915625517218106,153,1,47.49,1,1,2,4
1515915625517318899,108,1,130.0,2,1,3,6
1515915625517342761,123,1,45.24,1,1,2,4
1515915625517386797,117,1,179.94,1,1,3,5
1515915625517470003,149,1,68.57,1,1,2,4
1515915625517579630,100,2,735.9000000000001,2,2,4,8
1515915625517581806,158,1,26.46,1,1,1,3
1515915625517679329,36,1,61.16,3,1,2,6
1515915625517699110,118,1,46.67,1,1,2,4
1515915625517748115,140,3,198.29999999999998,1,3,3,7
1515915625517759569,154,1,75.67,1,1,2,4
1515915625517764150,133,1,167.62,1,1,3,5
1515915625517770257,157,1,50.11,1,1,2,4
1515915625517780037,107,3,26.369999999999997,2,3,1,6
1515915625517825350,148,1,163.52,1,1,3,5
1515915625517871720,110,4,119.56,2,3,3,8
1515915625517883203,132,3,165.48,1,3,3,7
1515915625517889944,3,1,58.25,4,1,2,7
1515915625517905050,157,3,892.23,1,3,4,8
1515915625517946481,150,1,12.62,1,1,1,3
1515915625518037933,125,1,314.97,1,1,4,6
1515915625518085006,131,4,314.23,1,3,4,8
1515915625518086046,142,5,543.23,1,4,4,9
1515915625518112609,124,2,268.26,1,2,3,6
1515915625518130982,158,2,178.44,1,2,3,6
1515915625518151432,135,1,14.29,1,1,1,3
1515915625518153762,144,2,472.0,1,2,4,7
1515915625518171389,46,1,33.97,3,1,2,6
1515915625518212316,122,1,12.46,1,1,1,3
1515915625518254444,145,2,110.48,1,2,3,6
1515915625518278964,143,5,1997.4,1,4,4,9
1515915625518286459,128,1,26.19,1,1,1,3
1515915625518289462,157,1,41.32,1,1,2,4
1515915625518296794,140,4,817.16,1,3,4,8
1515915625518370294,106,1,127.08,2,1,3,6
1515915625518390079,157,1,57.62,1,1,2,4
1515915625518413832,125,2,127.39,1,2,3,6
1515915625518435582,114,3,94.28999999999999,1,3,3,7
1515915625518472854,138,1,23.17,1,1,1,3
1515915625518482827,151,1,20.48,1,1,1,3
1515915625518560406,137,2,226.76,1,2,3,6
1515915625518570355,65,1,60.83,3,1,2,6
1515915625518585643,152,1,29.57,1,1,1,3
1515915625518591968,139,2,64.5,1,2,2,5
1515915625518696647,154,1,68.06,1,1,2,4
1515915625518710964,115,1,441.49,1,1,4,6
1515915625518820232,125,1,122.86,1,1,3,5
1515915625518836854,112,1,122.86,2,1,3,6
1515915625518837072,157,2,160.12,1,2,3,6
1515915625518887119,87,2,207.66,2,2,3,7
1515915625518894671,131,3,289.11,1,3,4,8
1515915625518900864,149,1,204.29,1,1,3,5
1515915625518901157,149,1,32.38,1,1,2,4
1515915625518901432,157,2,408.58,1,2,4,7
1515915625518946788,45,1,3267.06,3,1,4,8
1515915625518988628,144,3,773.61,1,3,4,8
1515915625519036980,145,1,50.6,1,1,2,4
1515915625519045356,158,3,220.82,1,3,3,7
1515915625519047102,134,2,151.54000000000002,1,2,3,6
1515915625519064114,157,2,191.36,1,2,3,6
1515915625519079553,134,2,160.7,1,2,3,6
1515915625519082162,157,3,1252.83,1,3,4,8
1515915625519107912,152,1,242.48,1,1,3,5
1515915625519140183,157,1,16.11,1,1,1,3
1515915625519218141,110,1,105.14,2,1,3,6
1515915625519245618,90,3,117.87,2,3,3,8
1515915625519258287,158,1,11.27,1,1,1,3
1515915625519259921,136,1,50.56,1,1,2,4
1515915625519289483,91,1,44.13,2,1,2,5
1515915625519301557,152,1,34.44,1,1,2,4
1515915625519344914,154,2,183.94,1,2,3,6
1515915625519356010,158,2,206.81,1,2,3,6
1515915625519390468,158,1,217.57,1,1,3,5
1515915625519397646,158,3,370.04999999999995,1,3,4,8
1515915625519399850,158,1,30.48,1,1,1,3
1515915625519401159,158,1,11.86,1,1,1,3
1515915625519403099,158,1,13.89,1,1,1,3
1515915625519406565,158,1,36.03,1,1,2,4
1515915625519406764,158,2,38.98,1,2,2,5
1515915625519407618,158,1,204.79,1,1,3,5
1515915625519417750,151,3,159.42000000000002,1,3,3,7
1515915625519426806,158,1,20.79,1,1,1,3
1515915625519427738,158,1,20.79,1,1,1,3
1515915625519432765,158,1,39.67,1,1,2,4
1515915625519436601,157,2,64.5,1,2,2,5
1515915625519439308,158,1,20.48,1,1,1,3
1515915625519440686,134,2,60.59,1,2,2,5
1515915625519454753,158,2,38.86,1,2,2,5
1515915625519463641,158,4,284.08,1,3,3,7
1515915625519470141,158,1,23.48,1,1,1,3
1515915625519470631,158,1,27.81,1,1,1,3
1515915625519473821,158,2,34.6,1,2,2,5
1515915625519475949,158,1,314.68,1,1,4,6
1515915625519477241,158,2,36.82,1,2,2,5
1515915625519477888,158,1,59.54,1,1,2,4
1515915625519487094,158,1,479.52,1,1,4,6
1515915625519489782,158,1,177.59,1,1,3,5
1515915625519491915,158,1,479.52,1,1,4,6
1515915625519492150,158,1,18.89,1,1,1,3
1515915625519494549,158,2,19.88,1,2,1,4
1515915625519495049,158,1,122.86,1,1,3,5
1515915625519495480,149,5,5489.08,1,4,4,9
1515915625519498076,158,1,58.25,1,1,2,4
1515915625519498155,152,4,69.2,1,3,2,6
1515915625519502747,158,1,86.37,1,1,2,4
1515915625519506935,158,2,25.4,1,2,1,4
1515915625519511621,158,1,36.59,1,1,2,4
1515915625519516622,158,1,23.81,1,1,1,3
1515915625519522275,158,1,15.24,1,1,1,3
1515915625519526765,158,2,245.72,1,2,3,6
1515915625519527229,158,3,50.489999999999995,1,3,2,6
1515915625519531830,158,1,32.92,1,1,2,4
1515915625519539652,158,1,15.16,1,1,1,3
1515915625519543855,144,1,10.13,1,1,1,3
1515915625519547708,158,1,26.46,1,1,1,3
1515915625519566682,157,1,32.7,1,1,2,4
1515915625519570694,156,1,140.63,1,1,3,5
1515915625519575396,155,2,31.42,1,2,1,4
1515915625519577089,145,1,2.86,1,1,1,3
1515915625519577424,157,1,22.68,1,1,1,3
1515915625519581197,157,1,204.79,1,1,3,5
1515915625519584585,157,1,261.4,1,1,3,5
1515915625519586523,157,1,118.57,1,1,3,5
1515915625519587464,157,1,26.19,1,1,1,3
1515915625519590394,157,1,9.35,1,1,1,3
1515915625519591681,157,3,455.25,1,3,4,8
1515915625519597429,157,1,30.14,1,1,1,3
1515915625519597534,157,1,75.67,1,1,2,4
1515915625519601763,157,2,54.510000000000005,1,2,2,5
1515915625519605201,157,1,55.16,1,1,2,4
1515915625519607534,157,1,2.86,1,1,1,3
1515915625519609613,157,1,18.1,1,1,1,3
1515915625519610130,157,1,33.9,1,1,2,4
1515915625519615558,157,1,55.87,1,1,2,4
1515915625519620661,157,2,52.34,1,2,2,5
1515915625519621085,157,2,503.84,1,2,4,7
1515915625519622769,157,1,17.25,1,1,1,3
1515915625519623456,157,1,110.03,1,1,3,5
1515915625519630660,157,1,10.14,1,1,1,3
1515915625519631285,157,2,83.84,1,2,2,5
1515915625519631988,157,1,24.76,1,1,1,3
1515915625519637881,157,3,335.52,1,3,4,8
1515915625519638486,157,1,64.48,1,1,2,4
1515915625519640298,157,1,20.16,1,1,1,3
1515915625519644907,157,1,13.97,1,1,1,3
1515915625519645266,157,1,25.71,1,1,1,3
1515915625519645639,157,2,51.42,1,2,2,5
1515915625519646464,157,1,50.27,1,1,2,4
1515915625519652637,136,1,50.37,1,1,2,4
1515915625519653457,157,1,793.49,1,1,4,6
1515915625519653795,157,1,66.03,1,1,2,4
1515915625519662750,157,1,13.17,1,1,1,3
1515915625519665345,157,2,86.22,1,2,2,5
1515915625519672140,157,2,196.74,1,2,3,6
1515915625519677243,150,1,15.43,1,1,1,3
1515915625519680105,157,3,420.33000000000004,1,3,4,8
1515915625519680971,157,3,39.51,1,3,2,6
1515915625519683887,157,2,83.8,1,2,2,5
1515915625519685961,157,1,115.0,1,1,3,5
1515915625519686118,157,1,12.06,1,1,1,3
1515915625519687218,157,1,57.46,1,1,2,4
1515915625519690209,157,2,24.16,1,2,1,4
1515915625519692031,156,2,38.74,1,2,2,5
1515915625519695489,157,1,32.17,1,1,1,3
1515915625519703604,155,2,221.13,1,2,3,6
1515915625519703999,157,2,29.22,1,2,1,4
1515915625519705162,157,1,27.32,1,1,1,3
1515915625519715781,129,2,752.79,1,2,4,7
1515915625519721864,157,2,314.03,1,2,4,7
1515915625519724580,157,1,26.19,1,1,1,3
1515915625519726059,136,2,4.59,1,2,1,4
1515915625519731512,157,1,9.35,1,1,1,3
1515915625519731655,157,1,16.19,1,1,1,3
1515915625519735038,157,1,12.22,1,1,1,3
1515915625519736345,157,1,142.38,1,1,3,5
1515915625519739382,157,1,10.43,1,1,1,3
1515915625519739637,157,4,41.68,1,3,2,6
1515915625519741402,157,3,66.63,1,3,2,6
1515915625519742568,157,1,10.43,1,1,1,3
1515915625519756152,157,1,65.16,1,1,2,4
1515915625519756191,151,2,214.66,1,2,3,6
1515915625519762021,99,5,784.12,2,4,4,10
1515915625519765122,157,2,12.16,1,2,1,4
1515915625519766634,156,1,38.73,1,1,2,4
1515915625519768447,157,1,22.22,1,1,1,3
1515915625519777433,157,1,21.43,1,1,1,3
1515915625519791861,157,2,39.84,1,2,2,5
1515915625519796425,157,1,29.57,1,1,1,3
1515915625519798961,157,1,204.29,1,1,3,5
1515915625519802000,157,1,126.68,1,1,3,5
1515915625519803520,155,1,24.68,1,1,1,3
1515915625519806544,157,1,15.87,1,1,1,3
1515915625519819720,157,1,104.86,1,1,3,5
1515915625519835769,157,1,8.59,1,1,1,3
1515915625519841283,157,1,15.08,1,1,1,3
1515915625519842619,157,1,19.37,1,1,1,3
1515915625519843522,157,1,57.14,1,1,2,4
1515915625519844384,157,1,57.14,1,1,2,4
1515915625519861582,153,4,257.92,1,3,3,7
1515915625519871369,156,1,53.06,1,1,2,4
1515915625519872813,156,3,174.79000000000002,1,3,3,7
1515915625519876913,156,1,15.08,1,1,1,3
1515915625519880892,156,1,83.02,1,1,2,4
1515915625519881862,156,1,18.57,1,1,1,3
1515915625519884688,156,3,62.849999999999994,1,3,2,6
1515915625519890231,156,1,23.57,1,1,1,3
1515915625519890298,156,1,11.22,1,1,1,3
1515915625519890377,156,1,123.35,1,1,3,5
1515915625519895052,151,1,51.68,1,1,2,4
1515915625519896823,156,1,72.38,1,1,2,4
1515915625519896903,156,1,29.52,1,1,1,3
1515915625519900321,155,1,184.13,1,1,3,5
1515915625519905171,120,1,11.27,1,1,1,3
1515915625519905197,156,1,63.98,1,1,2,4
1515915625519912678,110,2,30.16,2,2,1,5
1515915625519912906,156,2,18.7,1,2,1,4
1515915625519915919,156,2,69.57,1,2,2,5
1515915625519918222,156,1,167.94,1,1,3,5
1515915625519918512,156,1,229.38,1,1,3,5
1515915625519920599,156,1,57.62,1,1,2,4
1515915625519920949,156,1,57.62,1,1,2,4
1515915625519928515,156,1,26.98,1,1,1,3
1515915625519933981,122,9,681.03,1,4,4,9
1515915625519948239,156,1,19.43,1,1,1,3
1515915625519948506,156,1,32.22,1,1,1,3
1515915625519949698,156,9,138.96,1,4,3,8
1515915625519956133,156,2,64.44,1,2,2,5
1515915625519959649,156,1,83.17,1,1,2,4
1515915625519960362,156,3,609.0600000000001,1,3,4,8
1515915625519965712,156,1,32.95,1,1,2,4
1515915625519966319,156,1,203.02,1,1,3,5
1515915625519969728,95,1,36.86,2,1,2,5
1515915625519991781,154,4,43.18,1,3,2,6
1515915625519995261,156,6,842.51,1,4,4,9
1515915625520000581,120,1,72.59,1,1,2,4
1515915625520025059,156,1,103.83,1,1,3,5
1515915625520025806,118,1,164.33,1,1,3,5
1515915625520028849,156,1,43.11,1,1,2,4
1515915625520029145,156,3,172.85999999999999,1,3,3,7
1515915625520029972,156,2,290.8,1,2,4,7
1515915625520029989,156,1,29.57,1,1,1,3
1515915625520030557,156,1,58.25,1,1,2,4
1515915625520037537,156,2,111.74,1,2,3,6
1515915625520037968,155,3,105.30000000000001,1,3,3,7
1515915625520038560,156,1,45.24,1,1,2,4
1515915625520042035,156,1,87.14,1,1,2,4
1515915625520045457,156,1,10.46,1,1,1,3
1515915625520049345,156,1,104.86,1,1,3,5
1515915625520055381,156,2,30.16,1,2,1,4
1515915625520057192,156,3,1759.62,1,3,4,8
1515915625520057451,156,1,9.35,1,1,1,3
1515915625520057636,156,1,586.54,1,1,4,6
1515915625520058781,156,1,26.19,1,1,1,3
1515915625520066835,156,2,390.4,1,2,4,7
1515915625520067796,156,1,9.35,1,1,1,3
1515915625520068159,156,2,428.2,1,2,4,7
1515915625520070184,156,3,1941.87,1,3,4,8
1515915625520070468,140,1,87.16,1,1,2,4
1515915625520071259,155,1,8.7,1,1,1,3
1515915625520077333,156,3,25.77,1,3,1,5
1515915625520079410,108,1,21.9,2,1,1,4
1515915625520088524,132,1,78.3,1,1,2,4
1515915625520088544,156,1,16.19,1,1,1,3
1515915625520096701,156,1,204.29,1,1,3,5
1515915625520116294,150,4,116.86,1,3,3,7
1515915625520122399,155,2,32.7,1,2,2,5
1515915625520127803,155,1,21.43,1,1,1,3
1515915625520143703,155,1,22.54,1,1,1,3
1515915625520152405,80,1,16.35,2,1,1,4
1515915625520160214,155,1,27.84,1,1,1,3
1515915625520166830,155,3,261.42,1,3,3,7
1515915625520167554,155,5,226.75,1,4,3,8
1515915625520168475,155,2,155.46,1,2,3,6
1515915625520169166,155,1,1.57,1,1,1,3
1515915625520171216,155,3,460.07,1,3,4,8
1515915625520174925,152,3,403.38,1,3,4,8
1515915625520174997,155,1,9.35,1,1,1,3
1515915625520175322,153,12,139.26,1,4,3,8
1515915625520180338,155,2,224.44,1,2,3,6
1515915625520180922,155,1,10.02,1,1,1,3
1515915625520181207,155,2,27.72,1,2,1,4
1515915625520185806,155,3,460.07,1,3,4,8
1515915625520188055,155,1,46.98,1,1,2,4
1515915625520190690,155,1,12.94,1,1,1,3
1515915625520191157,147,3,243.42000000000002,1,3,3,7
1515915625520195009,155,1,28.41,1,1,1,3
1515915625520197149,155,1,37.51,1,1,2,4
1515915625520199233,137,1,46.67,1,1,2,4
1515915625520202092,155,1,13.02,1,1,1,3
1515915625520205065,153,1,56.27,1,1,2,4
1515915625520205740,132,1,204.29,1,1,3,5
1515915625520208683,155,1,23.65,1,1,1,3
1515915625520209626,155,1,63.98,1,1,2,4
1515915625520210793,155,1,15.08,1,1,1,3
1515915625520215075,155,2,619.9699999999999,1,2,4,7
1515915625520226587,155,2,237.14,1,2,3,6
1515915625520227072,154,3,441.59000000000003,1,3,4,8
1515915625520230306,154,4,173.32,1,3,3,7
1515915625520234208,155,1,590.6,1,1,4,6
1515915625520235046,155,1,46.83,1,1,2,4
1515915625520240839,155,1,34.06,1,1,2,4
1515915625520242621,155,1,204.29,1,1,3,5
1515915625520253927,155,2,232.1,1,2,3,6
1515915625520256988,155,1,26.17,1,1,1,3
1515915625520260468,155,1,55.16,1,1,2,4
1515915625520267868,155,1,292.83,1,1,4,6
1515915625520269718,155,3,98.48,1,3,3,7
1515915625520270709,155,3,98.48,1,3,3,7
1515915625520271608,155,1,26.83,1,1,1,3
1515915625520276451,129,1,26.19,1,1,1,3
1515915625520277189,155,1,107.63,1,1,3,5
1515915625520277900,154,2,133.84,1,2,3,6
1515915625520280699,155,2,3.14,1,2,1,4
1515915625520283808,155,1,28.1,1,1,1,3
1515915625520284362,155,1,9.35,1,1,1,3
1515915625520286819,155,2,18.7,1,2,1,4
1515915625520294085,155,1,9.35,1,1,1,3
1515915625520298512,155,1,14.78,1,1,1,3
1515915625520301473,143,3,179.85000000000002,1,3,3,7
1515915625520303779,155,1,18.41,1,1,1,3
1515915625520307032,149,4,115.56,1,3,3,7
1515915625520307248,155,2,126.04,1,2,3,6
1515915625520308260,155,1,17.46,1,1,1,3
1515915625520308834,155,1,17.46,1,1,1,3
1515915625520310846,154,1,184.13,1,1,3,5
1515915625520312102,155,1,46.83,1,1,2,4
1515915625520312334,155,2,34.739999999999995,1,2,2,5
1515915625520321485,104,2,949.05,2,2,4,8
1515915625520337494,146,2,195.88,1,2,3,6
1515915625520342229,151,6,543.78,1,4,4,9
1515915625520352228,155,2,55.62,1,2,2,5
1515915625520355544,155,1,64.48,1,1,2,4
1515915625520373152,154,1,61.27,1,1,2,4
1515915625520379618,154,1,118.57,1,1,3,5
1515915625520391829,153,2,38.1,1,2,2,5
1515915625520395279,153,1,106.19,1,1,3,5
1515915625520395732,154,1,81.54,1,1,2,4
1515915625520402151,154,2,105.08,1,2,3,6
1515915625520405339,154,1,43.11,1,1,2,4
1515915625520410677,154,1,1.57,1,1,1,3
1515915625520413119,154,5,88.10000000000001,1,4,2,7
1515915625520420110,154,1,292.83,1,1,4,6
1515915625520420291,154,2,79.85,1,2,2,5
1515915625520421469,154,1,55.08,1,1,2,4
1515915625520425942,154,1,33.97,1,1,2,4
1515915625520433043,154,1,17.89,1,1,1,3
1515915625520436258,154,1,64.48,1,1,2,4
1515915625520437857,154,2,52.92,1,2,2,5
1515915625520438989,154,2,68.88,1,2,2,5
1515915625520440135,154,1,77.73,1,1,2,4
1515915625520443825,154,5,1299.7,1,4,4,9
1515915625520447507,154,1,292.83,1,1,4,6
1515915625520449790,154,3,63.63,1,3,2,6
1515915625520454351,154,1,193.63,1,1,3,5
1515915625520455166,154,2,86.22,1,2,2,5
1515915625520465789,154,1,18.57,1,1,1,3
1515915625520466764,154,1,77.73,1,1,2,4
1515915625520468429,154,4,150.48,1,3,3,7
1515915625520473340,154,1,18.38,1,1,1,3
1515915625520475918,154,1,9.35,1,1,1,3
1515915625520477046,154,1,16.98,1,1,1,3
1515915625520478644,154,2,378.34,1,2,4,7
1515915625520479055,154,1,79.87,1,1,2,4
1515915625520480379,154,1,37.62,1,1,2,4
1515915625520480452,154,1,204.29,1,1,3,5
1515915625520480535,154,1,77.73,1,1,2,4
1515915625520483124,154,1,9.81,1,1,1,3
1515915625520488520,154,2,42.42,1,2,2,5
1515915625520490634,154,1,171.83,1,1,3,5
1515915625520492884,152,2,68.88,1,2,2,5
1515915625520496626,31,1,19.52,4,1,1,6
1515915625520498241,154,1,52.54,1,1,2,4
1515915625520498725,154,1,26.19,1,1,1,3
1515915625520505429,154,1,20.56,1,1,1,3
1515915625520507064,19,2,87.14,4,2,2,8
1515915625520508609,154,1,43.11,1,1,2,4
1515915625520510891,154,3,75.24,1,3,2,6
1515915625520511695,154,1,75.97,1,1,2,4
1515915625520513492,54,1,274.4,3,1,3,7
1515915625520515866,154,1,32.22,1,1,1,3
1515915625520516593,154,1,90.63,1,1,2,4
1515915625520518148,154,1,52.49,1,1,2,4
1515915625520518171,131,3,271.89,1,3,3,7
1515915625520518315,154,1,31.21,1,1,1,3
1515915625520522200,154,3,30.150000000000002,1,3,1,5
1515915625520525669,154,1,173.86,1,1,3,5
1515915625520526859,154,2,169.78,1,2,3,6
1515915625520527030,154,1,13.97,1,1,1,3
1515915625520528511,153,1,16.4,1,1,1,3
1515915625520539135,154,1,564.57,1,1,4,6
1515915625520542017,154,1,21.11,1,1,1,3
1515915625520546301,154,1,28.73,1,1,1,3
1515915625520546694,154,2,1653.72,1,2,4,7
1515915625520546786,153,1,202.97,1,1,3,5
1515915625520551097,154,1,52.49,1,1,2,4
1515915625520551705,154,2,603.71,1,2,4,7
1515915625520552412,154,1,28.62,1,1,1,3
1515915625520552628,154,1,11.13,1,1,1,3
1515915625520553697,154,1,21.81,1,1,1,3
1515915625520557693,154,2,23.96,1,2,1,4
1515915625520562680,154,1,84.89,1,1,2,4
1515915625520568554,154,1,257.87,1,1,3,5
1515915625520569929,154,5,61.25,1,4,2,7
1515915625520570472,133,1,16.02,1,1,1,3
1515915625520570673,154,1,204.29,1,1,3,5
1515915625520585526,154,1,439.49,1,1,4,6
1515915625520585838,128,1,23.16,1,1,1,3
1515915625520587432,119,2,480.22,1,2,4,7
1515915625520588090,154,1,113.38,1,1,3,5
1515915625520588723,154,1,64.48,1,1,2,4
1515915625520594880,148,3,45.24,1,3,2,6
1515915625520597578,154,1,23.48,1,1,1,3
1515915625520599047,154,1,607.92,1,1,4,6
1515915625520602880,153,1,19.84,1,1,1,3
1515915625520604796,154,1,35.67,1,1,2,4
1515915625520605727,154,1,257.87,1,1,3,5
1515915625520607352,154,1,16.19,1,1,1,3
1515915625520607687,116,2,14.08,1,2,1,4
1515915625520607955,154,2,43.5,1,2,2,5
1515915625520609702,154,3,43.56,1,3,2,6
1515915625520611776,153,1,59.41,1,1,2,4
1515915625520623939,153,1,33.97,1,1,2,4
1515915625520626799,154,3,632.79,1,3,4,8
1515915625520631996,154,1,21.3,1,1,1,3
1515915625520632200,154,1,32.38,1,1,2,4
1515915625520638431,151,1,133.03,1,1,3,5
1515915625520640767,154,2,39.56,1,2,2,5
1515915625520641050,154,2,157.39999999999998,1,2,3,6
1515915625520643882,127,3,100.94999999999999,1,3,3,7
1515915625520646233,154,3,160.53,1,3,3,7
1515915625520647381,37,1,88.7,3,1,2,6
1515915625520647594,154,1,204.29,1,1,3,5
1515915625520648208,154,1,204.29,1,1,3,5
1515915625520648851,154,2,80.4,1,2,2,5
1515915625520651197,150,2,430.82,1,2,4,7
1515915625520652578,127,1,71.02,1,1,2,4
1515915625520658368,154,3,110.01,1,3,3,7
1515915625520659917,154,1,18.25,1,1,1,3
1515915625520674726,153,1,16.19,1,1,1,3
1515915625520677724,153,1,395.54,1,1,4,6
1515915625520679716,153,10,1828.1,1,4,4,9
1515915625520684345,153,3,181.62,1,3,3,7
1515915625520686843,153,1,122.86,1,1,3,5
1515915625520689035,153,1,72.38,1,1,2,4
1515915625520701929,153,1,14.08,1,1,1,3
1515915625520709864,153,1,27.3,1,1,1,3
1515915625520712323,150,9,4666.990000000001,1,4,4,9
1515915625520720780,153,1,265.05,1,1,3,5
1515915625520724753,153,1,27.3,1,1,1,3
1515915625520725191,150,1,20.65,1,1,1,3
1515915625520727999,153,2,437.96,1,2,4,7
1515915625520730049,153,1,16.98,1,1,1,3
1515915625520731116,153,1,28.73,1,1,1,3
1515915625520731413,153,1,122.86,1,1,3,5
1515915625520731997,153,4,287.65999999999997,1,3,4,8
1515915625520732890,103,1,128.79,2,1,3,6
1515915625520733639,126,2,551.54,1,2,4,7
1515915625520734041,153,1,399.48,1,1,4,6
1515915625520734497,151,4,257.92,1,3,3,7
1515915625520734808,153,2,21.58,1,2,1,4
1515915625520736652,153,1,426.32,1,1,4,6
1515915625520740112,153,1,21.75,1,1,1,3
1515915625520742256,153,1,284.11,1,1,3,5
1515915625520745543,153,1,54.44,1,1,2,4
1515915625520753362,133,1,81.51,1,1,2,4
1515915625520755621,153,2,24.44,1,2,1,4
1515915625520755984,153,2,451.27,1,2,4,7
1515915625520756318,31,11,319.46,4,4,4,12
1515915625520757179,153,3,354.0,1,3,4,8
1515915625520762317,153,1,11.95,1,1,1,3
1515915625520764746,150,1,13.86,1,1,1,3
1515915625520764771,150,2,27.72,1,2,1,4
1515915625520766939,153,1,33.65,1,1,2,4
1515915625520767380,153,1,13.86,1,1,1,3
1515915625520769431,153,3,1037.94,1,3,4,8
1515915625520775188,153,1,26.46,1,1,1,3
1515915625520775765,153,1,14.44,1,1,1,3
1515915625520777106,153,1,15.08,1,1,1,3
1515915625520778179,153,3,63.33,1,3,2,6
1515915625520778905,153,1,22.79,1,1,1,3
1515915625520783026,153,2,155.46,1,2,3,6
1515915625520783042,153,1,15.1,1,1,1,3
1515915625520783109,152,4,232.25,1,3,3,7
1515915625520791009,153,1,256.81,1,1,3,5
1515915625520793454,134,2,3.14,1,2,1,4
1515915625520793692,153,4,1031.48,1,3,4,8
1515915625520797109,153,1,1.57,1,1,1,3
1515915625520797494,84,2,111.74,2,2,3,7
1515915625520797819,150,1,125.11,1,1,3,5
1515915625520798469,153,2,679.02,1,2,4,7
1515915625520799564,153,1,426.32,1,1,4,6
1515915625520804493,153,1,12.43,1,1,1,3
1515915625520804614,153,1,178.22,1,1,3,5
1515915625520809782,153,1,163.52,1,1,3,5
1515915625520810359,153,1,104.6,1,1,3,5
1515915625520815552,153,1,325.95,1,1,4,6
1515915625520815604,153,1,19.52,1,1,1,3
1515915625520817930,153,1,53.17,1,1,2,4
1515915625520822103,153,1,11.51,1,1,1,3
1515915625520824317,108,2,272.1,2,2,3,7
1515915625520828751,153,1,39.54,1,1,2,4
1515915625520834307,144,1,9.21,1,1,1,3
1515915625520835044,44,1,157.14,3,1,3,7
1515915625520838236,153,1,77.73,1,1,2,4
1515915625520839408,152,1,62.83,1,1,2,4
1515915625520850075,151,1,155.1,1,1,3,5
1515915625520852263,102,3,188.82,2,3,3,8
1515915625520869427,153,2,260.0,1,2,3,6
1515915625520870922,134,1,172.86,1,1,3,5
1515915625520874307,146,1,10.59,1,1,1,3
1515915625520874467,147,2,98.17,1,2,3,6
1515915625520875107,153,1,11.11,1,1,1,3
1515915625520877604,152,2,59.14,1,2,2,5
1515915625520884639,153,1,32.22,1,1,1,3
1515915625520887575,153,1,23.57,1,1,1,3
1515915625520891792,153,1,242.86,1,1,3,5
1515915625520893346,153,1,1089.62,1,1,4,6
1515915625520893877,153,1,15.71,1,1,1,3
1515915625520901090,153,1,15.08,1,1,1,3
1515915625520901633,153,1,51.21,1,1,2,4
1515915625520902684,153,1,170.0,1,1,3,5
1515915625520903154,153,1,20.95,1,1,1,3
1515915625520904426,152,2,41.09,1,2,2,5
1515915625520913760,153,4,62.24,1,3,2,6
1515915625520913843,153,1,9.35,1,1,1,3
1515915625520916557,129,1,47.49,1,1,2,4
1515915625520917825,153,2,307.66,1,2,4,7
1515915625520921422,141,6,846.94,1,4,4,9
1515915625520928140,153,1,11.32,1,1,1,3
1515915625520929239,93,1,202.67,2,1,3,6
1515915625520935576,153,2,651.9,1,2,4,7
1515915625520938071,153,1,115.4,1,1,3,5
1515915625520940312,153,1,39.75,1,1,2,4
1515915625520942074,153,4,344.64,1,3,4,8
1515915625520942171,153,1,14.6,1,1,1,3
1515915625520944943,153,1,204.29,1,1,3,5
1515915625520946912,152,2,515.74,1,2,4,7
1515915625520946932,153,1,257.87,1,1,3,5
1515915625520947113,153,1,52.05,1,1,2,4
1515915625520947620,153,1,56.27,1,1,2,4
1515915625520950006,153,1,83.97,1,1,2,4
1515915625520954121,153,1,136.92,1,1,3,5
1515915625520959644,153,1,26.57,1,1,1,3
1515915625520964031,153,1,20.0,1,1,1,3
1515915625520966260,151,1,7.0,1,1,1,3
1515915625520974618,153,1,23.33,1,1,1,3
1515915625520975628,153,1,28.1,1,1,1,3
1515915625520977306,153,1,28.89,1,1,1,3
1515915625520989668,152,1,15.08,1,1,1,3
1515915625521000868,152,2,115.24,1,2,3,6
1515915625521011332,151,1,59.3,1,1,2,4
1515915625521020735,152,1,28.1,1,1,1,3
1515915625521021557,152,1,28.57,1,1,1,3
1515915625521022597,152,1,16.19,1,1,1,3
1515915625521027516,151,1,29.52,1,1,1,3
1515915625521028944,152,1,49.38,1,1,2,4
1515915625521030382,152,1,17.29,1,1,1,3
1515915625521034518,152,1,38.7,1,1,2,4
1515915625521034885,152,7,10.99,1,4,1,6
1515915625521036317,152,1,55.16,1,1,2,4
1515915625521038403,152,1,28.19,1,1,1,3
1515915625521043469,152,1,18.7,1,1,1,3
1515915625521045311,152,1,35.87,1,1,2,4
1515915625521045847,152,1,16.35,1,1,1,3
1515915625521046794,145,1,25.63,1,1,1,3
1515915625521049498,152,1,15.08,1,1,1,3
1515915625521050952,152,3,161.94,1,3,3,7
1515915625521055300,152,1,116.49,1,1,3,5
1515915625521058297,151,1,44.13,1,1,2,4
1515915625521058333,152,2,138.7,1,2,3,6
1515915625521059186,152,1,61.27,1,1,2,4
1515915625521059823,123,2,318.28,1,2,4,7
1515915625521062465,152,3,63.63,1,3,2,6
1515915625521066156,152,1,12.86,1,1,1,3
1515915625521068542,152,3,474.84,1,3,4,8
1515915625521072192,3,2,374.58,4,2,4,10
1515915625521075866,152,2,27.72,1,2,1,4
1515915625521076407,152,2,173.08,1,2,3,6
1515915625521077863,152,2,38.74,1,2,2,5
1515915625521081466,152,2,28.26,1,2,1,4
1515915625521086565,146,2,654.86,1,2,4,7
1515915625521086795,152,1,21.21,1,1,1,3
1515915625521086929,152,1,279.02,1,1,3,5
1515915625521089578,152,1,1.57,1,1,1,3
1515915625521090126,152,1,10.71,1,1,1,3
1515915625521092478,152,2,90.48,1,2,2,5
1515915625521094800,88,1,32.22,2,1,1,4
1515915625521096929,152,1,92.05,1,1,3,5
1515915625521099135,152,2,67.94,1,2,2,5
1515915625521101345,152,1,29.7,1,1,1,3
1515915625521102740,152,1,16.83,1,1,1,3
1515915625521102968,152,1,53.32,1,1,2,4
1515915625521106676,152,1,34.54,1,1,2,4
1515915625521107650,152,1,1.57,1,1,1,3
1515915625521110584,152,1,34.06,1,1,2,4
1515915625521122322,152,1,29.52,1,1,1,3
1515915625521123758,152,1,52.05,1,1,2,4
1515915625521126306,152,1,30.54,1,1,1,3
1515915625521126919,152,2,33.46,1,2,2,5
1515915625521139836,119,3,355.71,1,3,4,8
1515915625521140032,152,1,612.59,1,1,4,6
1515915625521144638,150,3,39.3,1,3,2,6
1515915625521148902,152,1,9.35,1,1,1,3
1515915625521149368,151,1,46.03,1,1,2,4
1515915625521151051,152,1,322.57,1,1,4,6
1515915625521154128,20,4,785.0799999999999,4,3,4,11
1515915625521155151,152,2,98.76,1,2,3,6
1515915625521157156,144,1,23.76,1,1,1,3
1515915625521158912,152,1,414.13,1,1,4,6
1515915625521162739,152,1,43.11,1,1,2,4
1515915625521165201,116,1,33.81,1,1,2,4
1515915625521168367,152,2,250.37,1,2,3,6
1515915625521172534,1,1,656.63,4,1,4,9
1515915625521190800,150,2,35.58,1,2,2,5
1515915625521191063,152,2,142.21,1,2,3,6
1515915625521192901,93,1,1.57,2,1,1,4
1515915625521197993,152,1,192.86,1,1,3,5
1515915625521211113,152,4,71.6,1,3,2,6
1515915625521241706,152,2,36.38,1,2,2,5
1515915625521242518,152,1,26.46,1,1,1,3
1515915625521243344,152,3,28.049999999999997,1,3,1,5
1515915625521243810,152,1,23.9,1,1,1,3
1515915625521249795,141,2,73.02,1,2,2,5
1515915625521256975,152,1,19.84,1,1,1,3
1515915625521256978,152,1,32.38,1,1,2,4
1515915625521263551,152,1,24.54,1,1,1,3
1515915625521264957,135,3,37.62,1,3,2,6
1515915625521279407,151,2,54.6,1,2,2,5
1515915625521280982,151,1,19.52,1,1,1,3
1515915625521281502,151,4,82.22,1,3,2,6
1515915625521283624,151,1,66.1,1,1,2,4
1515915625521301606,151,1,75.71,1,1,2,4
1515915625521306057,151,1,15.92,1,1,1,3
1515915625521310116,151,1,204.29,1,1,3,5
1515915625521313013,151,1,236.38,1,1,3,5
1515915625521320618,151,1,87.7,1,1,2,4
1515915625521320735,151,1,23.29,1,1,1,3
1515915625521322323,132,1,58.41,1,1,2,4
1515915625521323192,151,3,166.05,1,3,3,7
1515915625521324394,151,1,18.89,1,1,1,3
1515915625521326560,151,1,22.22,1,1,1,3
1515915625521340074,151,1,133.7,1,1,3,5
1515915625521343767,151,2,72.98,1,2,2,5
1515915625521355068,151,1,33.65,1,1,2,4
1515915625521360711,151,1,125.4,1,1,3,5
1515915625521362300,151,1,127.08,1,1,3,5
1515915625521372617,151,1,11.65,1,1,1,3
1515915625521374674,151,1,24.3,1,1,1,3
1515915625521376437,151,1,47.14,1,1,2,4
1515915625521378164,151,3,75.72,1,3,2,6
1515915625521380382,151,3,66.24,1,3,2,6
1515915625521383057,151,1,126.68,1,1,3,5
1515915625521383933,151,1,45.44,1,1,2,4
1515915625521384102,151,1,4.63,1,1,1,3
1515915625521384941,151,1,138.92,1,1,3,5
1515915625521392861,151,1,155.1,1,1,3,5
1515915625521394003,28,1,187.29,4,1,3,8
1515915625521394012,118,14,944.99,1,4,4,9
1515915625521394717,147,1,42.98,1,1,2,4
1515915625521397372,151,2,250.8,1,2,3,6
1515915625521403644,151,2,67.94,1,2,2,5
1515915625521405265,151,1,64.48,1,1,2,4
1515915625521410197,151,1,10.84,1,1,1,3
1515915625521415915,151,1,15.08,1,1,1,3
1515915625521416351,151,1,10.4,1,1,1,3
1515915625521419210,151,1,25.78,1,1,1,3
1515915625521420941,151,1,178.22,1,1,3,5
1515915625521424575,151,1,229.0,1,1,3,5
1515915625521425355,151,1,127.08,1,1,3,5
1515915625521427857,120,4,980.97,1,3,4,8
1515915625521432080,151,1,13.86,1,1,1,3
1515915625521437928,151,1,355.21,1,1,4,6
1515915625521438670,128,3,583.8,1,3,4,8
1515915625521439064,151,1,28.25,1,1,1,3
1515915625521439826,151,1,355.21,1,1,4,6
1515915625521440471,151,1,15.89,1,1,1,3
1515915625521442643,151,1,19.41,1,1,1,3
1515915625521443535,151,1,36.81,1,1,2,4
1515915625521444589,151,1,10.68,1,1,1,3
1515915625521466215,151,1,15.43,1,1,1,3
1515915625521469586,151,1,1.57,1,1,1,3
1515915625521473924,151,1,73.24,1,1,2,4
1515915625521474334,151,1,18.57,1,1,1,3
1515915625521474780,144,2,46.06,1,2,2,5
1515915625521475326,151,3,539.34,1,3,4,8
1515915625521479080,151,1,108.56,1,1,3,5
1515915625521479935,151,2,275.26,1,2,3,6
1515915625521481186,151,2,220.96,1,2,3,6
1515915625521483892,151,1,26.19,1,1,1,3
1515915625521484014,151,1,121.4,1,1,3,5
1515915625521484253,151,1,12.22,1,1,1,3
1515915625521484718,151,1,9.35,1,1,1,3
1515915625521485529,151,1,39.67,1,1,2,4
1515915625521486132,151,1,204.29,1,1,3,5
1515915625521489136,151,1,115.1,1,1,3,5
1515915625521489421,151,2,20.0,1,2,1,4
1515915625521489535,151,2,32.7,1,2,2,5
1515915625521489867,151,3,1452.5900000000001,1,3,4,8
1515915625521490751,151,1,13.81,1,1,1,3
1515915625521492808,145,1,104.13,1,1,3,5
1515915625521495666,151,3,342.48,1,3,4,8
1515915625521500662,151,1,365.25,1,1,4,6
1515915625521500864,144,1,73.81,1,1,2,4
1515915625521501605,150,1,17.46,1,1,1,3
1515915625521512001,151,1,1.57,1,1,1,3
1515915625521513870,151,2,62.04,1,2,2,5
1515915625521517438,151,1,15.08,1,1,1,3
1515915625521518226,151,1,203.02,1,1,3,5
1515915625521518861,151,2,33.96,1,2,2,5
1515915625521519171,140,1,29.9,1,1,1,3
1515915625521525149,137,5,1183.35,1,4,4,9
1515915625521531734,144,1,297.94,1,1,4,6
1515915625521531947,53,1,82.06,3,1,2,6
1515915625521533048,151,2,2419.96,1,2,4,7
1515915625521536159,151,1,122.86,1,1,3,5
1515915625521539532,151,2,163.01000000000002,1,2,3,6
1515915625521545524,151,1,45.24,1,1,2,4
1515915625521550234,151,1,27.84,1,1,1,3
1515915625521550436,143,4,105.84,1,3,3,7
1515915625521554317,151,1,268.17,1,1,3,5
1515915625521555690,151,1,20.95,1,1,1,3
1515915625521559382,151,2,568.64,1,2,4,7
1515915625521564185,151,1,251.92,1,1,3,5
1515915625521564652,151,1,87.16,1,1,2,4
1515915625521564792,151,1,251.92,1,1,3,5
1515915625521566098,109,2,86.26,2,2,2,6
1515915625521568577,144,1,115.71,1,1,3,5
1515915625521569032,151,1,284.32,1,1,3,5
1515915625521580265,151,1,23.81,1,1,1,3
1515915625521580771,151,1,192.86,1,1,3,5
1515915625521585558,151,1,73.81,1,1,2,4
1515915625521585670,151,1,73.81,1,1,2,4
1515915625521587756,151,1,631.62,1,1,4,6
1515915625521591198,151,2,385.72,1,2,4,7
1515915625521591404,151,1,40.63,1,1,2,4
1515915625521591485,151,1,40.63,1,1,2,4
1515915625521592186,148,1,204.29,1,1,3,5
1515915625521596595,151,1,24.13,1,1,1,3
1515915625521598706,151,1,61.16,1,1,2,4
1515915625521604690,151,1,157.14,1,1,3,5
1515915625521604752,151,2,39.36,1,2,2,5
1515915625521611256,150,1,292.83,1,1,4,6
1515915625521613786,150,1,57.65,1,1,2,4
1515915625521626575,150,1,1800.35,1,1,4,6
1515915625521635032,150,2,3.14,1,2,1,4
1515915625521645843,148,2,684.26,1,2,4,7
1515915625521650157,150,1,29.22,1,1,1,3
1515915625521651563,150,1,26.46,1,1,1,3
1515915625521651918,143,1,10.08,1,1,1,3
1515915625521655036,144,2,88.35,1,2,2,5
1515915625521661983,150,1,16.19,1,1,1,3
1515915625521665117,150,1,33.08,1,1,2,4
1515915625521670455,150,2,34.59,1,2,2,5
1515915625521671654,150,1,55.16,1,1,2,4
1515915625521685583,150,2,548.8,1,2,4,7
1515915625521686852,147,1,79.43,1,1,2,4
1515915625521692002,150,1,26.98,1,1,1,3
1515915625521692129,150,1,23.48,1,1,1,3
1515915625521692150,150,2,31.74,1,2,1,4
1515915625521692809,150,1,37.62,1,1,2,4
1515915625521695371,150,1,16.33,1,1,1,3
1515915625521695676,150,1,17.22,1,1,1,3
1515915625521696571,150,1,51.68,1,1,2,4
1515915625521696634,150,1,14.95,1,1,1,3
1515915625521698451,150,1,20.95,1,1,1,3
1515915625521698694,150,1,104.86,1,1,3,5
1515915625521703973,150,2,290.82,1,2,4,7
1515915625521710527,150,1,13.65,1,1,1,3
1515915625521711181,150,1,26.19,1,1,1,3
1515915625521721644,149,2,64.44,1,2,2,5
1515915625521725068,150,3,336.65999999999997,1,3,4,8
1515915625521725391,149,2,64.44,1,2,2,5
1515915625521728574,150,1,183.75,1,1,3,5
1515915625521730087,149,1,33.19,1,1,2,4
1515915625521732696,150,1,61.16,1,1,2,4
1515915625521736719,150,1,13.48,1,1,1,3
1515915625521737157,150,1,153.17,1,1,3,5
1515915625521737485,150,1,81.63,1,1,2,4
1515915625521738782,150,1,30.83,1,1,1,3
1515915625521738856,150,1,30.83,1,1,1,3
1515915625521742269,150,1,381.62,1,1,4,6
1515915625521742896,150,2,201.5,1,2,3,6
1515915625521745364,109,36,702.0,2,4,4,10
1515915625521746426,150,1,8.7,1,1,1,3
1515915625521746568,150,1,64.84,1,1,2,4
1515915625521748210,150,2,65.4,1,2,2,5
1515915625521749225,150,1,230.75,1,1,3,5
1515915625521749824,150,1,51.21,1,1,2,4
1515915625521750300,150,1,230.75,1,1,3,5
1515915625521752161,150,2,98.42,1,2,3,6
1515915625521754831,150,1,101.9,1,1,3,5
1515915625521756317,150,1,24.92,1,1,1,3
1515915625521762369,150,1,58.25,1,1,2,4
1515915625521762969,150,2,683.8,1,2,4,7
1515915625521770673,150,1,104.86,1,1,3,5
1515915625521776518,150,1,64.48,1,1,2,4
1515915625521780547,150,2,117.80000000000001,1,2,3,6
1515915625521782655,150,3,254.67000000000002,1,3,3,7
1515915625521783325,150,2,169.78,1,2,3,6
1515915625521786638,150,1,104.13,1,1,3,5
1515915625521787901,150,1,180.73,1,1,3,5
1515915625521789232,150,1,26.17,1,1,1,3
1515915625521793537,150,2,59.68,1,2,2,5
1515915625521798702,119,1,38.83,1,1,2,4
1515915625521799306,122,1,16.11,1,1,1,3
1515915625521802457,150,1,11.7,1,1,1,3
1515915625521804101,150,1,204.29,1,1,3,5
1515915625521807789,150,1,51.14,1,1,2,4
1515915625521810557,150,1,51.75,1,1,2,4
1515915625521811836,149,2,27.78,1,2,1,4
1515915625521813005,150,1,71.59,1,1,2,4
1515915625521819163,139,6,62.760000000000005,1,4,2,7
1515915625521819287,150,1,2.86,1,1,1,3
1515915625521823999,150,1,56.35,1,1,2,4
1515915625521826552,150,1,20.79,1,1,1,3
1515915625521828858,150,1,228.57,1,1,3,5
1515915625521831755,149,4,1077.6,1,3,4,8
1515915625521834377,146,1,228.57,1,1,3,5
1515915625521838609,150,1,204.29,1,1,3,5
1515915625521838922,150,1,12.51,1,1,1,3
1515915625521842677,150,1,46.67,1,1,2,4
1515915625521845323,150,1,33.33,1,1,2,4
1515915625521848933,104,2,429.8,2,2,4,8
1515915625521857775,149,1,55.87,1,1,2,4
1515915625521867109,117,2,443.84,1,2,4,7
1515915625521870161,150,1,33.97,1,1,2,4
1515915625521871430,150,1,19.05,1,1,1,3
1515915625521871882,150,1,122.86,1,1,3,5
1515915625521873736,150,1,415.54,1,1,4,6
1515915625521876717,149,2,30.48,1,2,1,4
1515915625521877970,150,1,15.56,1,1,1,3
1515915625521880250,150,1,15.87,1,1,1,3
1515915625521883132,150,2,166.98,1,2,3,6
1515915625521884102,150,1,257.87,1,1,3,5
1515915625521887148,150,1,253.38,1,1,3,5
1515915625521888302,150,6,2452.1,1,4,4,9
1515915625521890667,150,1,49.06,1,1,2,4
1515915625521891220,150,1,2170.57,1,1,4,6
1515915625521892233,150,1,107.16,1,1,3,5
1515915625521893087,150,2,101.2,1,2,3,6
1515915625521894772,150,1,50.6,1,1,2,4
1515915625521899862,150,1,204.29,1,1,3,5
1515915625521900058,150,1,15.87,1,1,1,3
1515915625521902173,149,4,694.01,1,3,4,8
1515915625521921931,149,3,612.87,1,3,4,8
1515915625521927999,149,1,110.95,1,1,3,5
1515915625521930871,149,1,43.17,1,1,2,4
1515915625521935928,13,1,9.84,4,1,1,6
1515915625521938945,149,1,23.57,1,1,1,3
1515915625521940863,149,2,455.26,1,2,4,7
1515915625521943153,149,1,227.63,1,1,3,5
1515915625521948067,149,1,164.92,1,1,3,5
1515915625521956911,149,1,20.25,1,1,1,3
1515915625521963716,149,1,15.08,1,1,1,3
1515915625521969792,149,4,6.28,1,3,1,5
1515915625521971399,44,1,34.92,3,1,2,6
1515915625521973135,149,1,11.0,1,1,1,3
1515915625521973801,9,2,374.58,4,2,4,10
1515915625521974731,149,3,539.8199999999999,1,3,4,8
1515915625521975162,149,2,201.5,1,2,3,6
1515915625521977743,149,1,10.63,1,1,1,3
1515915625521978566,149,1,9.35,1,1,1,3
1515915625521982819,149,1,21.21,1,1,1,3
1515915625521984756,149,1,17.62,1,1,1,3
1515915625521986704,147,1,12.62,1,1,1,3
1515915625521987466,149,1,23.81,1,1,1,3
1515915625521987798,149,2,187.02,1,2,3,6
1515915625521987867,149,1,15.08,1,1,1,3
1515915625521988540,149,1,13.02,1,1,1,3
1515915625521993801,149,2,85.72,1,2,2,5
1515915625521995649,149,2,3.14,1,2,1,4
1515915625521998098,149,1,204.29,1,1,3,5
1515915625522005987,145,2,106.34,1,2,3,6
1515915625522008456,149,3,107.77,1,3,3,7
1515915625522010178,146,1,297.41,1,1,4,6
1515915625522010742,149,1,32.38,1,1,2,4
1515915625522011080,149,2,242.38,1,2,3,6
1515915625522013453,149,2,47.14,1,2,2,5
1515915625522015639,148,3,1056.26,1,3,4,8
1515915625522019058,149,1,50.25,1,1,2,4
1515915625522019606,132,3,87.66,1,3,2,6
1515915625522023442,148,1,61.13,1,1,2,4
1515915625522032006,149,1,75.7,1,1,2,4
1515915625522035711,149,2,31.74,1,2,1,4
1515915625522038821,149,2,111.74,1,2,3,6
1515915625522044685,149,1,19.37,1,1,1,3
1515915625522046429,149,1,19.37,1,1,1,3
1515915625522050804,149,1,133.03,1,1,3,5
1515915625522056950,149,2,58.44,1,2,2,5
1515915625522066159,103,1,15.4,2,1,1,4
1515915625522068024,149,1,13.86,1,1,1,3
1515915625522068245,137,1,36.49,1,1,2,4
1515915625522072114,146,2,498.04,1,2,4,7
1515915625522073646,149,2,406.04,1,2,4,7
1515915625522079804,149,1,15.08,1,1,1,3
1515915625522081838,149,1,22.7,1,1,1,3
1515915625522084867,149,2,3.14,1,2,1,4
1515915625522085635,149,1,204.29,1,1,3,5
1515915625522086869,149,1,134.46,1,1,3,5
1515915625522087978,149,1,56.76,1,1,2,4
1515915625522090941,149,2,370.16,1,2,4,7
1515915625522096756,145,10,261.90000000000003,1,4,3,8
1515915625522100512,149,1,7.71,1,1,1,3
1515915625522102354,148,1,40.79,1,1,2,4
1515915625522105081,149,3,353.25,1,3,4,8
1515915625522105913,149,1,171.94,1,1,3,5
1515915625522109167,125,1,236.67,1,1,3,5
1515915625522112763,132,1,237.13,1,1,3,5
1515915625522114610,145,1,43.11,1,1,2,4
1515915625522118598,149,1,73.24,1,1,2,4
1515915625522120986,122,2,74.13,1,2,2,5
1515915625522125464,148,1,53.51,1,1,2,4
1515915625522126650,149,1,159.68,1,1,3,5
1515915625522127351,149,2,61.13,1,2,2,5
1515915625522129864,149,1,27.14,1,1,1,3
1515915625522132762,144,3,32.849999999999994,1,3,2,6
1515915625522139137,44,1,23.49,3,1,1,5
1515915625522142585,149,1,198.62,1,1,3,5
1515915625522147447,149,1,28.43,1,1,1,3
1515915625522149677,149,1,22.22,1,1,1,3
1515915625522153973,149,1,15.83,1,1,1,3
1515915625522165358,148,3,612.87,1,3,4,8
1515915625522181731,148,1,51.68,1,1,2,4
1515915625522182800,147,2,128.92,1,2,3,6
1515915625522184198,148,1,51.68,1,1,2,4
1515915625522192477,100,3,319.6,2,3,4,9
1515915625522193011,148,1,365.38,1,1,4,6
1515915625522196213,148,3,380.04,1,3,4,8
1515915625522203400,148,1,13.65,1,1,1,3
1515915625522203523,148,1,56.56,1,1,2,4
1515915625522203696,148,1,11.86,1,1,1,3
1515915625522204326,148,2,380.06,1,2,4,7
1515915625522204765,148,1,31.65,1,1,1,3
1515915625522207154,148,4,158.38,1,3,3,7
1515915625522209114,148,4,72.4,1,3,2,6
1515915625522209739,148,1,34.51,1,1,2,4
1515915625522215915,139,1,64.48,1,1,2,4
1515915625522218363,148,3,129.51,1,3,3,7
1515915625522218989,148,1,21.21,1,1,1,3
1515915625522224980,148,1,64.48,1,1,2,4
1515915625522228865,148,4,114.2,1,3,3,7
1515915625522230060,148,2,289.02,1,2,4,7
1515915625522230299,148,1,14.08,1,1,1,3
1515915625522231267,138,5,7.8500000000000005,1,4,1,6
1515915625522232054,136,1,68.1,1,1,2,4
1515915625522233935,148,1,15.87,1,1,1,3
1515915625522234706,148,3,62.849999999999994,1,3,2,6
1515915625522235647,148,1,35.71,1,1,2,4
1515915625522239173,148,1,9.35,1,1,1,3
1515915625522240817,148,1,19.97,1,1,1,3
1515915625522244041,148,1,17.19,1,1,1,3
1515915625522248858,148,1,284.32,1,1,3,5
1515915625522249658,148,4,233.72,1,3,3,7
1515915625522251813,148,1,26.19,1,1,1,3
1515915625522252152,148,1,11.13,1,1,1,3
1515915625522252711,148,1,26.19,1,1,1,3
1515915625522253494,110,6,336.96,2,4,4,10
1515915625522253613,148,1,26.19,1,1,1,3
1515915625522260149,148,5,405.77,1,4,4,9
1515915625522261053,148,1,21.48,1,1,1,3
1515915625522261606,148,1,26.98,1,1,1,3
1515915625522278590,112,6,1376.28,2,4,4,10
1515915625522279874,148,1,309.24,1,1,4,6
1515915625522281792,148,2,70.64,1,2,2,5
1515915625522282550,148,1,1.57,1,1,1,3
1515915625522285098,148,1,50.79,1,1,2,4
1515915625522291103,148,1,12.08,1,1,1,3
1515915625522291912,148,2,3.14,1,2,1,4
1515915625522293084,148,1,9.81,1,1,1,3
1515915625522293142,148,1,33.33,1,1,2,4
1515915625522293916,148,1,10.95,1,1,1,3
1515915625522293941,148,2,3.14,1,2,1,4
1515915625522294963,148,1,9.59,1,1,1,3
1515915625522295955,148,6,151.4,1,4,3,8
1515915625522297596,148,4,428.19,1,3,4,8
1515915625522299341,136,2,197.18,1,2,3,6
1515915625522301929,127,3,167.60999999999999,1,3,3,7
1515915625522306935,147,3,944.04,1,3,4,8
1515915625522308060,148,4,565.96,1,3,4,8
1515915625522310080,148,1,60.32,1,1,2,4
1515915625522313574,146,1,222.06,1,1,3,5
1515915625522314609,148,1,10.13,1,1,1,3
1515915625522316857,148,2,655.8599999999999,1,2,4,7
1515915625522317584,148,3,129.51,1,3,3,7
1515915625522321925,148,1,31.16,1,1,1,3
1515915625522324063,148,2,654.86,1,2,4,7
1515915625522328103,142,4,60.32,1,3,2,6
1515915625522331370,148,1,56.62,1,1,2,4
1515915625522334797,148,2,38.74,1,2,2,5
1515915625522338816,148,1,149.05,1,1,3,5
1515915625522344518,86,1,274.4,2,1,3,6
1515915625522353198,148,3,43.86,1,3,2,6
1515915625522354174,148,2,97.78,1,2,3,6
1515915625522355283,148,1,53.24,1,1,2,4
1515915625522355295,148,2,106.48,1,2,3,6
1515915625522357966,141,1,26.19,1,1,1,3
1515915625522357993,141,2,52.38,1,2,2,5
1515915625522360050,147,1,16.65,1,1,1,3
1515915625522360064,148,2,33.3,1,2,2,5
1515915625522360901,148,1,17.22,1,1,1,3
1515915625522361327,148,1,23.29,1,1,1,3
1515915625522367730,148,1,16.19,1,1,1,3
1515915625522372053,148,2,32.38,1,2,2,5
1515915625522373038,148,1,16.19,1,1,1,3
1515915625522379819,148,3,53.8,1,3,2,6
1515915625522381171,126,2,67.72,1,2,2,5
1515915625522383081,148,1,144.6,1,1,3,5
1515915625522383398,148,1,45.24,1,1,2,4
1515915625522384689,148,1,187.29,1,1,3,5
1515915625522385746,148,1,163.48,1,1,3,5
1515915625522393762,147,1,98.73,1,1,3,5
1515915625522396427,148,1,10.16,1,1,1,3
1515915625522397297,148,1,12.83,1,1,1,3
1515915625522397973,148,1,53.17,1,1,2,4
1515915625522398650,135,1,43.11,1,1,2,4
1515915625522405050,147,1,64.48,1,1,2,4
1515915625522405836,144,1,73.81,1,1,2,4
1515915625522406892,148,1,10.13,1,1,1,3
1515915625522410803,106,6,1228.74,2,4,4,10
1515915625522412478,147,2,296.92,1,2,4,7
1515915625522415374,147,1,25.29,1,1,1,3
1515915625522415662,148,1,15.24,1,1,1,3
1515915625522415684,148,2,30.48,1,2,1,4
1515915625522415770,135,2,165.72,1,2,3,6
1515915625522419788,148,2,172.32,1,2,3,6
1515915625522423026,148,1,135.87,1,1,3,5
1515915625522423167,148,1,17.14,1,1,1,3
1515915625522436563,146,2,104.66,1,2,3,6
1515915625522441516,148,1,24.21,1,1,1,3
1515915625522442027,147,1,22.22,1,1,1,3
1515915625522446300,147,1,32.22,1,1,1,3
1515915625522448762,147,1,16.98,1,1,1,3
1515915625522458771,147,1,13.86,1,1,1,3
1515915625522459230,147,2,223.03,1,2,3,6
1515915625522463421,147,2,25.060000000000002,1,2,1,4
1515915625522466941,147,1,33.97,1,1,2,4
1515915625522467359,143,1,193.97,1,1,3,5
1515915625522469801,147,1,11.98,1,1,1,3
1515915625522470744,147,1,64.56,1,1,2,4
1515915625522473137,147,1,24.13,1,1,1,3
1515915625522473380,147,1,17.08,1,1,1,3
1515915625522475989,147,2,515.74,1,2,4,7
1515915625522477223,147,1,59.6,1,1,2,4
1515915625522477238,147,1,26.19,1,1,1,3
1515915625522477541,147,1,16.35,1,1,1,3
1515915625522482551,147,1,10.48,1,1,1,3
1515915625522484616,147,1,1.57,1,1,1,3
1515915625522484629,146,3,93.96,1,3,3,7
1515915625522484824,147,1,10.48,1,1,1,3
1515915625522485375,147,2,169.9,1,2,3,6
1515915625522487342,60,4,96.89999999999999,3,3,3,9
1515915625522487803,147,1,12.25,1,1,1,3
1515915625522487901,147,1,23.17,1,1,1,3
1515915625522489222,147,1,19.52,1,1,1,3
1515915625522489495,147,1,21.9,1,1,1,3
1515915625522490796,147,1,98.56,1,1,3,5
1515915625522492000,147,1,257.87,1,1,3,5
1515915625522493517,108,1,36.03,2,1,2,5
1515915625522493897,147,1,126.68,1,1,3,5
1515915625522494778,141,1,32.86,1,1,2,4
1515915625522496326,147,3,28.049999999999997,1,3,1,5
1515915625522497272,147,1,26.33,1,1,1,3
1515915625522502966,147,1,13.81,1,1,1,3
1515915625522507307,147,1,236.46,1,1,3,5
1515915625522511865,147,2,684.26,1,2,4,7
1515915625522514678,147,1,43.11,1,1,2,4
1515915625522516345,147,5,587.81,1,4,4,9
1515915625522519352,147,1,103.83,1,1,3,5
1515915625522519694,147,1,149.05,1,1,3,5
1515915625522521751,137,4,1149.18,1,3,4,8
1515915625522521916,147,5,91.39,1,4,3,8
1515915625522522111,147,7,515.5500000000001,1,4,4,9
1515915625522525961,147,1,118.57,1,1,3,5
1515915625522527279,147,1,26.52,1,1,1,3
1515915625522527525,90,4,73.81,2,3,2,7
1515915625522528480,147,1,32.22,1,1,1,3
1515915625522529381,147,1,43.17,1,1,2,4
1515915625522530994,147,2,147.3,1,2,3,6
1515915625522533038,147,1,126.68,1,1,3,5
1515915625522535688,147,1,218.98,1,1,3,5
1515915625522535708,147,1,155.1,1,1,3,5
1515915625522541958,147,2,35.46,1,2,2,5
1515915625522545734,147,2,1313.26,1,2,4,7
1515915625522546095,147,1,72.38,1,1,2,4
1515915625522550115,147,1,35.08,1,1,2,4
1515915625522550192,147,1,18.73,1,1,1,3
1515915625522556947,147,1,22.41,1,1,1,3
1515915625522558568,103,3,201.81,2,3,3,8
1515915625522559239,145,1,64.89,1,1,2,4
1515915625522559615,147,1,87.16,1,1,2,4
1515915625522564795,147,3,676.08,1,3,4,8
1515915625522567502,147,4,156.84,1,3,3,7
1515915625522568906,147,3,398.61,1,3,4,8
1515915625522571881,147,1,236.46,1,1,3,5
1515915625522573514,147,2,32.38,1,2,2,5
1515915625522576941,147,1,17.49,1,1,1,3
1515915625522577172,147,4,535.65,1,3,4,8
1515915625522583111,147,1,13.03,1,1,1,3
1515915625522585222,147,1,122.57,1,1,3,5
1515915625522586313,147,3,36.660000000000004,1,3,2,6
1515915625522586325,146,7,1284.8799999999999,1,4,4,9
1515915625522591689,147,1,13.49,1,1,1,3
1515915625522593193,147,1,192.86,1,1,3,5
1515915625522598495,147,1,17.78,1,1,1,3
1515915625522600233,145,2,37.46,1,2,2,5
1515915625522600400,147,1,72.98,1,1,2,4
1515915625522601149,147,1,13.03,1,1,1,3
1515915625522601634,147,1,55.16,1,1,2,4
1515915625522602712,147,1,12.22,1,1,1,3
1515915625522613032,147,1,26.46,1,1,1,3
1515915625522613956,147,3,98.28,1,3,3,7
1515915625522614885,143,1,115.1,1,1,3,5
1515915625522615573,147,1,167.62,1,1,3,5
1515915625522616669,147,1,30.83,1,1,1,3
1515915625522617711,147,1,15.71,1,1,1,3
1515915625522618779,147,2,39.36,1,2,2,5
1515915625522620655,147,1,10.32,1,1,1,3
1515915625522624773,147,2,52.92,1,2,2,5
1515915625522627358,146,5,1021.4499999999999,1,4,4,9
1515915625522627791,147,1,1.57,1,1,1,3
1515915625522632481,147,1,50.79,1,1,2,4
1515915625522637022,147,1,120.48,1,1,3,5
1515915625522637370,147,1,34.44,1,1,2,4
1515915625522642644,147,1,21.43,1,1,1,3
1515915625522645532,147,1,10.87,1,1,1,3
1515915625522647341,147,1,19.84,1,1,1,3
1515915625522647381,108,1,4.49,2,1,1,4
1515915625522654629,80,2,62.54,2,2,2,6
1515915625522658542,147,2,112.7,1,2,3,6
1515915625522659765,110,2,92.32,2,2,3,7
1515915625522660708,147,2,43.81,1,2,2,5
1515915625522661245,147,1,257.87,1,1,3,5
1515915625522666969,147,1,16.19,1,1,1,3
1515915625522667336,147,1,17.62,1,1,1,3
1515915625522669887,147,5,157.5,1,4,3,8
1515915625522672366,147,1,28.89,1,1,1,3
1515915625522675750,147,3,563.34,1,3,4,8
1515915625522677365,147,1,19.19,1,1,1,3
1515915625522682485,109,2,151.46,2,2,3,7
1515915625522688056,147,1,53.51,1,1,2,4
1515915625522701852,147,1,188.06,1,1,3,5
1515915625522708203,137,3,221.43,1,3,3,7
1515915625522717886,147,1,55.65,1,1,2,4
1515915625522719840,147,1,204.29,1,1,3,5
1515915625522725858,147,2,740.92,1,2,4,7
1515915625522726232,147,1,54.08,1,1,2,4
1515915625522727360,147,1,239.97,1,1,3,5
1515915625522731084,146,2,310.2,1,2,4,7
1515915625522755221,145,15,1024.08,1,4,4,9
1515915625522756356,146,1,25.08,1,1,1,3
1515915625522757173,128,2,39.04,1,2,2,5
1515915625522759851,146,1,1.57,1,1,1,3
1515915625522772544,146,1,369.46,1,1,4,6
1515915625522779180,113,13,2160.1,2,4,4,10
1515915625522788070,146,3,93.09,1,3,3,7
1515915625522796311,146,2,28.25,1,2,1,4
1515915625522797517,146,1,15.4,1,1,1,3
1515915625522803008,146,2,3.14,1,2,1,4
1515915625522804956,146,1,32.7,1,1,2,4
1515915625522807983,146,1,72.38,1,1,2,4
1515915625522812057,146,1,39.75,1,1,2,4
1515915625522812732,146,1,44.03,1,1,2,4
1515915625522814652,146,1,22.49,1,1,1,3
1515915625522815066,146,1,18.89,1,1,1,3
1515915625522818719,3,2,140.22,4,2,3,9
1515915625522824890,145,4,442.52,1,3,4,8
1515915625522826106,146,6,780.0,1,4,4,9
1515915625522827730,146,1,16.35,1,1,1,3
1515915625522829624,146,3,222.39,1,3,3,7
1515915625522830713,146,3,33.51,1,3,2,6
1515915625522831656,146,1,67.94,1,1,2,4
1515915625522831944,146,1,13.48,1,1,1,3
1515915625522832911,146,2,93.02,1,2,3,6
1515915625522834389,146,1,15.92,1,1,1,3
1515915625522836168,146,1,170.0,1,1,3,5
1515915625522839138,146,1,28.1,1,1,1,3
1515915625522841159,146,2,340.0,1,2,4,7
1515915625522851670,146,2,58.66,1,2,2,5
1515915625522852197,146,4,85.72,1,3,2,6
1515915625522853199,146,2,152.12,1,2,3,6
1515915625522853538,146,1,1.57,1,1,1,3
1515915625522863968,146,1,11.81,1,1,1,3
1515915625522867936,146,3,13.71,1,3,1,5
1515915625522870550,146,3,1299.56,1,3,4,8
1515915625522874617,146,1,33.97,1,1,2,4
1515915625522878582,146,1,12.43,1,1,1,3
1515915625522885465,145,2,165.94,1,2,3,6
1515915625522887421,146,1,26.03,1,1,1,3
1515915625522890209,146,2,585.66,1,2,4,7
1515915625522891758,146,1,284.3,1,1,3,5
1515915625522892616,146,1,26.46,1,1,1,3
1515915625522892923,146,2,254.16,1,2,3,6
1515915625522893003,146,1,9.35,1,1,1,3
1515915625522909977,146,1,31.27,1,1,1,3
1515915625522910615,128,5,61.25,1,4,2,7
1515915625522911061,146,1,292.83,1,1,4,6
1515915625522912018,146,1,40.0,1,1,2,4
1515915625522913110,146,2,80.0,1,2,2,5
1515915625522914814,146,3,65.82,1,3,2,6
1515915625522915522,140,8,660.16,1,4,4,9
1515915625522916766,146,1,21.75,1,1,1,3
1515915625522921293,146,2,166.04,1,2,3,6
1515915625522923221,146,1,101.43,1,1,3,5
1515915625522923796,137,1,19.84,1,1,1,3
1515915625522923885,146,1,19.84,1,1,1,3
1515915625522935005,146,1,215.6,1,1,3,5
1515915625522939439,146,1,309.24,1,1,4,6
1515915625522940514,146,2,52.38,1,2,2,5
1515915625522955204,146,1,1.57,1,1,1,3
1515915625522960610,146,2,42.86,1,2,2,5
1515915625522963185,146,1,14.29,1,1,1,3
1515915625522963391,146,3,630.5699999999999,1,3,4,8
1515915625522963850,89,1,126.68,2,1,3,6
1515915625522964723,146,1,17.46,1,1,1,3
1515915625522966037,146,1,20.22,1,1,1,3
1515915625522967433,146,1,29.57,1,1,1,3
1515915625522974526,146,1,12.62,1,1,1,3
1515915625522979742,146,1,24.92,1,1,1,3
1515915625522980131,146,1,26.98,1,1,1,3
1515915625522980367,146,1,118.57,1,1,3,5
1515915625522981774,102,14,505.96000000000004,2,4,4,10
1515915625522981960,146,2,128.96,1,2,3,6
1515915625522984706,146,1,85.56,1,1,2,4
1515915625522985740,146,1,322.57,1,1,4,6
1515915625522990245,146,1,18.3,1,1,1,3
1515915625522991213,136,5,1021.4499999999999,1,4,4,9
1515915625522998185,145,2,25.520000000000003,1,2,1,4
1515915625522999100,145,1,98.21,1,1,3,5
1515915625523003958,146,1,204.29,1,1,3,5
1515915625523006148,146,1,161.11,1,1,3,5
1515915625523009970,146,1,7.29,1,1,1,3
1515915625523012187,146,1,16.73,1,1,1,3
1515915625523022868,146,1,50.17,1,1,2,4
1515915625523030307,146,1,15.68,1,1,1,3
1515915625523034095,146,3,612.87,1,3,4,8
1515915625523034841,146,3,23.56,1,3,1,5
1515915625523038741,146,1,26.19,1,1,1,3
1515915625523042963,146,1,32.81,1,1,2,4
1515915625523057572,145,2,97.68,1,2,3,6
1515915625523077177,145,3,1361.94,1,3,4,8
1515915625523077324,145,1,26.46,1,1,1,3
1515915625523084304,145,2,155.46,1,2,3,6
1515915625523095285,145,1,22.75,1,1,1,3
1515915625523102527,145,1,103.83,1,1,3,5
1515915625523104662,145,1,32.81,1,1,2,4
1515915625523108778,144,2,359.88,1,2,4,7
1515915625523110390,130,2,36.82,1,2,2,5
1515915625523112442,145,1,322.57,1,1,4,6
1515915625523114779,145,1,15.1,1,1,1,3
1515915625523115491,143,1,48.84,1,1,2,4
1515915625523115980,145,1,19.86,1,1,1,3
1515915625523116684,137,1,34.9,1,1,2,4
1515915625523117207,145,1,32.54,1,1,2,4
1515915625523121464,145,2,40.22,1,2,2,5
1515915625523126547,145,3,28.049999999999997,1,3,1,5
1515915625523129714,145,1,77.73,1,1,2,4
1515915625523131713,145,1,75.76,1,1,2,4
1515915625523132487,145,1,8.38,1,1,1,3
1515915625523135645,140,1,55.41,1,1,2,4
1515915625523136096,145,1,15.08,1,1,1,3
1515915625523139862,145,1,345.98,1,1,4,6
1515915625523141564,145,1,327.43,1,1,4,6
1515915625523144054,145,1,104.51,1,1,3,5
1515915625523145155,145,1,523.65,1,1,4,6
1515915625523149796,145,1,215.4,1,1,3,5
1515915625523150336,145,1,13.97,1,1,1,3
1515915625523150351,145,4,141.0,1,3,3,7
1515915625523155078,145,1,404.25,1,1,4,6
1515915625523155499,145,2,107.8,1,2,3,6
1515915625523157060,145,1,53.9,1,1,2,4
1515915625523157751,145,2,73.34,1,2,2,5
1515915625523159181,145,3,42.24,1,3,2,6
1515915625523161089,145,1,118.57,1,1,3,5
1515915625523161539,145,1,33.97,1,1,2,4
1515915625523167501,145,3,103.32,1,3,3,7
1515915625523168530,140,3,56.92,1,3,2,6
1515915625523168911,145,1,117.75,1,1,3,5
1515915625523168943,145,1,31.29,1,1,1,3
1515915625523173064,145,1,77.78,1,1,2,4
1515915625523176558,145,1,15.35,1,1,1,3
1515915625523178448,33,2,27.619999999999997,4,2,1,7
1515915625523184682,145,1,45.24,1,1,2,4
1515915625523186951,145,1,71.75,1,1,2,4
1515915625523187472,145,1,32.54,1,1,2,4
1515915625523192600,145,1,104.13,1,1,3,5
1515915625523194252,145,1,75.67,1,1,2,4
1515915625523195810,145,1,44.81,1,1,2,4
1515915625523197734,136,4,123.02,1,3,3,7
1515915625523200194,145,1,113.38,1,1,3,5
1515915625523209780,145,1,371.89,1,1,4,6
1515915625523212211,137,2,188.2,1,2,3,6
1515915625523221319,145,1,23.41,1,1,1,3
1515915625523221934,145,1,218.98,1,1,3,5
1515915625523223177,145,3,91.62,1,3,3,7
1515915625523224595,145,2,90.48,1,2,2,5
1515915625523224691,144,2,50.03,1,2,2,5
1515915625523227980,145,1,9.35,1,1,1,3
1515915625523230786,145,1,22.67,1,1,1,3
1515915625523233770,125,1,16.19,1,1,1,3
1515915625523236615,145,1,55.65,1,1,2,4
1515915625523236759,145,1,33.97,1,1,2,4
1515915625523238603,145,1,56.83,1,1,2,4
1515915625523244073,145,1,23.81,1,1,1,3
1515915625523248277,145,1,23.16,1,1,1,3
1515915625523249636,145,1,77.73,1,1,2,4
1515915625523250254,145,1,108.92,1,1,3,5
1515915625523253948,145,1,257.87,1,1,3,5
1515915625523256726,145,3,501.0,1,3,4,8
1515915625523259748,145,1,40.89,1,1,2,4
1515915625523260221,145,1,26.46,1,1,1,3
1515915625523261282,145,1,176.17,1,1,3,5
1515915625523261926,145,1,167.62,1,1,3,5
1515915625523263589,145,1,40.41,1,1,2,4
1515915625523263740,145,3,88.56,1,3,2,6
1515915625523265741,145,1,9.35,1,1,1,3
1515915625523269579,145,1,327.43,1,1,4,6
1515915625523273021,145,1,104.86,1,1,3,5
1515915625523279957,145,1,34.06,1,1,2,4
1515915625523280270,145,1,94.86,1,1,3,5
1515915625523284508,145,3,322.79999999999995,1,3,4,8
1515915625523286542,145,1,257.87,1,1,3,5
1515915625523291148,145,1,104.13,1,1,3,5
1515915625523298072,144,3,192.63,1,3,3,7
1515915625523298533,145,1,18.48,1,1,1,3
1515915625523300073,144,1,122.86,1,1,3,5
1515915625523300510,145,1,560.57,1,1,4,6
1515915625523302162,145,1,20.95,1,1,1,3
1515915625523304098,145,2,293.84,1,2,4,7
1515915625523320990,145,1,20.79,1,1,1,3
1515915625523325944,145,1,33.97,1,1,2,4
1515915625523326297,145,2,59.04,1,2,2,5
1515915625523331417,144,1,23.97,1,1,1,3
1515915625523332501,142,1,87.63,1,1,2,4
1515915625523339343,145,3,454.14,1,3,4,8
1515915625523348189,145,1,102.49,1,1,3,5
1515915625523354124,145,1,9.81,1,1,1,3
1515915625523366412,144,2,266.06,1,2,3,6
1515915625523366867,144,1,12.51,1,1,1,3
1515915625523367586,63,1,73.95,3,1,2,6
1515915625523368991,144,1,81.14,1,1,2,4
1515915625523375916,144,1,77.73,1,1,2,4
1515915625523380302,144,2,193.35000000000002,1,2,3,6
1515915625523380388,144,2,193.35000000000002,1,2,3,6
1515915625523380902,144,1,56.51,1,1,2,4
1515915625523383364,144,1,66.19,1,1,2,4
1515915625523387398,144,3,92.82000000000001,1,3,3,7
1515915625523392858,144,1,12.43,1,1,1,3
1515915625523394329,144,7,99.14,1,4,3,8
1515915625523403114,144,1,11.13,1,1,1,3
1515915625523403159,144,3,168.42000000000002,1,3,3,7
1515915625523403494,144,2,31.67,1,2,1,4
1515915625523417688,144,1,120.27,1,1,3,5
1515915625523417730,144,2,240.54,1,2,3,6
1515915625523420315,136,1,30.48,1,1,1,3
1515915625523424272,144,1,30.48,1,1,1,3
1515915625523425002,144,1,53.92,1,1,2,4
1515915625523425336,144,3,31.33,1,3,1,5
1515915625523435922,144,1,224.76,1,1,3,5
1515915625523437147,144,4,690.54,1,3,4,8
1515915625523437372,144,2,355.08000000000004,1,2,4,7
1515915625523440447,144,1,34.46,1,1,2,4
1515915625523441716,144,1,168.25,1,1,3,5
1515915625523458200,114,1,35.27,1,1,2,4
1515915625523464050,144,1,33.97,1,1,2,4
1515915625523465072,144,1,23.49,1,1,1,3
1515915625523469038,144,2,504.64,1,2,4,7
1515915625523469320,144,1,21.75,1,1,1,3
1515915625523474560,144,1,52.33,1,1,2,4
1515915625523476985,129,2,73.02,1,2,2,5
1515915625523478580,144,1,15.56,1,1,1,3
1515915625523481617,144,1,26.19,1,1,1,3
1515915625523488344,144,2,310.86,1,2,4,7
1515915625523491639,144,1,23.81,1,1,1,3
1515915625523498349,144,1,27.62,1,1,1,3
1515915625523501544,144,1,227.3,1,1,3,5
1515915625523505370,144,1,27.62,1,1,1,3
1515915625523505830,144,5,1598.27,1,4,4,9
1515915625523507270,88,1,468.54,2,1,4,7
1515915625523508718,144,1,28.1,1,1,1,3
1515915625523526426,144,1,57.62,1,1,2,4
1515915625523528469,144,1,19.68,1,1,1,3
1515915625523529348,105,3,146.10000000000002,2,3,3,8
1515915625523530840,144,1,9.35,1,1,1,3
1515915625523533020,144,1,11.11,1,1,1,3
1515915625523540302,144,1,21.4,1,1,1,3
1515915625523540488,144,1,29.9,1,1,1,3
1515915625523550269,144,2,87.3,1,2,2,5
1515915625523550681,144,1,138.92,1,1,3,5
1515915625523555952,143,2,253.36,1,2,3,6
1515915625523560370,144,1,12.98,1,1,1,3
1515915625523573259,48,1,18.57,3,1,1,5
1515915625523574984,144,1,20.29,1,1,1,3
1515915625523577846,124,2,47.3,1,2,2,5
1515915625523578720,144,3,10.68,1,3,1,5
1515915625523582165,143,1,15.87,1,1,1,3
1515915625523585535,144,1,27.65,1,1,1,3
1515915625523589164,144,1,136.29,1,1,3,5
1515915625523589942,144,1,192.86,1,1,3,5
1515915625523591759,144,3,517.0,1,3,4,8
1515915625523608198,138,2,122.86,1,2,3,6
1515915625523609747,144,1,31.43,1,1,1,3
1515915625523610572,116,1,10.13,1,1,1,3
1515915625523613312,144,1,43.11,1,1,2,4
1515915625523614804,144,1,31.43,1,1,1,3
1515915625523614921,144,1,53.51,1,1,2,4
1515915625523617448,19,2,21.8,4,2,1,7
1515915625523622482,144,2,86.22,1,2,2,5
1515915625523637184,144,1,11.65,1,1,1,3
1515915625523647097,14,1,399.48,4,1,4,9
1515915625523652903,144,1,19.37,1,1,1,3
1515915625523652965,144,2,43.68,1,2,2,5
1515915625523655324,144,1,314.68,1,1,4,6
1515915625523657786,144,2,743.94,1,2,4,7
1515915625523660843,144,3,412.89,1,3,4,8
1515915625523661236,144,1,29.52,1,1,1,3
1515915625523668160,144,1,61.27,1,1,2,4
1515915625523671389,144,1,26.98,1,1,1,3
1515915625523674021,29,4,84.84,4,3,2,9
1515915625523676827,90,6,397.74,2,4,4,10
1515915625523677075,134,1,172.38,1,1,3,5
1515915625523677128,144,1,75.29,1,1,2,4
1515915625523678060,144,1,204.29,1,1,3,5
1515915625523684986,144,1,277.1,1,1,3,5
1515915625523691985,144,1,327.43,1,1,4,6
1515915625523693896,144,2,112.54,1,2,3,6
1515915625523696973,143,3,264.58,1,3,3,7
1515915625523697848,144,1,115.71,1,1,3,5
1515915625523704676,144,2,841.26,1,2,4,7
1515915625523705734,139,5,245.41000000000003,1,4,3,8
1515915625523712354,138,2,408.58,1,2,4,7
1515915625523714862,129,1,210.68,1,1,3,5
1515915625523725538,144,2,18.7,1,2,1,4
1515915625523730781,144,1,14.86,1,1,1,3
1515915625523732759,144,1,10.84,1,1,1,3
1515915625523733128,144,1,10.84,1,1,1,3
1515915625523742657,135,1,20.38,1,1,1,3
1515915625523743681,144,1,204.29,1,1,3,5
1515915625523745324,144,2,230.0,1,2,3,6
1515915625523748497,144,1,23.49,1,1,1,3
1515915625523753682,144,1,47.78,1,1,2,4
1515915625523758558,144,1,25.71,1,1,1,3
1515915625523761159,142,1,42.78,1,1,2,4
1515915625523761189,138,13,1292.6299999999999,1,4,4,9
1515915625523761225,144,6,544.98,1,4,4,9
1515915625523764029,144,1,29.52,1,1,1,3
1515915625523771247,144,18,1634.94,1,4,4,9
1515915625523773162,136,2,230.0,1,2,3,6
1515915625523773168,138,1,146.92,1,1,3,5
1515915625523773949,144,2,56.2,1,2,2,5
1515915625523780128,144,1,21.43,1,1,1,3
1515915625523780315,54,3,609.87,3,3,4,10
1515915625523785463,144,2,18.7,1,2,1,4
1515915625523789155,65,1,303.02,3,1,4,8
1515915625523796205,143,1,30.16,1,1,1,3
1515915625523805437,143,1,33.65,1,1,2,4
1515915625523814183,143,2,277.84,1,2,3,6
1515915625523825887,143,3,34.95,1,3,2,6
1515915625523828610,143,1,28.0,1,1,1,3
1515915625523829968,143,1,151.75,1,1,3,5
1515915625523833635,103,5,964.3000000000001,2,4,4,10
1515915625523842832,143,1,52.13,1,1,2,4
1515915625523842905,143,2,20.42,1,2,1,4
1515915625523845306,143,1,11.65,1,1,1,3
1515915625523851549,143,2,36.82,1,2,2,5
1515915625523858547,139,2,27.3,1,2,1,4
1515915625523858643,143,1,1.57,1,1,1,3
1515915625523858815,143,1,72.16,1,1,2,4
1515915625523858910,87,1,18.41,2,1,1,4
1515915625523859899,143,5,151.6,1,4,3,8
1515915625523862705,143,1,43.11,1,1,2,4
1515915625523874385,131,2,515.74,1,2,4,7
1515915625523885000,143,1,617.83,1,1,4,6
1515915625523885677,143,1,97.41,1,1,3,5
1515915625523889243,143,1,24.92,1,1,1,3
1515915625523901647,140,1,98.73,1,1,3,5
1515915625523902530,143,1,32.6,1,1,2,4
1515915625523905522,124,1,15.08,1,1,1,3
1515915625523908509,143,1,10.16,1,1,1,3
1515915625523911000,143,1,10.16,1,1,1,3
1515915625523913764,143,1,292.83,1,1,4,6
1515915625523914971,140,1,33.65,1,1,2,4
1515915625523916577,143,4,774.16,1,3,4,8
1515915625523920196,140,4,234.28,1,3,3,7
1515915625523923317,143,1,139.13,1,1,3,5
1515915625523929151,143,1,13.03,1,1,1,3
1515915625523929380,143,1,115.0,1,1,3,5
1515915625523929397,143,2,230.0,1,2,3,6
1515915625523939101,76,1,32.76,2,1,2,5
1515915625523942774,143,3,52.38,1,3,2,6
1515915625523943354,143,1,1.57,1,1,1,3
1515915625523947480,143,1,32.22,1,1,1,3
1515915625523953462,143,1,31.32,1,1,1,3
1515915625523958130,143,4,702.84,1,3,4,8
1515915625523959165,52,2,188.6,3,2,3,8
1515915625523962862,143,1,45.24,1,1,2,4
1515915625523969820,143,1,39.06,1,1,2,4
1515915625523973105,143,3,243.42000000000002,1,3,3,7
1515915625523974603,143,2,122.58,1,2,3,6
1515915625523977498,143,1,33.02,1,1,2,4
1515915625523977856,119,8,147.44,1,4,3,8
1515915625523987102,143,1,281.06,1,1,3,5
1515915625523990007,143,2,165.04,1,2,3,6
1515915625523993648,138,1,33.02,1,1,2,4
1515915625523994242,139,2,154.48,1,2,3,6
1515915625523998986,140,1,26.19,1,1,1,3
1515915625523999204,143,1,204.29,1,1,3,5
1515915625524000486,143,1,365.38,1,1,4,6
1515915625524015946,115,1,32.22,1,1,1,3
1515915625524018420,143,1,229.38,1,1,3,5
1515915625524020636,143,1,163.52,1,1,3,5
1515915625524022424,143,2,54.92,1,2,2,5
1515915625524024054,26,2,112.53999999999999,4,2,3,9
1515915625524024492,143,1,138.92,1,1,3,5
1515915625524025179,143,3,100.94999999999999,1,3,3,7
1515915625524026353,101,1,150.65,2,1,3,6
1515915625524033619,143,1,45.24,1,1,2,4
1515915625524038492,143,4,691.44,1,3,4,8
1515915625524041770,143,3,55.41,1,3,2,6
1515915625524041889,143,1,122.86,1,1,3,5
1515915625524049247,143,2,68.08,1,2,2,5
1515915625524049325,143,1,17.62,1,1,1,3
1515915625524058458,87,1,38.46,2,1,2,5
1515915625524060615,98,1,23.76,2,1,1,4
1515915625524060625,98,1,23.76,2,1,1,4
1515915625524067454,128,2,903.13,1,2,4,7
1515915625524071892,133,1,322.57,1,1,4,6
1515915625524077087,143,2,14.98,1,2,1,4
1515915625524079685,143,1,7.49,1,1,1,3
1515915625524081233,120,2,134.7,1,2,3,6
1515915625524087603,143,2,197.96,1,2,3,6
1515915625524096238,143,1,40.63,1,1,2,4
1515915625524101444,135,3,598.11,1,3,4,8
1515915625524109289,143,4,104.76,1,3,3,7
1515915625524112060,143,3,90.96000000000001,1,3,3,7
1515915625524112412,143,1,184.51,1,1,3,5
1515915625524116593,143,3,490.56000000000006,1,3,4,8
1515915625524125896,117,2,310.2,1,2,4,7
1515915625524126577,143,2,42.86,1,2,2,5
1515915625524134096,143,7,163.03,1,4,3,8
1515915625524135114,141,2,80.0,1,2,2,5
1515915625524136759,143,1,21.43,1,1,1,3
1515915625524144461,142,1,4.29,1,1,1,3
1515915625524144476,143,1,1.57,1,1,1,3
1515915625524144731,143,1,33.27,1,1,2,4
1515915625524151270,143,1,176.17,1,1,3,5
1515915625524156076,141,2,15.26,1,2,1,4
1515915625524158782,143,1,17.14,1,1,1,3
1515915625524169034,143,2,62.22,1,2,2,5
1515915625524169084,143,1,31.11,1,1,1,3
1515915625524175756,143,1,199.37,1,1,3,5
1515915625524185998,143,1,279.7,1,1,3,5
1515915625524204938,142,1,110.48,1,1,3,5
1515915625524211212,142,2,45.290000000000006,1,2,2,5
1515915625524228369,142,1,26.98,1,1,1,3
1515915625524230334,142,3,37.14,1,3,2,6
1515915625524230747,142,1,75.29,1,1,2,4
1515915625524237516,142,1,20.32,1,1,1,3
1515915625524240738,138,1,104.21,1,1,3,5
1515915625524244089,142,1,23.17,1,1,1,3
1515915625524248063,142,1,8.0,1,1,1,3
1515915625524259712,142,1,80.35,1,1,2,4
1515915625524273474,142,1,115.4,1,1,3,5
1515915625524273483,142,2,42.22,1,2,2,5
1515915625524274739,142,3,296.94,1,3,4,8
1515915625524276381,114,1,204.79,1,1,3,5
1515915625524282777,75,11,991.54,2,4,4,10
1515915625524286653,142,1,26.98,1,1,1,3
1515915625524291440,142,1,50.16,1,1,2,4
1515915625524313392,142,1,55.6,1,1,2,4
1515915625524314575,142,4,177.16,1,3,3,7
1515915625524317221,142,1,12.48,1,1,1,3
1515915625524318572,142,1,75.94,1,1,2,4
1515915625524320780,142,1,292.83,1,1,4,6
1515915625524322611,94,2,762.92,2,2,4,8
1515915625524325417,141,1,45.24,1,1,2,4
1515915625524328972,142,4,175.16,1,3,3,7
1515915625524338645,142,1,26.98,1,1,1,3
1515915625524342720,137,1,32.37,1,1,2,4
1515915625524344814,142,2,135.24,1,2,3,6
1515915625524353171,142,2,102.66,1,2,3,6
1515915625524358164,142,2,585.66,1,2,4,7
1515915625524363645,142,1,17.73,1,1,1,3
1515915625524370865,142,1,11.57,1,1,1,3
1515915625524371274,142,1,19.68,1,1,1,3
1515915625524373045,142,3,166.8,1,3,3,7
1515915625524375958,142,1,16.19,1,1,1,3
1515915625524379508,136,1,101.1,1,1,3,5
1515915625524379959,142,1,19.68,1,1,1,3
1515915625524380375,142,1,204.29,1,1,3,5
1515915625524386365,142,1,30.16,1,1,1,3
1515915625524392193,142,2,45.019999999999996,1,2,2,5
1515915625524393350,142,1,18.41,1,1,1,3
1515915625524395300,142,1,87.7,1,1,2,4
1515915625524395399,142,1,49.57,1,1,2,4
1515915625524397442,142,1,16.35,1,1,1,3
1515915625524400478,142,1,34.79,1,1,2,4
1515915625524401994,142,1,12.22,1,1,1,3
1515915625524407477,142,1,60.54,1,1,2,4
1515915625524417989,142,1,204.29,1,1,3,5
1515915625524421544,142,1,12.38,1,1,1,3
1515915625524422978,123,3,87.66,1,3,2,6
1515915625524423738,142,1,112.4,1,1,3,5
1515915625524424201,142,1,26.98,1,1,1,3
1515915625524424303,142,1,40.0,1,1,2,4
1515915625524426429,142,1,15.87,1,1,1,3
1515915625524427187,142,1,27.62,1,1,1,3
1515915625524428006,124,1,64.48,1,1,2,4
1515915625524431404,96,6,89.16,2,4,2,8
1515915625524431513,142,1,656.63,1,1,4,6
1515915625524432602,142,2,62.22,1,2,2,5
1515915625524433083,142,3,193.44,1,3,3,7
1515915625524435421,119,5,444.45,1,4,4,9
1515915625524435516,142,1,32.06,1,1,1,3
1515915625524437112,142,1,26.57,1,1,1,3
1515915625524441642,142,1,167.62,1,1,3,5
1515915625524442296,139,3,608.01,1,3,4,8
1515915625524442660,142,1,7.86,1,1,1,3
1515915625524443007,142,2,65.42,1,2,2,5
1515915625524445292,141,5,52.23,1,4,2,7
1515915625524448160,123,2,52.38,1,2,2,5
1515915625524452145,141,2,56.82,1,2,2,5
1515915625524453154,142,1,67.62,1,1,2,4
1515915625524457371,131,1,55.6,1,1,2,4
1515915625524459093,142,1,69.08,1,1,2,4
1515915625524460823,141,5,368.28,1,4,4,9
1515915625524467912,142,1,20.95,1,1,1,3
1515915625524468720,142,1,40.32,1,1,2,4
1515915625524471001,141,2,45.72,1,2,2,5
1515915625524471410,142,1,67.62,1,1,2,4
1515915625524471664,142,1,40.41,1,1,2,4
1515915625524477394,142,1,39.75,1,1,2,4
1515915625524483621,142,1,21.75,1,1,1,3
1515915625524503734,142,1,18.89,1,1,1,3
1515915625524504728,142,1,42.57,1,1,2,4
1515915625524505727,79,1,40.48,2,1,2,5
1515915625524509199,142,2,52.38,1,2,2,5
1515915625524515963,130,1,50.57,1,1,2,4
1515915625524516022,14,2,215.58,4,2,3,9
1515915625524516394,142,1,33.97,1,1,2,4
1515915625524519215,142,1,19.1,1,1,1,3
1515915625524521246,52,1,68.57,3,1,2,6
1515915625524522215,142,1,34.9,1,1,2,4
1515915625524522297,133,1,16.19,1,1,1,3
1515915625524522427,142,1,17.49,1,1,1,3
1515915625524526524,142,3,79.38,1,3,2,6
1515915625524526644,134,1,239.38,1,1,3,5
1515915625524544143,142,1,40.0,1,1,2,4
1515915625524548839,116,3,760.14,1,3,4,8
1515915625524549359,141,2,52.92,1,2,2,5
1515915625524557293,141,1,38.37,1,1,2,4
1515915625524559745,141,1,16.98,1,1,1,3
1515915625524565394,141,1,6.68,1,1,1,3
1515915625524576292,141,2,48.57,1,2,2,5
1515915625524576398,16,1,201.33,4,1,3,8
1515915625524577567,116,2,79.5,1,2,2,5
1515915625524578593,141,3,27.42,1,3,1,5
1515915625524580232,117,5,104.75,1,4,3,8
1515915625524582379,141,2,10.92,1,2,1,4
1515915625524583209,141,1,210.62,1,1,3,5
1515915625524584380,141,1,294.41,1,1,4,6
1515915625524584883,139,1,268.17,1,1,3,5
1515915625524585819,141,1,294.41,1,1,4,6
1515915625524592099,141,1,57.46,1,1,2,4
1515915625524594809,141,2,110.7,1,2,3,6
1515915625524604623,141,1,22.22,1,1,1,3
1515915625524604953,141,1,55.35,1,1,2,4
1515915625524607285,102,1,176.17,2,1,3,6
1515915625524623031,141,1,156.73,1,1,3,5
1515915625524624847,141,2,30.16,1,2,1,4
1515915625524626182,141,1,1.57,1,1,1,3
1515915625524628491,141,20,3643.88,1,4,4,9
1515915625524630866,59,7,1990.1000000000001,3,4,4,11
1515915625524631720,141,1,143.46,1,1,3,5
1515915625524633116,141,2,45.290000000000006,1,2,2,5
1515915625524637720,141,1,25.4,1,1,1,3
1515915625524646756,141,1,26.19,1,1,1,3
1515915625524648405,137,1,16.19,1,1,1,3
1515915625524661060,141,1,27.14,1,1,1,3
1515915625524663955,141,1,87.16,1,1,2,4
1515915625524669360,141,1,33.97,1,1,2,4
1515915625524671832,141,1,36.35,1,1,2,4
1515915625524682866,139,2,67.94,1,2,2,5
1515915625524689449,141,1,98.41,1,1,3,5
1515915625524690368,141,1,57.62,1,1,2,4
1515915625524691842,138,3,96.44000000000001,1,3,3,7
1515915625524692448,141,1,15.08,1,1,1,3
1515915625524692530,141,1,127.08,1,1,3,5
1515915625524705572,140,3,497.06999999999994,1,3,4,8
1515915625524707343,141,3,368.58,1,3,4,8
1515915625524707541,141,1,122.86,1,1,3,5
1515915625524709351,141,2,49.599999999999994,1,2,2,5
1515915625524709530,141,1,32.22,1,1,1,3
1515915625524716454,141,2,38.74,1,2,2,5
1515915625524717702,141,1,115.4,1,1,3,5
1515915625524720349,141,1,43.17,1,1,2,4
1515915625524726795,141,2,26.04,1,2,1,4
1515915625524743054,141,1,43.11,1,1,2,4
1515915625524743740,141,1,18.7,1,1,1,3
1515915625524745491,141,1,25.4,1,1,1,3
1515915625524746123,124,1,259.38,1,1,3,5
1515915625524748957,141,1,134.13,1,1,3,5
1515915625524749845,133,3,135.72,1,3,3,7
1515915625524751222,140,1,11.65,1,1,1,3
1515915625524753747,141,1,9.35,1,1,1,3
1515915625524757669,141,1,34.79,1,1,2,4
1515915625524764764,141,1,63.35,1,1,2,4
1515915625524768731,141,1,29.32,1,1,1,3
1515915625524770923,140,2,23.24,1,2,1,4
1515915625524775842,141,1,403.46,1,1,4,6
1515915625524779671,141,3,1120.3799999999999,1,3,4,8
1515915625524782537,41,3,491.89,3,3,4,10
1515915625524788621,140,1,40.32,1,1,2,4
1515915625524790346,90,1,10.43,2,1,1,4
1515915625524792359,141,1,27.62,1,1,1,3
1515915625524792894,141,1,401.49,1,1,4,6
1515915625524795928,141,1,9.92,1,1,1,3
1515915625524800358,140,3,76.56,1,3,2,6
1515915625524802322,141,1,27.14,1,1,1,3
1515915625524815210,141,1,59.76,1,1,2,4
1515915625524817324,140,1,18.73,1,1,1,3
1515915625524828636,141,1,184.13,1,1,3,5
1515915625524832109,141,1,26.46,1,1,1,3
1515915625524838941,139,2,122.58,1,2,3,6
1515915625524846165,141,3,49.29,1,3,2,6
1515915625524847015,141,1,17.78,1,1,1,3
1515915625524847906,141,1,16.43,1,1,1,3
1515915625524849860,81,1,104.13,2,1,3,6
1515915625524855855,95,3,177.96,2,3,3,8
1515915625524859767,141,2,172.7,1,2,3,6
1515915625524861516,141,7,1078.46,1,4,4,9
1515915625524862937,141,2,34.92,1,2,2,5
1515915625524863168,140,4,423.48,1,3,4,8
1515915625524863914,140,1,18.57,1,1,1,3
1515915625524865621,141,1,16.05,1,1,1,3
1515915625524873288,126,1,82.22,1,1,2,4
1515915625524876002,122,1,56.27,1,1,2,4
1515915625524882815,48,1,284.3,3,1,3,7
1515915625524883233,141,2,67.72,1,2,2,5
1515915625524888396,141,1,32.38,1,1,2,4
1515915625524891877,141,1,35.89,1,1,2,4
1515915625524894841,141,1,127.08,1,1,3,5
1515915625524895071,141,1,9.35,1,1,1,3
1515915625524907714,134,3,248.91,1,3,3,7
1515915625524920883,141,1,381.46,1,1,4,6
1515915625524923102,141,2,375.56,1,2,4,7
1515915625524923592,141,1,23.78,1,1,1,3
1515915625524926496,72,3,103.85999999999999,3,3,3,9
1515915625524939268,140,1,49.38,1,1,2,4
1515915625524946730,140,1,36.35,1,1,2,4
1515915625524963216,125,2,1080.28,1,2,4,7
1515915625524972764,140,1,27.46,1,1,1,3
1515915625524974086,132,9,1457.1299999999999,1,4,4,9
1515915625524981067,140,2,40.16,1,2,2,5
1515915625524985423,140,1,204.29,1,1,3,5
1515915625524986054,140,2,210.88,1,2,3,6
1515915625524989378,140,1,23.33,1,1,1,3
1515915625524989675,140,4,769.52,1,3,4,8
1515915625524990215,140,2,28.16,1,2,1,4
1515915625524991789,140,1,192.38,1,1,3,5
1515915625524993946,138,1,55.65,1,1,2,4
1515915625524999588,140,8,627.16,1,4,4,9
1515915625525003542,140,1,35.1,1,1,2,4
1515915625525004012,140,1,22.22,1,1,1,3
1515915625525019219,137,1,48.89,1,1,2,4
1515915625525020446,140,1,53.33,1,1,2,4
1515915625525021315,140,1,23.17,1,1,1,3
1515915625525023223,140,1,19.52,1,1,1,3
1515915625525037478,140,3,1252.5,1,3,4,8
1515915625525040298,140,1,125.4,1,1,3,5
1515915625525041864,127,2,207.66,1,2,3,6
1515915625525045917,140,3,681.9000000000001,1,3,4,8
1515915625525051196,89,1,16.35,2,1,1,4
1515915625525051467,131,1,43.13,1,1,2,4
1515915625525065489,140,1,34.22,1,1,2,4
1515915625525079118,140,2,28.29,1,2,1,4
1515915625525082283,132,1,23.81,1,1,1,3
1515915625525082314,140,1,23.81,1,1,1,3
1515915625525087579,140,1,414.78,1,1,4,6
1515915625525097018,140,2,31.74,1,2,1,4
1515915625525098495,140,1,33.19,1,1,2,4
1515915625525105717,140,3,317.61,1,3,4,8
1515915625525113477,140,1,19.37,1,1,1,3
1515915625525114572,140,1,257.87,1,1,3,5
1515915625525118289,140,2,83.5,1,2,2,5
1515915625525118629,140,1,33.33,1,1,2,4
1515915625525118943,80,1,118.57,2,1,3,6
1515915625525122644,140,2,253.36,1,2,3,6
1515915625525123542,140,1,126.68,1,1,3,5
1515915625525125522,140,1,27.73,1,1,1,3
1515915625525127258,117,2,46.44,1,2,2,5
1515915625525131336,140,1,1.57,1,1,1,3
1515915625525134382,131,1,134.13,1,1,3,5
1515915625525134539,140,2,51.72,1,2,2,5
1515915625525139345,118,1,6.43,1,1,1,3
1515915625525141026,137,3,967.71,1,3,4,8
1515915625525141073,140,1,24.13,1,1,1,3
1515915625525141972,137,1,10.08,1,1,1,3
1515915625525145401,140,1,15.08,1,1,1,3
1515915625525146363,140,1,64.48,1,1,2,4
1515915625525153911,140,1,116.0,1,1,3,5
1515915625525160092,133,3,325.68,1,3,4,8
1515915625525160657,139,2,69.84,1,2,2,5
1515915625525161075,111,2,329.59,2,2,4,8
1515915625525161698,140,2,174.92,1,2,3,6
1515915625525163776,140,1,126.68,1,1,3,5
1515915625525164916,140,1,126.68,1,1,3,5
1515915625525167104,140,1,23.81,1,1,1,3
1515915625525170721,140,1,21.21,1,1,1,3
1515915625525179311,125,1,23.57,1,1,1,3
1515915625525181548,140,2,72.34,1,2,2,5
1515915625525187202,140,1,23.48,1,1,1,3
1515915625525187429,140,1,55.6,1,1,2,4
1515915625525187873,140,1,73.81,1,1,2,4
1515915625525194825,140,1,34.73,1,1,2,4
1515915625525196335,123,2,227.62,1,2,3,6
1515915625525197775,82,3,78.57000000000001,2,3,2,7
1515915625525197889,140,1,740.67,1,1,4,6
1515915625525199494,140,1,45.24,1,1,2,4
1515915625525202305,140,1,29.52,1,1,1,3
1515915625525203209,140,1,26.98,1,1,1,3
1515915625525207465,140,1,104.13,1,1,3,5
1515915625525210928,140,1,14.86,1,1,1,3
1515915625525211280,140,6,615.63,1,4,4,9
1515915625525215115,140,2,18.7,1,2,1,4
1515915625525215686,140,1,102.11,1,1,3,5
1515915625525216751,140,1,12.22,1,1,1,3
1515915625525221544,131,2,134.28,1,2,3,6
1515915625525221880,140,1,136.05,1,1,3,5
1515915625525222328,140,1,55.87,1,1,2,4
1515915625525225052,140,1,50.6,1,1,2,4
1515915625525230411,64,2,24.44,3,2,1,6
1515915625525233692,140,1,32.76,1,1,2,4
1515915625525234709,140,1,249.02,1,1,3,5
1515915625525236825,140,1,94.1,1,1,3,5
1515915625525236993,140,1,83.22,1,1,2,4
1515915625525237049,140,1,94.1,1,1,3,5
1515915625525237166,140,1,10.65,1,1,1,3
1515915625525240887,139,2,594.82,1,2,4,7
1515915625525243865,93,2,104.12,2,2,3,7
1515915625525247549,140,1,18.57,1,1,1,3
1515915625525248260,140,1,210.9,1,1,3,5
1515915625525253560,140,1,23.13,1,1,1,3
1515915625525256569,140,1,30.16,1,1,1,3
1515915625525259363,113,1,57.62,2,1,2,5
1515915625525263658,140,1,71.38,1,1,2,4
1515915625525265732,127,3,129.39000000000001,1,3,3,7
1515915625525268971,140,1,159.1,1,1,3,5
1515915625525271124,123,2,35.24,1,2,2,5
1515915625525281297,140,2,101.58,1,2,3,6
1515915625525283670,140,1,88.54,1,1,2,4
1515915625525284662,140,1,26.98,1,1,1,3
1515915625525285865,140,1,16.05,1,1,1,3
1515915625525288261,139,4,239.28,1,3,3,7
1515915625525294041,139,1,57.62,1,1,2,4
1515915625525307867,140,2,288.58,1,2,4,7
1515915625525309350,140,1,49.38,1,1,2,4
1515915625525316028,138,1,73.81,1,1,2,4
1515915625525333944,139,1,15.4,1,1,1,3
1515915625525338775,139,1,21.02,1,1,1,3
1515915625525339152,114,7,1011.5699999999999,1,4,4,9
1515915625525343349,139,1,40.32,1,1,2,4
1515915625525346079,139,1,26.48,1,1,1,3
1515915625525349335,139,1,32.22,1,1,1,3
1515915625525361344,139,1,34.76,1,1,2,4
1515915625525364134,139,1,12.7,1,1,1,3
1515915625525365803,139,2,428.2,1,2,4,7
1515915625525368048,115,1,399.48,1,1,4,6
1515915625525372749,139,1,20.38,1,1,1,3
1515915625525373371,139,2,69.84,1,2,2,5
1515915625525379537,139,1,13.65,1,1,1,3
1515915625525381800,139,1,104.86,1,1,3,5
1515915625525384626,139,1,21.59,1,1,1,3
1515915625525385558,137,1,22.22,1,1,1,3
1515915625525386862,139,1,11.13,1,1,1,3
1515915625525387105,139,1,122.86,1,1,3,5
1515915625525389738,139,2,408.58,1,2,4,7
1515915625525392184,139,1,153.83,1,1,3,5
1515915625525393317,139,1,322.57,1,1,4,6
1515915625525393727,139,1,18.57,1,1,1,3
1515915625525393881,139,1,18.73,1,1,1,3
1515915625525394503,132,1,44.13,1,1,2,4
1515915625525395588,139,1,5.16,1,1,1,3
1515915625525397378,139,2,401.47999999999996,1,2,4,7
1515915625525399461,139,1,153.83,1,1,3,5
1515915625525400947,110,1,171.41,2,1,3,6
1515915625525405435,131,2,72.28,1,2,2,5
1515915625525406075,139,1,203.02,1,1,3,5
1515915625525407015,139,1,142.05,1,1,3,5
1515915625525408714,139,1,1.57,1,1,1,3
1515915625525408819,139,1,43.11,1,1,2,4
1515915625525410736,139,1,29.22,1,1,1,3
1515915625525411674,131,3,575.56,1,3,4,8
1515915625525412276,139,2,86.22,1,2,2,5
1515915625525412406,139,1,224.76,1,1,3,5
1515915625525418565,139,1,9.35,1,1,1,3
1515915625525422459,139,1,43.11,1,1,2,4
1515915625525428496,137,1,9.35,1,1,1,3
1515915625525430030,114,1,26.57,1,1,1,3
1515915625525430253,136,2,40.28,1,2,2,5
1515915625525432852,139,1,46.06,1,1,2,4
1515915625525433271,139,1,23.76,1,1,1,3
1515915625525433963,139,1,415.54,1,1,4,6
1515915625525438232,130,1,457.51,1,1,4,6
1515915625525443588,137,2,126.32,1,2,3,6
1515915625525451447,66,2,333.02,3,2,4,9
1515915625525456896,139,1,43.11,1,1,2,4
1515915625525457579,139,1,32.22,1,1,1,3
1515915625525459432,139,2,19.68,1,2,1,4
1515915625525467302,139,1,100.75,1,1,3,5
1515915625525467473,139,1,36.49,1,1,2,4
1515915625525475444,139,1,18.25,1,1,1,3
1515915625525475824,139,1,29.22,1,1,1,3
1515915625525478714,139,1,26.67,1,1,1,3
1515915625525482499,139,1,26.67,1,1,1,3
1515915625525487645,139,1,15.08,1,1,1,3
1515915625525493804,112,1,16.97,2,1,1,4
1515915625525496376,115,3,271.14,1,3,3,7
1515915625525496932,139,1,23.33,1,1,1,3
1515915625525498113,138,1,25.63,1,1,1,3
1515915625525501433,139,1,415.54,1,1,4,6
1515915625525502065,139,2,39.74,1,2,2,5
1515915625525506285,139,1,16.67,1,1,1,3
1515915625525507033,139,3,126.51,1,3,3,7
1515915625525510447,139,1,13.52,1,1,1,3
1515915625525510466,138,1,22.43,1,1,1,3
1515915625525511411,134,2,176.5,1,2,3,6
1515915625525520214,35,1,9.84,4,1,1,6
1515915625525522240,139,3,31.380000000000003,1,3,1,5
1515915625525533314,139,1,77.73,1,1,2,4
1515915625525546621,139,1,20.14,1,1,1,3
1515915625525548010,139,1,20.14,1,1,1,3
1515915625525549218,122,2,408.58,1,2,4,7
1515915625525550647,139,9,977.6,1,4,4,9
1515915625525551148,139,1,35.84,1,1,2,4
1515915625525560363,139,1,28.57,1,1,1,3
1515915625525564508,127,1,15.1,1,1,1,3
1515915625525571895,139,1,1.57,1,1,1,3
1515915625525575109,137,1,170.0,1,1,3,5
1515915625525580847,137,1,18.48,1,1,1,3
1515915625525583653,139,2,16.169999999999998,1,2,1,4
1515915625525584243,138,2,30.2,1,2,1,4
1515915625525589160,139,2,406.04,1,2,4,7
1515915625525594230,139,1,24.75,1,1,1,3
1515915625525594492,135,2,24.92,1,2,1,4
1515915625525595211,139,4,204.44,1,3,3,7
1515915625525603175,139,1,224.76,1,1,3,5
1515915625525603207,139,1,15.87,1,1,1,3
1515915625525603710,139,1,259.38,1,1,3,5
1515915625525607607,139,1,37.05,1,1,2,4
1515915625525609863,139,1,10.32,1,1,1,3
1515915625525615042,139,1,26.46,1,1,1,3
1515915625525619842,139,3,959.8199999999999,1,3,4,8
1515915625525625987,137,5,178.55,1,4,3,8
1515915625525626396,113,1,136.29,2,1,3,6
1515915625525626435,139,1,136.29,1,1,3,5
1515915625525628263,139,1,33.65,1,1,2,4
1515915625525631928,139,1,134.13,1,1,3,5
1515915625525638548,109,5,1136.5,2,4,4,10
1515915625525643284,139,1,9.84,1,1,1,3
1515915625525645311,139,1,40.0,1,1,2,4
1515915625525645476,139,1,9.84,1,1,1,3
1515915625525648246,138,1,82.97,1,1,2,4
1515915625525650096,138,1,75.29,1,1,2,4
1515915625525651625,105,3,209.74,2,3,3,8
1515915625525651799,137,1,26.46,1,1,1,3
1515915625525654309,138,1,155.1,1,1,3,5
1515915625525663524,139,1,49.21,1,1,2,4
1515915625525667486,139,1,104.21,1,1,3,5
1515915625525668150,133,1,337.44,1,1,4,6
1515915625525679533,139,1,61.29,1,1,2,4
1515915625525680047,103,1,9.84,2,1,1,4
1515915625525688842,108,2,907.96,2,2,4,8
1515915625525693197,139,1,20.0,1,1,1,3
1515915625525706300,139,2,65.42,1,2,2,5
1515915625525707480,139,1,14.29,1,1,1,3
1515915625525714004,139,2,56.2,1,2,2,5
1515915625525714876,136,1,187.29,1,1,3,5
1515915625525714984,138,1,187.29,1,1,3,5
1515915625525721741,138,4,521.45,1,3,4,8
1515915625525724799,138,2,325.74,1,2,4,7
1515915625525730142,138,1,162.87,1,1,3,5
1515915625525735279,138,2,67.94,1,2,2,5
1515915625525735331,138,3,22.71,1,3,1,5
1515915625525746294,138,3,32.519999999999996,1,3,2,6
1515915625525749086,84,2,23.18,2,2,1,5
1515915625525753062,128,2,1173.08,1,2,4,7
1515915625525760206,138,1,30.54,1,1,1,3
1515915625525762894,138,1,29.22,1,1,1,3
1515915625525766190,138,1,29.21,1,1,1,3
1515915625525768945,40,1,205.25,3,1,3,7
1515915625525778250,138,1,20.79,1,1,1,3
1515915625525779443,138,1,32.22,1,1,1,3
1515915625525787124,138,1,215.06,1,1,3,5
1515915625525787801,138,1,38.78,1,1,2,4
1515915625525792421,138,1,1.57,1,1,1,3
1515915625525795272,115,1,23.7,1,1,1,3
1515915625525795723,138,1,15.1,1,1,1,3
1515915625525796801,138,1,204.29,1,1,3,5
1515915625525797274,138,1,23.7,1,1,1,3
1515915625525803347,138,7,41.86,1,4,2,7
1515915625525807827,138,1,33.97,1,1,2,4
1515915625525811484,138,2,43.62,1,2,2,5
1515915625525818725,138,2,515.74,1,2,4,7
1515915625525818869,119,2,59.14,1,2,2,5
1515915625525821208,138,1,43.11,1,1,2,4
1515915625525827148,138,2,58.32,1,2,2,5
1515915625525831210,138,2,245.72,1,2,3,6
1515915625525832703,138,1,29.52,1,1,1,3
1515915625525832908,138,2,175.4,1,2,3,6
1515915625525834147,138,1,29.52,1,1,1,3
1515915625525834367,138,1,116.05,1,1,3,5
1515915625525836110,138,1,12.27,1,1,1,3
1515915625525839284,138,1,731.83,1,1,4,6
1515915625525839356,138,1,30.16,1,1,1,3
1515915625525839644,137,1,64.48,1,1,2,4
1515915625525840156,138,1,107.79,1,1,3,5
1515915625525841093,138,2,66.38,1,2,2,5
1515915625525841341,138,1,26.19,1,1,1,3
1515915625525850071,137,2,29.2,1,2,1,4
1515915625525851361,138,2,37.78,1,2,2,5
1515915625525851403,138,1,9.35,1,1,1,3
1515915625525852140,138,1,16.98,1,1,1,3
1515915625525854773,138,1,0.9,1,1,1,3
1515915625525855335,138,1,16.98,1,1,1,3
1515915625525856497,110,2,65.34,2,2,2,6
1515915625525865288,138,1,172.38,1,1,3,5
1515915625525865757,138,1,18.11,1,1,1,3
1515915625525866995,138,1,18.11,1,1,1,3
1515915625525868258,137,1,12.14,1,1,1,3
1515915625525900715,125,1,98.41,1,1,3,5
1515915625525900930,138,1,98.41,1,1,3,5
1515915625525905111,138,1,45.24,1,1,2,4
1515915625525905748,138,2,336.09000000000003,1,2,4,7
1515915625525907963,138,4,95.88,1,3,3,7
1515915625525909198,138,2,79.5,1,2,2,5
1515915625525910520,138,1,13.52,1,1,1,3
1515915625525911482,138,3,525.5699999999999,1,3,4,8
1515915625525911886,138,1,84.89,1,1,2,4
1515915625525911888,138,2,28.58,1,2,1,4
1515915625525913353,138,1,84.89,1,1,2,4
1515915625525916471,138,1,29.68,1,1,1,3
1515915625525916754,138,1,46.67,1,1,2,4
1515915625525917302,138,1,105.29,1,1,3,5
1515915625525922024,124,1,24.16,1,1,1,3
1515915625525922466,136,1,17.25,1,1,1,3
1515915625525924814,138,1,488.02,1,1,4,6
1515915625525945983,138,1,24.98,1,1,1,3
1515915625525948273,138,4,143.48,1,3,3,7
1515915625525950257,138,1,32.22,1,1,1,3
1515915625525953560,138,1,55.16,1,1,2,4
1515915625525954236,138,1,62.71,1,1,2,4
1515915625525957721,102,2,327.04,2,2,4,8
1515915625525958021,138,1,23.75,1,1,1,3
1515915625525958230,84,1,519.56,2,1,4,7
1515915625525958728,138,3,247.56,1,3,3,7
1515915625525961998,138,1,31.11,1,1,1,3
1515915625525964330,109,2,307.66,2,2,4,8
1515915625525966772,126,1,27.14,1,1,1,3
1515915625525967214,138,2,50.16,1,2,2,5
1515915625525969163,136,1,32.22,1,1,1,3
1515915625525972226,138,2,29.0,1,2,1,4
1515915625525973595,138,1,15.35,1,1,1,3
1515915625525977241,137,1,140.86,1,1,3,5
1515915625525980491,138,1,15.08,1,1,1,3
1515915625525984515,138,1,27.62,1,1,1,3
1515915625525987075,138,3,307.38,1,3,4,8
1515915625525988580,138,1,27.62,1,1,1,3
1515915625525993469,118,2,178.43,1,2,3,6
1515915625525993820,137,1,43.11,1,1,2,4
1515915625525995498,138,3,104.28,1,3,3,7
1515915625526004502,128,3,184.61,1,3,3,7
1515915625526004535,138,1,3.02,1,1,1,3
1515915625526004835,138,2,111.3,1,2,3,6
1515915625526006122,138,1,27.32,1,1,1,3
1515915625526006124,104,1,34.92,2,1,2,5
1515915625526006630,138,1,17.49,1,1,1,3
1515915625526006794,138,1,27.49,1,1,1,3
1515915625526008181,138,4,128.24,1,3,3,7
1515915625526008292,137,2,293.84,1,2,4,7
1515915625526009435,69,6,441.53,3,4,4,11
1515915625526009967,138,3,490.56000000000006,1,3,4,8
1515915625526012569,138,1,10.6,1,1,1,3
1515915625526019340,138,2,692.16,1,2,4,7
1515915625526020082,138,1,10.6,1,1,1,3
1515915625526020499,138,1,26.19,1,1,1,3
1515915625526024583,63,3,76.19999999999999,3,3,2,8
1515915625526026300,137,1,38.41,1,1,2,4
1515915625526040386,138,1,11.43,1,1,1,3
1515915625526043633,138,1,13.03,1,1,1,3
1515915625526047537,138,1,107.79,1,1,3,5
1515915625526048933,138,1,94.41,1,1,3,5
1515915625526058281,11,4,1754.01,4,3,4,11
1515915625526066847,138,2,18.7,1,2,1,4
1515915625526074837,138,1,9.35,1,1,1,3
1515915625526084284,138,1,24.92,1,1,1,3
1515915625526085232,138,1,29.22,1,1,1,3
1515915625526086568,137,1,97.41,1,1,3,5
1515915625526093690,138,4,42.52,1,3,2,6
1515915625526098240,138,1,45.24,1,1,2,4
1515915625526105313,138,1,89.21,1,1,2,4
1515915625526105620,138,1,30.38,1,1,1,3
1515915625526120062,134,2,30.16,1,2,1,4
1515915625526134903,137,5,161.1,1,4,3,8
1515915625526139606,138,1,155.1,1,1,3,5
1515915625526139762,138,1,155.1,1,1,3,5
1515915625526143776,137,4,67.97,1,3,2,6
1515915625526147607,138,1,35.87,1,1,2,4
1515915625526148813,138,1,12.86,1,1,1,3
1515915625526153878,138,1,108.35,1,1,3,5
1515915625526154987,138,2,61.08,1,2,2,5
1515915625526167180,137,1,62.71,1,1,2,4
1515915625526173400,137,1,15.38,1,1,1,3
1515915625526174073,137,1,33.19,1,1,2,4
1515915625526182650,137,3,96.66,1,3,3,7
1515915625526195118,137,5,206.45,1,4,3,8
1515915625526195713,137,1,294.41,1,1,4,6
1515915625526202918,137,1,15.08,1,1,1,3
1515915625526212343,137,1,50.63,1,1,2,4
1515915625526217902,137,1,50.63,1,1,2,4
1515915625526217986,137,1,21.21,1,1,1,3
1515915625526222457,137,2,129.1,1,2,3,6
1515915625526227048,137,1,48.27,1,1,2,4
1515915625526232166,137,1,113.48,1,1,3,5
1515915625526244779,137,1,8.79,1,1,1,3
1515915625526245934,137,1,21.46,1,1,1,3
1515915625526255463,132,10,336.5,1,4,4,9
1515915625526273204,137,1,64.48,1,1,2,4
1515915625526274907,137,2,122.34,1,2,3,6
1515915625526275622,137,2,210.58,1,2,3,6
1515915625526278854,137,2,127.96,1,2,3,6
1515915625526280013,137,1,21.25,1,1,1,3
1515915625526281895,136,2,27.3,1,2,1,4
1515915625526282600,137,1,345.44,1,1,4,6
1515915625526284766,137,1,1.57,1,1,1,3
1515915625526286808,137,3,509.01,1,3,4,8
1515915625526287114,137,1,48.7,1,1,2,4
1515915625526288427,137,2,89.13,1,2,2,5
1515915625526290975,137,1,19.16,1,1,1,3
1515915625526292514,127,2,60.76,1,2,2,5
1515915625526294699,137,1,42.38,1,1,2,4
1515915625526297047,137,5,1180.0,1,4,4,9
1515915625526299006,137,1,135.21,1,1,3,5
1515915625526299369,133,4,207.0,1,3,3,7
1515915625526299425,134,4,211.76,1,3,3,7
1515915625526302288,137,1,122.86,1,1,3,5
1515915625526311637,137,2,29.21,1,2,1,4
1515915625526312960,137,1,125.08,1,1,3,5
1515915625526313687,128,3,102.18,1,3,3,7
1515915625526314100,137,1,76.03,1,1,2,4
1515915625526316699,137,2,36.82,1,2,2,5
1515915625526317361,137,1,13.81,1,1,1,3
1515915625526320197,129,5,156.35,1,4,3,8
1515915625526322495,137,1,26.19,1,1,1,3
1515915625526325903,137,2,24.53,1,2,1,4
1515915625526329017,137,1,31.11,1,1,1,3
1515915625526329882,137,1,17.9,1,1,1,3
1515915625526331460,137,1,22.79,1,1,1,3
1515915625526335093,114,1,26.46,1,1,1,3
1515915625526338078,121,1,539.57,1,1,4,6
1515915625526339124,137,1,122.86,1,1,3,5
1515915625526339561,121,3,1279.49,1,3,4,8
1515915625526340321,137,1,72.38,1,1,2,4
1515915625526342267,119,2,188.12,1,2,3,6
1515915625526346138,137,1,103.83,1,1,3,5
1515915625526353407,137,1,43.11,1,1,2,4
1515915625526354450,137,2,361.46,1,2,4,7
1515915625526361824,137,1,1.57,1,1,1,3
1515915625526362354,137,1,33.65,1,1,2,4
1515915625526366528,137,1,20.13,1,1,1,3
1515915625526375332,137,1,60.21,1,1,2,4
1515915625526375526,137,1,10.1,1,1,1,3
1515915625526380994,137,1,10.43,1,1,1,3
1515915625526382468,137,4,58.84,1,3,2,6
1515915625526384026,137,2,9.34,1,2,1,4
1515915625526384517,137,1,260.3,1,1,3,5
1515915625526388423,137,2,310.2,1,2,4,7
1515915625526388432,137,2,115.26,1,2,3,6
1515915625526389606,137,1,21.6,1,1,1,3
1515915625526393288,137,2,30.48,1,2,1,4
1515915625526394279,137,1,441.49,1,1,4,6
1515915625526398154,137,1,19.38,1,1,1,3
1515915625526400042,135,1,149.7,1,1,3,5
1515915625526400594,137,7,855.19,1,4,4,9
1515915625526401449,49,7,615.47,3,4,4,11
1515915625526401747,136,4,711.8,1,3,4,8
1515915625526412456,137,2,28.89,1,2,1,4
1515915625526412946,137,1,78.3,1,1,2,4
1515915625526414446,137,2,28.16,1,2,1,4
1515915625526414626,137,2,42.54,1,2,2,5
1515915625526415496,137,1,14.6,1,1,1,3
1515915625526415678,135,3,642.3,1,3,4,8
1515915625526416405,137,1,71.83,1,1,2,4
1515915625526416648,86,2,171.82,2,2,3,7
1515915625526418551,124,1,50.33,1,1,2,4
1515915625526418813,137,2,100.01,1,2,3,6
1515915625526422141,137,1,53.24,1,1,2,4
1515915625526425255,137,1,34.3,1,1,2,4
1515915625526433762,137,1,228.62,1,1,3,5
1515915625526434969,137,1,43.17,1,1,2,4
1515915625526439236,137,5,48.13,1,4,2,7
1515915625526439809,137,2,102.66,1,2,3,6
1515915625526440267,137,1,14.75,1,1,1,3
1515915625526441190,137,1,23.9,1,1,1,3
1515915625526441431,137,1,23.48,1,1,1,3
1515915625526443845,131,1,24.92,1,1,1,3
1515915625526444130,137,1,4.86,1,1,1,3
1515915625526447403,137,1,15.87,1,1,1,3
1515915625526450760,137,3,43.940000000000005,1,3,2,6
1515915625526450888,135,1,86.16,1,1,2,4
1515915625526450909,137,1,73.81,1,1,2,4
1515915625526458582,137,1,35.08,1,1,2,4
1515915625526461271,137,1,43.11,1,1,2,4
1515915625526463049,137,1,24.92,1,1,1,3
1515915625526471986,113,1,113.17,2,1,3,6
1515915625526472119,137,1,23.02,1,1,1,3
1515915625526473967,137,2,24.12,1,2,1,4
1515915625526480740,135,1,126.68,1,1,3,5
1515915625526483691,137,2,41.3,1,2,2,5
1515915625526488764,137,3,481.85,1,3,4,8
1515915625526488855,137,1,21.21,1,1,1,3
1515915625526489910,137,1,43.11,1,1,2,4
1515915625526489969,137,1,19.37,1,1,1,3
1515915625526490385,134,1,20.51,1,1,1,3
1515915625526492335,137,1,42.98,1,1,2,4
1515915625526495846,136,1,26.46,1,1,1,3
1515915625526499539,137,2,46.74,1,2,2,5
1515915625526504363,106,4,172.44,2,3,3,8
1515915625526504933,137,1,87.63,1,1,2,4
1515915625526507041,132,1,1.57,1,1,1,3
1515915625526508966,137,1,30.54,1,1,1,3
1515915625526518485,136,2,130.16,1,2,3,6
1515915625526522408,137,1,9.79,1,1,1,3
1515915625526531093,112,2,58.74,2,2,2,6
1515915625526533185,136,1,70.89,1,1,2,4
1515915625526542737,136,1,104.21,1,1,3,5
1515915625526560530,136,1,149.05,1,1,3,5
1515915625526564908,20,2,424.26,4,2,4,10
1515915625526564954,136,1,204.29,1,1,3,5
1515915625526567582,88,1,20.48,2,1,1,4
1515915625526571408,136,1,230.48,1,1,3,5
1515915625526571951,136,23,3583.3900000000003,1,4,4,9
1515915625526582261,136,1,35.87,1,1,2,4
1515915625526597231,136,1,32.7,1,1,2,4
1515915625526602073,136,1,45.24,1,1,2,4
1515915625526604255,136,2,46.82,1,2,2,5
1515915625526604620,136,1,77.78,1,1,2,4
1515915625526606339,136,1,17.37,1,1,1,3
1515915625526611927,136,1,9.81,1,1,1,3
1515915625526613046,135,1,70.16,1,1,2,4
1515915625526615119,136,1,26.19,1,1,1,3
1515915625526615360,136,2,52.38,1,2,2,5
1515915625526615886,107,1,38.83,2,1,2,5
1515915625526618598,136,1,26.51,1,1,1,3
1515915625526619002,136,1,136.05,1,1,3,5
1515915625526621214,136,1,159.68,1,1,3,5
1515915625526622014,136,1,30.16,1,1,1,3
1515915625526624740,136,1,36.49,1,1,2,4
1515915625526630226,136,1,37.62,1,1,2,4
1515915625526645099,136,1,62.71,1,1,2,4
1515915625526645662,136,1,399.35,1,1,4,6
1515915625526646150,136,1,29.52,1,1,1,3
1515915625526647141,136,9,480.15000000000003,1,4,4,9
1515915625526649425,76,3,80.87,2,3,2,7
1515915625526649580,136,1,44.92,1,1,2,4
1515915625526650947,136,2,86.98,1,2,2,5
1515915625526652280,48,2,63.94,3,2,2,7
1515915625526653093,136,6,187.62,1,4,3,8
1515915625526654616,136,2,79.5,1,2,2,5
1515915625526656251,136,2,308.64,1,2,4,7
1515915625526659501,136,1,63.98,1,1,2,4
1515915625526661896,136,3,1364.58,1,3,4,8
1515915625526664740,136,1,52.49,1,1,2,4
1515915625526667167,136,1,9.35,1,1,1,3
1515915625526667571,136,1,107.3,1,1,3,5
1515915625526669018,136,1,64.48,1,1,2,4
1515915625526670229,136,1,16.35,1,1,1,3
1515915625526671180,136,1,11.41,1,1,1,3
1515915625526672376,136,2,79.5,1,2,2,5
1515915625526674432,136,1,292.83,1,1,4,6
1515915625526675435,136,2,26.950000000000003,1,2,1,4
1515915625526678318,136,2,65.52,1,2,2,5
1515915625526678538,136,1,56.27,1,1,2,4
1515915625526682977,136,3,967.71,1,3,4,8
1515915625526684235,136,1,44.86,1,1,2,4
1515915625526684382,136,1,70.16,1,1,2,4
1515915625526684644,136,1,41.35,1,1,2,4
1515915625526687368,136,1,51.27,1,1,2,4
1515915625526690712,136,1,42.57,1,1,2,4
1515915625526694483,136,2,163.01000000000002,1,2,3,6
1515915625526695411,136,8,592.94,1,4,4,9
1515915625526696972,136,1,17.48,1,1,1,3
1515915625526698357,136,1,202.67,1,1,3,5
1515915625526700753,136,1,33.97,1,1,2,4
1515915625526702824,136,1,55.16,1,1,2,4
1515915625526710287,136,1,14.08,1,1,1,3
1515915625526711530,136,1,16.98,1,1,1,3
1515915625526711903,136,1,32.25,1,1,2,4
1515915625526712130,136,1,63.98,1,1,2,4
1515915625526713579,136,2,126.66,1,2,3,6
1515915625526715699,136,1,154.32,1,1,3,5
1515915625526726942,116,3,150.14999999999998,1,3,3,7
1515915625526727733,136,2,38.98,1,2,2,5
1515915625526729099,136,1,28.94,1,1,1,3
1515915625526730260,136,1,28.57,1,1,1,3
1515915625526731328,122,2,123.72,1,2,3,6
1515915625526731347,136,2,21.72,1,2,1,4
1515915625526731641,131,1,134.13,1,1,3,5
1515915625526733134,136,1,10.11,1,1,1,3
1515915625526736152,136,2,178.16,1,2,3,6
1515915625526736292,136,1,50.56,1,1,2,4
1515915625526738070,136,1,16.41,1,1,1,3
1515915625526739939,136,1,11.03,1,1,1,3
1515915625526742540,136,1,34.14,1,1,2,4
1515915625526745191,136,21,4386.75,1,4,4,9
1515915625526745760,112,3,475.71,2,3,4,9
1515915625526747178,87,1,16.03,2,1,1,4
1515915625526748100,136,1,29.22,1,1,1,3
1515915625526749376,136,1,15.24,1,1,1,3
1515915625526755028,125,2,46.0,1,2,2,5
1515915625526757478,104,5,495.02,2,4,4,10
1515915625526761873,129,2,418.58,1,2,4,7
1515915625526762477,108,1,164.33,2,1,3,6
1515915625526764355,101,1,192.86,2,1,3,6
1515915625526767070,136,1,229.38,1,1,3,5
1515915625526769365,136,1,26.19,1,1,1,3
1515915625526773686,134,2,315.14,1,2,4,7
1515915625526774142,130,3,214.56,1,3,3,7
1515915625526774704,136,1,13.02,1,1,1,3
1515915625526787001,136,1,314.68,1,1,4,6
1515915625526788318,136,1,55.6,1,1,2,4
1515915625526788384,136,3,79.38,1,3,2,6
1515915625526793344,136,1,64.92,1,1,2,4
1515915625526797470,73,6,157.14000000000001,2,4,3,9
1515915625526798728,136,2,310.2,1,2,4,7
1515915625526799864,136,2,30.16,1,2,1,4
1515915625526806699,136,1,14.19,1,1,1,3
1515915625526807163,136,3,84.30000000000001,1,3,2,6
1515915625526808887,56,3,805.77,3,3,4,10
1515915625526809272,136,6,910.5,1,4,4,9
1515915625526809408,136,2,340.54,1,2,4,7
1515915625526814033,136,1,27.62,1,1,1,3
1515915625526822567,90,4,536.52,2,3,4,9
1515915625526823287,136,1,292.83,1,1,4,6
1515915625526823471,136,1,9.35,1,1,1,3
1515915625526824024,103,3,96.66,2,3,3,8
1515915625526826781,136,1,19.84,1,1,1,3
1515915625526827454,136,2,27.78,1,2,1,4
1515915625526834824,135,4,79.77000000000001,1,3,2,6
1515915625526835389,136,1,48.41,1,1,2,4
1515915625526837196,135,1,32.22,1,1,1,3
1515915625526838107,136,1,204.29,1,1,3,5
1515915625526838728,109,3,462.96,2,3,4,9
1515915625526841557,136,2,40.64,1,2,2,5
1515915625526849111,136,1,24.24,1,1,1,3
1515915625526851288,136,1,43.13,1,1,2,4
1515915625526860850,136,2,86.22,1,2,2,5
1515915625526865666,136,2,205.9,1,2,3,6
1515915625526866271,136,2,103.5,1,2,3,6
1515915625526867123,136,1,36.59,1,1,2,4
1515915625526870955,136,1,15.56,1,1,1,3
1515915625526873385,136,5,753.9499999999999,1,4,4,9
1515915625526873779,136,1,123.65,1,1,3,5
1515915625526876232,86,2,245.72,2,2,3,7
1515915625526881471,134,2,147.58,1,2,3,6
1515915625526881618,136,1,15.9,1,1,1,3
1515915625526881627,136,2,23.18,1,2,1,4
1515915625526886885,136,1,11.59,1,1,1,3
1515915625526891968,109,1,40.03,2,1,2,5
1515915625526893569,127,1,23.84,1,1,1,3
1515915625526893754,119,1,71.75,1,1,2,4
1515915625526895461,134,6,197.43,1,4,3,8
1515915625526909272,136,1,62.17,1,1,2,4
1515915625526913518,136,1,204.29,1,1,3,5
1515915625526914687,133,6,342.78000000000003,1,4,4,9
1515915625526915188,136,1,27.62,1,1,1,3
1515915625526916238,136,8,178.08,1,4,3,8
1515915625526940209,135,3,34.769999999999996,1,3,2,6
1515915625526953691,135,1,13.57,1,1,1,3
1515915625526957732,135,1,28.1,1,1,1,3
1515915625526961358,132,2,38.1,1,2,2,5
1515915625526972853,135,1,26.19,1,1,1,3
1515915625526974259,135,1,11.97,1,1,1,3
1515915625526977904,135,1,349.46,1,1,4,6
1515915625526978114,135,1,24.6,1,1,1,3
1515915625526986577,1,2,52.38,4,2,2,8
1515915625526987391,135,1,43.13,1,1,2,4
1515915625526987413,135,1,16.35,1,1,1,3
1515915625526987691,102,1,127.08,2,1,3,6
1515915625526990374,135,3,78.57000000000001,1,3,2,6
1515915625526992330,135,1,94.41,1,1,3,5
1515915625526993377,44,1,15.08,3,1,1,5
1515915625526994879,135,1,18.57,1,1,1,3
1515915625526996728,135,2,245.72,1,2,3,6
1515915625526999377,135,1,26.19,1,1,1,3
1515915625526999970,135,2,135.34,1,2,3,6
1515915625527000849,135,1,26.19,1,1,1,3
1515915625527003688,135,1,13.22,1,1,1,3
1515915625527009836,135,1,29.22,1,1,1,3
1515915625527012376,133,2,68.88,1,2,2,5
1515915625527015732,135,1,37.62,1,1,2,4
1515915625527016137,135,1,29.37,1,1,1,3
1515915625527019964,135,1,10.14,1,1,1,3
1515915625527020760,135,2,28.58,1,2,1,4
1515915625527022011,135,1,35.87,1,1,2,4
1515915625527022842,135,2,70.16,1,2,2,5
1515915625527032270,132,2,72.04,1,2,2,5
1515915625527034114,135,1,40.44,1,1,2,4
1515915625527037429,135,3,479.52,1,3,4,8
1515915625527041586,135,2,72.98,1,2,2,5
1515915625527042344,135,1,21.27,1,1,1,3
1515915625527044580,135,1,159.84,1,1,3,5
1515915625527046379,135,1,32.95,1,1,2,4
1515915625527050389,135,1,10.73,1,1,1,3
1515915625527055742,135,2,105.08,1,2,3,6
1515915625527058257,135,2,40.28,1,2,2,5
1515915625527060764,135,1,51.24,1,1,2,4
1515915625527061506,135,1,148.37,1,1,3,5
1515915625527061578,135,1,10.63,1,1,1,3
1515915625527062833,135,2,209.72,1,2,3,6
1515915625527066430,135,1,16.83,1,1,1,3
1515915625527066465,135,2,52.38,1,2,2,5
1515915625527067304,135,1,16.83,1,1,1,3
1515915625527070869,135,1,449.51,1,1,4,6
1515915625527078952,135,1,224.76,1,1,3,5
1515915625527080877,135,2,33.46,1,2,2,5
1515915625527080923,135,2,136.35,1,2,3,6
1515915625527081993,132,1,218.98,1,1,3,5
1515915625527082626,133,1,218.98,1,1,3,5
1515915625527083110,135,1,16.83,1,1,1,3
1515915625527084746,135,1,13.17,1,1,1,3
1515915625527086920,135,2,207.66,1,2,3,6
1515915625527088709,133,4,880.64,1,3,4,8
1515915625527090351,135,1,10.59,1,1,1,3
1515915625527091868,135,1,11.98,1,1,1,3
1515915625527093808,130,3,75.56,1,3,2,6
1515915625527108651,135,1,2.86,1,1,1,3
1515915625527111579,134,1,16.19,1,1,1,3
1515915625527112428,135,1,2.86,1,1,1,3
1515915625527113027,135,1,31.11,1,1,1,3
1515915625527114152,135,4,294.18,1,3,4,8
1515915625527115023,135,1,131.68,1,1,3,5
1515915625527119387,135,1,202.67,1,1,3,5
1515915625527123586,135,1,67.27,1,1,2,4
1515915625527124237,135,1,43.11,1,1,2,4
1515915625527124667,135,1,9.35,1,1,1,3
1515915625527128522,134,1,204.29,1,1,3,5
1515915625527135756,135,2,272.1,1,2,3,6
1515915625527136762,135,1,40.32,1,1,2,4
1515915625527138562,92,1,36.9,2,1,2,5
1515915625527139549,135,2,449.52,1,2,4,7
1515915625527140432,135,1,118.57,1,1,3,5
1515915625527143017,135,2,30.16,1,2,1,4
1515915625527143143,135,2,39.74,1,2,2,5
1515915625527151575,135,1,177.95,1,1,3,5
1515915625527152133,135,1,164.33,1,1,3,5
1515915625527157362,135,1,50.05,1,1,2,4
1515915625527158178,118,3,518.58,1,3,4,8
1515915625527161448,135,4,53.6,1,3,2,6
1515915625527163047,135,1,14.19,1,1,1,3
1515915625527168768,123,1,294.65,1,1,4,6
1515915625527169180,120,2,27.94,1,2,1,4
1515915625527169552,127,1,28.1,1,1,1,3
1515915625527171450,134,1,314.68,1,1,4,6
1515915625527172900,135,5,215.26,1,4,3,8
1515915625527175924,135,1,11.13,1,1,1,3
1515915625527175941,135,1,55.16,1,1,2,4
1515915625527183284,135,1,27.13,1,1,1,3
1515915625527184589,135,2,15.14,1,2,1,4
1515915625527187789,135,1,224.76,1,1,3,5
1515915625527191014,135,1,14.65,1,1,1,3
1515915625527191757,71,4,346.16,3,3,4,10
1515915625527192189,135,1,271.76,1,1,3,5
1515915625527193795,112,5,80.95,2,4,2,8
1515915625527194467,135,1,64.48,1,1,2,4
1515915625527200620,135,1,42.57,1,1,2,4
1515915625527200866,128,1,23.71,1,1,1,3
1515915625527208766,135,2,86.26,1,2,2,5
1515915625527217161,135,2,32.88,1,2,2,5
1515915625527218111,135,1,35.1,1,1,2,4
1515915625527222662,135,1,36.49,1,1,2,4
1515915625527232557,135,1,82.97,1,1,2,4
1515915625527235966,134,3,43.95,1,3,2,6
1515915625527237314,133,2,75.88,1,2,2,5
1515915625527238352,135,4,69.2,1,3,2,6
1515915625527248059,135,2,42.62,1,2,2,5
1515915625527248991,107,1,61.17,2,1,2,5
1515915625527255661,135,4,142.72,1,3,3,7
1515915625527261079,135,2,254.16,1,2,3,6
1515915625527263422,135,1,15.87,1,1,1,3
1515915625527264263,135,3,4.71,1,3,1,5
1515915625527265480,133,1,43.13,1,1,2,4
1515915625527288759,135,1,53.33,1,1,2,4
1515915625527291560,97,1,370.46,2,1,4,7
1515915625527294941,134,11,739.9699999999999,1,4,4,9
1515915625527316661,134,3,65.25,1,3,2,6
1515915625527326096,134,2,35.05,1,2,2,5
1515915625527331178,89,5,510.55,2,4,4,10
1515915625527340120,134,1,10.68,1,1,1,3
1515915625527340206,134,1,43.48,1,1,2,4
1515915625527340570,134,1,103.24,1,1,3,5
1515915625527341529,134,1,103.24,1,1,3,5
1515915625527341853,134,2,324.16999999999996,1,2,4,7
1515915625527350876,134,2,111.3,1,2,3,6
1515915625527352959,134,1,10.24,1,1,1,3
1515915625527353999,134,2,227.62,1,2,3,6
1515915625527355238,134,2,70.16,1,2,2,5
1515915625527355327,134,2,59.36,1,2,2,5
1515915625527355680,134,1,236.46,1,1,3,5
1515915625527356597,134,3,341.43,1,3,4,8
1515915625527360048,44,1,27.62,3,1,1,5
1515915625527361062,134,1,23.81,1,1,1,3
1515915625527361832,134,1,34.44,1,1,2,4
1515915625527361998,134,1,55.16,1,1,2,4
1515915625527362727,134,1,13.63,1,1,1,3
1515915625527364504,134,1,13.02,1,1,1,3
1515915625527365812,134,1,22.22,1,1,1,3
1515915625527366014,134,1,23.81,1,1,1,3
1515915625527367807,134,1,15.9,1,1,1,3
1515915625527370806,134,1,21.21,1,1,1,3
1515915625527375327,134,2,118.44,1,2,3,6
1515915625527378323,134,3,145.03,1,3,3,7
1515915625527379139,134,3,30.48,1,3,1,5
1515915625527382071,134,1,103.83,1,1,3,5
1515915625527386826,134,1,82.86,1,1,2,4
1515915625527395404,134,1,122.86,1,1,3,5
1515915625527397245,134,1,13.49,1,1,1,3
1515915625527397508,134,1,263.52,1,1,3,5
1515915625527401056,99,1,415.54,2,1,4,7
1515915625527403156,134,2,174.92,1,2,3,6
1515915625527403730,134,1,292.83,1,1,4,6
1515915625527407687,134,2,115.24,1,2,3,6
1515915625527408622,134,1,96.19,1,1,3,5
1515915625527417534,134,6,150.48,1,4,3,8
1515915625527420896,134,2,112.54,1,2,3,6
1515915625527428839,134,1,314.68,1,1,4,6
1515915625527434126,134,1,1.57,1,1,1,3
1515915625527434788,134,1,36.49,1,1,2,4
1515915625527436803,134,1,57.62,1,1,2,4
1515915625527437519,132,1,27.62,1,1,1,3
1515915625527437650,134,1,314.68,1,1,4,6
1515915625527437898,134,1,115.4,1,1,3,5
1515915625527439989,134,1,83.97,1,1,2,4
1515915625527448464,134,2,74.6,1,2,2,5
1515915625527450369,115,2,58.44,1,2,2,5
1515915625527450581,134,2,29.72,1,2,1,4
1515915625527450752,124,5,191.5,1,4,3,8
1515915625527451443,134,1,17.62,1,1,1,3
1515915625527453649,134,1,3.56,1,1,1,3
1515915625527454946,134,1,20.63,1,1,1,3
1515915625527457604,44,5,81.98,3,4,2,9
1515915625527459011,134,5,65.1,1,4,2,7
1515915625527462066,134,4,74.28,1,3,2,6
1515915625527468835,134,2,253.36,1,2,3,6
1515915625527469217,134,3,517.14,1,3,4,8
1515915625527472807,134,1,177.95,1,1,3,5
1515915625527477918,134,1,130.0,1,1,3,5
1515915625527477963,120,2,19.52,1,2,1,4
1515915625527478238,134,1,207.27,1,1,3,5
1515915625527478347,134,1,140.63,1,1,3,5
1515915625527480054,134,3,479.04,1,3,4,8
1515915625527480388,134,1,294.41,1,1,4,6
1515915625527484185,134,1,90.73,1,1,3,5
1515915625527487417,24,1,144.49,4,1,3,8
1515915625527489350,134,1,17.46,1,1,1,3
1515915625527489423,134,1,14.86,1,1,1,3
1515915625527491311,126,1,177.95,1,1,3,5
1515915625527494820,134,4,84.07000000000001,1,3,2,6
1515915625527495855,134,1,65.4,1,1,2,4
1515915625527496574,134,2,32.38,1,2,2,5
1515915625527502095,134,1,29.57,1,1,1,3
1515915625527504299,134,1,134.13,1,1,3,5
1515915625527512103,134,3,1348.53,1,3,4,8
1515915625527518189,134,1,15.87,1,1,1,3
1515915625527524923,134,1,45.87,1,1,2,4
1515915625527528751,131,1,82.41,1,1,2,4
1515915625527528767,134,1,33.86,1,1,2,4
1515915625527532205,134,2,26.2,1,2,1,4
1515915625527532690,133,1,82.41,1,1,2,4
1515915625527538959,134,1,398.7,1,1,4,6
1515915625527544108,134,1,502.43,1,1,4,6
1515915625527548408,134,1,50.33,1,1,2,4
1515915625527549499,134,1,15.87,1,1,1,3
1515915625527550352,134,2,271.74,1,2,3,6
1515915625527564800,32,1,40.95,4,1,2,7
1515915625527565097,134,1,43.11,1,1,2,4
1515915625527570947,134,1,16.44,1,1,1,3
1515915625527572805,133,1,214.1,1,1,3,5
1515915625527573656,134,2,232.1,1,2,3,6
1515915625527576410,132,2,36.07,1,2,2,5
1515915625527579796,134,1,13.65,1,1,1,3
1515915625527582220,134,1,116.05,1,1,3,5
1515915625527583651,121,4,1171.32,1,3,4,8
1515915625527584854,134,1,162.51,1,1,3,5
1515915625527588494,134,1,127.08,1,1,3,5
1515915625527591469,125,12,205.32,1,4,3,8
1515915625527594865,134,1,249.02,1,1,3,5
1515915625527600742,134,1,9.35,1,1,1,3
1515915625527604095,134,1,88.33,1,1,2,4
1515915625527606579,134,2,122.32,1,2,3,6
1515915625527607764,36,1,27.84,3,1,1,5
1515915625527612278,94,1,18.41,2,1,1,4
1515915625527621988,134,1,17.62,1,1,1,3
1515915625527623204,134,2,58.44,1,2,2,5
1515915625527624805,134,1,34.44,1,1,2,4
1515915625527626804,133,1,28.25,1,1,1,3
1515915625527629651,103,1,229.38,2,1,3,6
1515915625527630554,134,1,19.68,1,1,1,3
1515915625527632561,134,2,19.84,1,2,1,4
1515915625527634821,134,1,23.57,1,1,1,3
1515915625527635469,134,3,23.14,1,3,1,5
1515915625527649013,134,1,46.92,1,1,2,4
1515915625527658541,105,1,21.21,2,1,1,4
1515915625527659310,112,1,126.68,2,1,3,6
1515915625527659614,134,2,216.88,1,2,3,6
1515915625527663138,134,1,9.95,1,1,1,3
1515915625527668151,134,1,93.65,1,1,3,5
1515915625527670136,134,1,11.75,1,1,1,3
1515915625527672915,134,1,21.75,1,1,1,3
1515915625527673457,134,2,398.74,1,2,4,7
1515915625527676347,121,3,87.66,1,3,2,6
1515915625527679447,118,1,64.48,1,1,2,4
1515915625527684889,95,1,192.86,2,1,3,6
1515915625527693299,122,3,46.68,1,3,2,6
1515915625527697075,134,1,48.84,1,1,2,4
1515915625527715251,133,1,349.46,1,1,4,6
1515915625527723245,130,8,1750.8999999999999,1,4,4,9
1515915625527724300,133,10,1378.04,1,4,4,9
1515915625527726783,133,1,59.68,1,1,2,4
1515915625527731254,133,3,45.13,1,3,2,6
1515915625527733505,133,3,255.87,1,3,3,7
1515915625527733754,133,1,22.41,1,1,1,3
1515915625527740794,129,1,36.49,1,1,2,4
1515915625527740894,133,4,145.96,1,3,3,7
1515915625527741785,133,2,92.06,1,2,3,6
1515915625527742229,133,3,541.81,1,3,4,8
1515915625527742593,133,1,16.19,1,1,1,3
1515915625527743067,133,1,46.03,1,1,2,4
1515915625527743089,133,6,2277.94,1,4,4,9
1515915625527743671,133,1,46.03,1,1,2,4
1515915625527744341,133,1,15.0,1,1,1,3
1515915625527744359,133,3,825.95,1,3,4,8
1515915625527744534,133,1,19.52,1,1,1,3
1515915625527746214,51,10,777.3000000000001,3,4,4,11
1515915625527752650,133,1,211.14,1,1,3,5
1515915625527754930,133,2,97.68,1,2,3,6
1515915625527757175,133,10,104.3,1,4,3,8
1515915625527766446,127,3,155.58999999999997,1,3,3,7
1515915625527766536,133,5,103.25,1,4,3,8
1515915625527766602,133,1,4.95,1,1,1,3
1515915625527768285,133,1,26.9,1,1,1,3
1515915625527768476,133,1,47.78,1,1,2,4
1515915625527771460,133,1,19.84,1,1,1,3
1515915625527775284,131,4,315.56,1,3,4,8
1515915625527775533,133,2,730.5,1,2,4,7
1515915625527776352,133,1,61.27,1,1,2,4
1515915625527781253,133,4,491.88,1,3,4,8
1515915625527790544,131,4,168.42,1,3,3,7
1515915625527792268,133,1,9.35,1,1,1,3
1515915625527792444,133,1,254.38,1,1,3,5
1515915625527793569,133,1,169.67,1,1,3,5
1515915625527799215,133,1,17.32,1,1,1,3
1515915625527809456,133,1,17.3,1,1,1,3
1515915625527809831,133,1,27.46,1,1,1,3
1515915625527812128,133,1,27.46,1,1,1,3
1515915625527813587,130,1,130.0,1,1,3,5
1515915625527816332,133,1,42.57,1,1,2,4
1515915625527816644,133,1,4.67,1,1,1,3
1515915625527818291,133,2,327.04,1,2,4,7
1515915625527821906,133,1,166.03,1,1,3,5
1515915625527823849,133,1,374.38,1,1,4,6
1515915625527823962,133,3,51.75,1,3,2,6
1515915625527826748,133,1,23.41,1,1,1,3
1515915625527830190,133,5,754.3,1,4,4,9
1515915625527832042,133,1,113.81,1,1,3,5
1515915625527834590,133,1,108.56,1,1,3,5
1515915625527841736,37,2,92.38,3,2,3,8
1515915625527842400,115,9,181.3,1,4,3,8
1515915625527844720,133,1,16.33,1,1,1,3
1515915625527844763,133,1,26.46,1,1,1,3
1515915625527846035,125,1,224.76,1,1,3,5
1515915625527848165,111,7,1185.62,2,4,4,10
1515915625527849559,133,2,64.44,1,2,2,5
1515915625527849747,133,2,85.96,1,2,2,5
1515915625527851005,132,1,59.79,1,1,2,4
1515915625527851301,133,1,15.87,1,1,1,3
1515915625527852663,133,1,13.52,1,1,1,3
1515915625527853801,133,2,449.52,1,2,4,7
1515915625527853886,126,1,23.81,1,1,1,3
1515915625527858705,101,1,111.08,2,1,3,6
1515915625527860120,133,1,9.35,1,1,1,3
1515915625527861186,133,1,13.52,1,1,1,3
1515915625527861308,133,2,27.52,1,2,1,4
1515915625527864180,124,1,26.98,1,1,1,3
1515915625527866749,133,2,327.04,1,2,4,7
1515915625527867289,132,2,27.04,1,2,1,4
1515915625527868062,133,2,165.72,1,2,3,6
1515915625527872178,133,1,25.08,1,1,1,3
1515915625527872540,133,1,25.4,1,1,1,3
1515915625527873078,133,2,25.4,1,2,1,4
1515915625527875754,133,1,11.56,1,1,1,3
1515915625527877675,133,1,202.67,1,1,3,5
1515915625527878444,27,1,18.41,4,1,1,6
1515915625527880069,133,1,8.29,1,1,1,3
1515915625527891034,129,2,27.94,1,2,1,4
1515915625527893195,131,2,32.1,1,2,1,4
1515915625527901287,133,2,3.14,1,2,1,4
1515915625527902896,133,1,41.9,1,1,2,4
1515915625527906192,133,1,15.4,1,1,1,3
1515915625527909323,83,4,773.04,2,3,4,9
1515915625527909410,35,1,15.08,4,1,1,6
1515915625527910897,133,1,17.81,1,1,1,3
1515915625527912295,133,1,20.95,1,1,1,3
1515915625527912920,109,1,18.73,2,1,1,4
1515915625527913409,103,1,32.22,2,1,1,4
1515915625527918550,133,1,11.98,1,1,1,3
1515915625527919694,133,1,26.46,1,1,1,3
1515915625527920979,133,3,97.14000000000001,1,3,3,7
1515915625527921853,132,1,210.19,1,1,3,5
1515915625527925944,133,1,124.08,1,1,3,5
1515915625527928961,13,4,856.4,4,3,4,11
1515915625527932030,133,1,21.21,1,1,1,3
1515915625527942071,133,1,33.33,1,1,2,4
1515915625527942276,133,1,13.4,1,1,1,3
1515915625527942413,133,1,21.21,1,1,1,3
1515915625527943145,133,1,113.17,1,1,3,5
1515915625527943802,133,1,149.05,1,1,3,5
1515915625527944418,133,1,3.67,1,1,1,3
1515915625527949041,133,1,337.44,1,1,4,6
1515915625527949577,106,8,170.16,2,4,3,9
1515915625527951517,133,2,515.74,1,2,4,7
1515915625527955003,133,1,20.14,1,1,1,3
1515915625527955680,133,1,149.05,1,1,3,5
1515915625527959443,133,2,64.44,1,2,2,5
1515915625527962027,133,2,301.3,1,2,4,7
1515915625527962601,133,1,108.44,1,1,3,5
1515915625527965882,133,3,41.58,1,3,2,6
1515915625527968796,108,6,762.48,2,4,4,10
1515915625527969304,42,1,174.84,3,1,3,7
1515915625527981025,128,3,195.24,1,3,3,7
1515915625527983710,133,1,56.27,1,1,2,4
1515915625527986742,133,2,335.24,1,2,4,7
1515915625527988415,133,2,62.22,1,2,2,5
1515915625527991064,88,1,73.83,2,1,2,5
1515915625527995949,133,1,109.48,1,1,3,5
1515915625527997796,130,1,48.05,1,1,2,4
1515915625527998447,133,1,324.35,1,1,4,6
1515915625528008966,47,2,498.06,3,2,4,9
1515915625528012760,133,1,14.94,1,1,1,3
1515915625528020172,106,1,43.87,2,1,2,5
1515915625528021366,133,2,527.04,1,2,4,7
1515915625528028507,133,4,180.96,1,3,3,7
1515915625528028732,25,1,113.38,4,1,3,8
1515915625528029700,133,1,35.87,1,1,2,4
1515915625528029807,8,1,32.22,4,1,1,6
1515915625528030340,133,1,284.3,1,1,3,5
1515915625528030759,133,1,113.02,1,1,3,5
1515915625528034350,133,2,3.14,1,2,1,4
1515915625528034806,133,2,94.28,1,2,3,6
1515915625528036483,133,1,199.7,1,1,3,5
1515915625528039088,133,1,284.3,1,1,3,5
1515915625528039825,133,1,3.98,1,1,1,3
1515915625528042143,133,1,179.94,1,1,3,5
1515915625528042536,131,1,51.33,1,1,2,4
1515915625528044894,9,1,52.9,4,1,2,7
1515915625528045956,133,3,266.90999999999997,1,3,3,7
1515915625528049660,133,1,68.57,1,1,2,4
1515915625528050019,133,1,127.08,1,1,3,5
1515915625528058841,133,1,39.21,1,1,2,4
1515915625528061341,133,1,23.7,1,1,1,3
1515915625528062409,133,1,29.22,1,1,1,3
1515915625528067697,133,2,245.72,1,2,3,6
1515915625528068847,133,1,65.32,1,1,2,4
1515915625528068865,133,1,163.52,1,1,3,5
1515915625528070192,132,4,639.4399999999999,1,3,4,8
1515915625528072657,129,1,25.4,1,1,1,3
1515915625528083016,133,1,32.22,1,1,1,3
1515915625528083280,133,5,80.95,1,4,2,7
1515915625528095687,133,2,79.5,1,2,2,5
1515915625528099633,132,3,246.42000000000002,1,3,3,7
1515915625528104728,116,3,93.48,1,3,3,7
1515915625528122933,132,2,36.82,1,2,2,5
1515915625528124671,132,3,96.66,1,3,3,7
1515915625528126414,119,4,113.64,1,3,3,7
1515915625528128164,132,4,529.37,1,3,4,8
1515915625528132308,131,1,178.89,1,1,3,5
1515915625528138121,132,1,16.19,1,1,1,3
1515915625528138701,132,3,28.11,1,3,1,5
1515915625528141628,132,3,370.04999999999995,1,3,4,8
1515915625528143066,132,5,283.09999999999997,1,4,3,8
1515915625528147375,132,1,27.62,1,1,1,3
1515915625528156434,132,2,52.38,1,2,2,5
1515915625528157986,119,2,112.54,1,2,3,6
1515915625528160283,129,1,65.08,1,1,2,4
1515915625528162184,48,1,43.11,3,1,2,6
1515915625528163187,132,1,16.98,1,1,1,3
1515915625528163303,132,2,20.92,1,2,1,4
1515915625528168295,132,1,11.98,1,1,1,3
1515915625528171282,132,1,22.22,1,1,1,3
1515915625528172098,132,1,39.75,1,1,2,4
1515915625528172200,66,1,180.63,3,1,3,7
1515915625528172292,132,4,471.0,1,3,4,8
1515915625528173150,132,1,86.51,1,1,2,4
1515915625528176746,132,1,18.57,1,1,1,3
1515915625528177179,132,1,56.62,1,1,2,4
1515915625528178923,132,1,179.94,1,1,3,5
1515915625528179317,132,1,27.62,1,1,1,3
1515915625528179387,132,4,801.4,1,3,4,8
1515915625528180429,128,2,43.5,1,2,2,5
1515915625528181425,132,1,10.98,1,1,1,3
1515915625528182037,132,1,36.03,1,1,2,4
1515915625528183887,132,2,64.44,1,2,2,5
1515915625528185375,132,1,156.9,1,1,3,5
1515915625528186937,132,1,55.6,1,1,2,4
1515915625528190486,131,5,335.7,1,4,4,9
1515915625528193679,132,4,159.0,1,3,3,7
1515915625528195173,132,1,155.1,1,1,3,5
1515915625528195261,132,1,172.86,1,1,3,5
1515915625528197897,132,1,115.71,1,1,3,5
1515915625528199204,109,2,37.4,2,2,2,6
1515915625528200689,132,2,56.68,1,2,2,5
1515915625528201082,132,1,230.35,1,1,3,5
1515915625528202412,132,1,731.83,1,1,4,6
1515915625528203267,132,1,44.03,1,1,2,4
1515915625528204003,110,10,1267.97,2,4,4,10
1515915625528209195,132,1,14.22,1,1,1,3
1515915625528210272,132,1,56.51,1,1,2,4
1515915625528212857,132,1,16.98,1,1,1,3
1515915625528216179,132,1,28.1,1,1,1,3
1515915625528217883,81,1,10.62,2,1,1,4
1515915625528221369,132,2,64.44,1,2,2,5
1515915625528223024,132,1,10.08,1,1,1,3
1515915625528223631,27,5,3507.3,4,4,4,12
1515915625528224528,55,4,209.96,3,3,3,9
1515915625528226905,124,5,47.95,1,4,2,7
1515915625528228003,132,1,20.76,1,1,1,3
1515915625528228888,132,1,164.92,1,1,3,5
1515915625528231174,129,4,817.16,1,3,4,8
1515915625528232776,132,1,55.87,1,1,2,4
1515915625528234349,132,1,113.81,1,1,3,5
1515915625528234605,132,1,190.27,1,1,3,5
1515915625528236495,132,1,160.17,1,1,3,5
1515915625528238074,127,1,9.81,1,1,1,3
1515915625528244075,132,1,202.67,1,1,3,5
1515915625528246508,83,1,245.29,2,1,3,6
1515915625528249247,132,2,408.58,1,2,4,7
1515915625528250064,132,1,201.11,1,1,3,5
1515915625528251230,132,1,167.62,1,1,3,5
1515915625528252103,119,6,645.24,1,4,4,9
1515915625528252242,132,1,19.98,1,1,1,3
1515915625528254906,132,1,87.7,1,1,2,4
1515915625528257843,132,1,36.67,1,1,2,4
1515915625528258593,132,1,20.95,1,1,1,3
1515915625528262319,132,1,169.75,1,1,3,5
1515915625528262459,132,1,257.87,1,1,3,5
1515915625528266021,123,1,180.06,1,1,3,5
1515915625528271440,132,1,37.16,1,1,2,4
1515915625528272848,132,3,111.47999999999999,1,3,3,7
1515915625528272919,129,5,1612.85,1,4,4,9
1515915625528280939,132,1,16.05,1,1,1,3
1515915625528282178,132,1,13.17,1,1,1,3
1515915625528285727,132,2,85.14,1,2,2,5
1515915625528288291,132,1,19.84,1,1,1,3
1515915625528290181,132,1,14.08,1,1,1,3
1515915625528293047,85,2,3.14,2,2,1,5
1515915625528300325,132,1,65.32,1,1,2,4
1515915625528301304,132,1,153.83,1,1,3,5
1515915625528316942,20,1,55.87,4,1,2,7
1515915625528317866,132,1,42.57,1,1,2,4
1515915625528318145,132,1,26.43,1,1,1,3
1515915625528319209,132,1,33.81,1,1,2,4
1515915625528320565,131,1,204.29,1,1,3,5
1515915625528324099,132,2,64.76,1,2,2,5
1515915625528326547,132,1,32.38,1,1,2,4
1515915625528329409,132,3,109.47,1,3,3,7
1515915625528329505,132,1,57.13,1,1,2,4
1515915625528331697,132,4,109.0,1,3,3,7
1515915625528333009,95,2,68.86,2,2,2,6
1515915625528337595,132,1,30.21,1,1,1,3
1515915625528340914,132,4,163.16,1,3,3,7
1515915625528341719,129,1,29.52,1,1,1,3
1515915625528342595,132,1,36.49,1,1,2,4
1515915625528346332,132,1,18.3,1,1,1,3
1515915625528347020,132,1,202.67,1,1,3,5
1515915625528353423,126,2,148.26999999999998,1,2,3,6
1515915625528354345,132,1,14.08,1,1,1,3
1515915625528355383,132,1,46.78,1,1,2,4
1515915625528356611,132,1,26.57,1,1,1,3
1515915625528357291,65,7,1418.6899999999998,3,4,4,11
1515915625528360506,132,1,32.22,1,1,1,3
1515915625528364240,132,1,88.08,1,1,2,4
1515915625528365306,104,2,171.09,2,2,3,7
1515915625528366058,130,4,61.120000000000005,1,3,2,6
1515915625528369702,132,1,103.83,1,1,3,5
1515915625528370490,132,1,20.95,1,1,1,3
1515915625528370568,131,2,428.2,1,2,4,7
1515915625528370814,132,3,153.89999999999998,1,3,3,7
1515915625528373566,132,1,13.17,1,1,1,3
1515915625528375773,132,1,1.57,1,1,1,3
1515915625528376421,97,1,28.89,2,1,1,4
1515915625528377920,132,1,155.43,1,1,3,5
1515915625528386496,132,1,14.86,1,1,1,3
1515915625528387594,130,1,33.33,1,1,2,4
1515915625528388737,132,1,29.22,1,1,1,3
1515915625528390689,132,1,13.89,1,1,1,3
1515915625528396572,132,2,40.32,1,2,2,5
1515915625528398663,132,2,3.14,1,2,1,4
1515915625528399418,75,1,34.44,2,1,2,5
1515915625528401024,132,1,10.68,1,1,1,3
1515915625528409349,131,4,75.56,1,3,2,6
1515915625528411432,132,1,15.1,1,1,1,3
1515915625528412371,132,1,50.13,1,1,2,4
1515915625528413599,132,1,26.46,1,1,1,3
1515915625528417639,132,1,60.89,1,1,2,4
1515915625528424364,131,1,17.0,1,1,1,3
1515915625528424801,132,1,31.11,1,1,1,3
1515915625528432719,132,2,169.58,1,2,3,6
1515915625528433798,132,1,9.35,1,1,1,3
1515915625528436644,132,1,153.83,1,1,3,5
1515915625528438702,63,3,130.95,3,3,3,9
1515915625528439108,94,2,52.38,2,2,2,6
1515915625528439899,132,1,314.97,1,1,4,6
1515915625528442353,131,1,26.46,1,1,1,3
1515915625528443497,132,4,116.88,1,3,3,7
1515915625528445245,132,2,585.66,1,2,4,7
1515915625528445364,79,4,771.44,2,3,4,9
1515915625528445962,94,3,112.68,2,3,3,8
1515915625528450317,131,1,20.48,1,1,1,3
1515915625528451101,128,4,37.4,1,3,2,6
1515915625528454433,132,1,128.79,1,1,3,5
1515915625528460422,131,1,87.16,1,1,2,4
1515915625528461265,132,2,30.48,1,2,1,4
1515915625528468540,132,1,62.52,1,1,2,4
1515915625528471261,132,1,204.79,1,1,3,5
1515915625528482954,132,1,34.44,1,1,2,4
1515915625528483117,132,1,33.63,1,1,2,4
1515915625528483564,132,1,22.48,1,1,1,3
1515915625528487597,47,4,443.8,3,3,4,10
1515915625528489642,130,5,75.4,1,4,2,7
1515915625528491084,132,1,190.54,1,1,3,5
1515915625528493867,132,1,11.65,1,1,1,3
1515915625528494183,132,1,11.65,1,1,1,3
1515915625528497967,125,5,49.050000000000004,1,4,2,7
1515915625528498379,108,1,68.1,2,1,2,5
1515915625528498540,131,1,224.76,1,1,3,5
1515915625528502632,132,1,10.68,1,1,1,3
1515915625528502773,132,1,24.13,1,1,1,3
1515915625528505216,132,3,64.47,1,3,2,6
1515915625528506696,131,1,68.57,1,1,2,4
1515915625528507910,132,1,13.97,1,1,1,3
1515915625528514174,130,1,17.62,1,1,1,3
1515915625528518502,132,2,355.58,1,2,4,7
1515915625528521731,34,1,33.02,4,1,2,7
1515915625528525099,131,3,192.44,1,3,3,7
1515915625528525313,131,1,104.13,1,1,3,5
1515915625528531127,132,1,26.46,1,1,1,3
1515915625528545675,112,2,314.72,2,2,4,8
1515915625528559269,131,1,34.46,1,1,2,4
1515915625528559608,131,1,32.22,1,1,1,3
1515915625528563604,131,4,56.32,1,3,2,6
1515915625528564461,131,1,70.57,1,1,2,4
1515915625528565566,131,1,46.33,1,1,2,4
1515915625528565773,131,1,36.17,1,1,2,4
1515915625528570712,131,2,319.36,1,2,4,7
1515915625528573842,131,1,16.98,1,1,1,3
1515915625528574382,131,1,42.22,1,1,2,4
1515915625528574764,131,5,565.1,1,4,4,9
1515915625528576126,131,1,230.35,1,1,3,5
1515915625528576803,124,2,188.2,1,2,3,6
1515915625528584592,124,4,905.22,1,3,4,8
1515915625528585186,131,1,58.57,1,1,2,4
1515915625528587420,54,2,233.58,3,2,3,8
1515915625528587660,131,1,104.21,1,1,3,5
1515915625528589270,129,5,1021.4499999999999,1,4,4,9
1515915625528589928,131,1,479.51,1,1,4,6
1515915625528590749,131,1,52.05,1,1,2,4
1515915625528593671,131,1,10.43,1,1,1,3
1515915625528600275,131,1,32.7,1,1,2,4
1515915625528604018,131,1,31.27,1,1,1,3
1515915625528610617,131,2,673.54,1,2,4,7
1515915625528612259,131,3,34.86,1,3,2,6
1515915625528625078,98,1,539.57,2,1,4,7
1515915625528625404,48,1,307.43,3,1,4,8
1515915625528626510,131,4,39.8,1,3,2,6
1515915625528629342,131,1,51.33,1,1,2,4
1515915625528629883,130,4,296.1,1,3,4,8
1515915625528630809,131,1,85.68,1,1,2,4
1515915625528631402,131,1,204.29,1,1,3,5
1515915625528632068,131,2,80.0,1,2,2,5
1515915625528633629,131,1,36.49,1,1,2,4
1515915625528633732,131,1,21.43,1,1,1,3
1515915625528634399,131,2,121.08,1,2,3,6
1515915625528634624,131,2,230.5,1,2,3,6
1515915625528635140,131,1,29.9,1,1,1,3
1515915625528636304,131,1,40.0,1,1,2,4
1515915625528636372,131,1,58.54,1,1,2,4
1515915625528637719,131,2,27.04,1,2,1,4
1515915625528639253,131,1,123.32,1,1,3,5
1515915625528639448,131,1,21.43,1,1,1,3
1515915625528639746,131,1,15.17,1,1,1,3
1515915625528640241,131,1,9.95,1,1,1,3
1515915625528640669,131,2,105.8,1,2,3,6
1515915625528641002,131,2,420.38,1,2,4,7
1515915625528645027,131,3,518.58,1,3,4,8
1515915625528646882,123,3,63.63,1,3,2,6
1515915625528647916,131,2,71.88,1,2,2,5
1515915625528649277,131,1,41.11,1,1,2,4
1515915625528649921,131,1,22.22,1,1,1,3
1515915625528653129,131,2,552.74,1,2,4,7
1515915625528655587,131,1,40.79,1,1,2,4
1515915625528660365,131,1,32.22,1,1,1,3
1515915625528665151,131,1,153.83,1,1,3,5
1515915625528668185,131,12,395.15,1,4,4,9
1515915625528669095,131,2,69.4,1,2,2,5
1515915625528672798,131,2,45.02,1,2,2,5
1515915625528677177,19,2,65.4,4,2,2,8
1515915625528677180,131,1,153.41,1,1,3,5
1515915625528686469,130,1,63.33,1,1,2,4
1515915625528690612,56,1,26.19,3,1,1,5
1515915625528692965,131,1,10.32,1,1,1,3
1515915625528693707,119,3,87.66,1,3,2,6
1515915625528693805,131,3,208.62,1,3,3,7
1515915625528695066,131,3,48.57000000000001,1,3,2,6
1515915625528696734,131,1,20.65,1,1,1,3
1515915625528699112,131,3,189.99,1,3,3,7
1515915625528700192,131,1,214.1,1,1,3,5
1515915625528703341,131,2,23.21,1,2,1,4
1515915625528703392,131,3,109.66,1,3,3,7
1515915625528705485,131,1,33.19,1,1,2,4
1515915625528706410,47,1,298.76,3,1,4,8
1515915625528707476,131,1,24.29,1,1,1,3
1515915625528711382,126,3,71.1,1,3,2,6
1515915625528717928,130,1,11.25,1,1,1,3
1515915625528720327,131,2,50.16,1,2,2,5
1515915625528722021,131,1,29.22,1,1,1,3
1515915625528724840,131,2,408.58,1,2,4,7
1515915625528727904,131,4,8.86,1,3,1,5
1515915625528728807,131,3,45.57,1,3,2,6
1515915625528729963,131,1,164.33,1,1,3,5
1515915625528730137,131,1,13.57,1,1,1,3
1515915625528730288,131,2,215.2,1,2,3,6
1515915625528731753,131,1,11.62,1,1,1,3
1515915625528731810,131,1,43.81,1,1,2,4
1515915625528732940,131,1,121.87,1,1,3,5
1515915625528734719,129,2,103.5,1,2,3,6
1515915625528736497,131,1,43.11,1,1,2,4
1515915625528737830,131,1,26.46,1,1,1,3
1515915625528742599,131,1,149.05,1,1,3,5
1515915625528749772,9,4,230.44,4,3,3,10
1515915625528750866,78,1,398.7,2,1,4,7
1515915625528752945,131,1,15.92,1,1,1,3
1515915625528753721,97,1,78.89,2,1,2,5
1515915625528754062,131,2,63.74,1,2,2,5
1515915625528755045,131,1,215.24,1,1,3,5
1515915625528755461,131,4,1455.36,1,3,4,8
1515915625528757366,131,3,1091.52,1,3,4,8
1515915625528763644,91,1,239.19,2,1,3,6
1515915625528764045,131,1,43.13,1,1,2,4
1515915625528764564,131,4,60.76,1,3,2,6
1515915625528764740,114,1,115.41,1,1,3,5
1515915625528767063,131,1,308.71,1,1,4,6
1515915625528768475,131,1,16.11,1,1,1,3
1515915625528770855,131,1,29.22,1,1,1,3
1515915625528771942,123,1,133.17,1,1,3,5
1515915625528772148,131,1,294.41,1,1,4,6
1515915625528778024,131,1,210.19,1,1,3,5
1515915625528779246,128,1,16.35,1,1,1,3
1515915625528781119,131,1,18.89,1,1,1,3
1515915625528781407,125,2,88.35,1,2,2,5
1515915625528782993,131,1,31.13,1,1,1,3
1515915625528783344,131,1,126.83,1,1,3,5
1515915625528783426,92,2,155.46,2,2,3,7
1515915625528784394,128,1,72.38,1,1,2,4
1515915625528788578,109,1,217.16,2,1,3,6
1515915625528801217,131,2,365.66,1,2,4,7
1515915625528803529,131,1,15.08,1,1,1,3
1515915625528805762,125,2,55.3,1,2,2,5
1515915625528806904,131,1,10.59,1,1,1,3
1515915625528807401,131,1,62.17,1,1,2,4
1515915625528814185,131,1,15.13,1,1,1,3
1515915625528814720,131,1,61.43,1,1,2,4
1515915625528816332,82,1,30.48,2,1,1,4
1515915625528818312,131,1,63.33,1,1,2,4
1515915625528822865,131,1,1.57,1,1,1,3
1515915625528825601,131,1,9.35,1,1,1,3
1515915625528829699,131,2,107.8,1,2,3,6
1515915625528833172,129,1,29.52,1,1,1,3
1515915625528838093,131,2,174.32,1,2,3,6
1515915625528847735,10,3,762.72,4,3,4,11
1515915625528851594,112,1,122.86,2,1,3,6
1515915625528851755,131,1,83.97,1,1,2,4
1515915625528852736,131,1,2.86,1,1,1,3
1515915625528852895,131,1,179.94,1,1,3,5
1515915625528866828,131,1,154.32,1,1,3,5
1515915625528868621,131,3,65.25,1,3,2,6
1515915625528873736,129,1,29.89,1,1,1,3
1515915625528874096,131,1,11.52,1,1,1,3
1515915625528874701,42,1,43.11,3,1,2,6
1515915625528874980,78,1,36.51,2,1,2,5
1515915625528878556,131,2,3.14,1,2,1,4
1515915625528883019,96,2,308.64,2,2,4,8
1515915625528887111,118,3,831.3000000000001,1,3,4,8
1515915625528889197,110,2,741.9300000000001,2,2,4,8
1515915625528892118,131,1,376.11,1,1,4,6
1515915625528895778,124,4,6.28,1,3,1,5
1515915625528895876,71,1,64.48,3,1,2,6
1515915625528898581,131,3,52.11,1,3,2,6
1515915625528900295,131,1,9.76,1,1,1,3
1515915625528903813,131,4,994.24,1,3,4,8
1515915625528908412,131,1,85.71,1,1,2,4
1515915625528913172,131,2,289.02,1,2,4,7
1515915625528921009,130,1,29.57,1,1,1,3
1515915625528922947,125,1,167.0,1,1,3,5
1515915625528922950,131,1,15.08,1,1,1,3
1515915625528923701,131,2,52.38,1,2,2,5
1515915625528934189,131,1,29.57,1,1,1,3
1515915625528942295,124,1,28.57,1,1,1,3
1515915625528942562,131,4,65.88,1,3,2,6
1515915625528956821,129,1,187.29,1,1,3,5
1515915625528975807,130,1,22.22,1,1,1,3
1515915625528976276,130,1,19.52,1,1,1,3
1515915625528977268,26,1,577.6,4,1,4,9
1515915625528977306,130,1,28.41,1,1,1,3
1515915625528978168,130,1,1.57,1,1,1,3
1515915625528983523,130,3,50.94,1,3,2,6
1515915625528983618,130,1,100.75,1,1,3,5
1515915625528993986,130,1,14.08,1,1,1,3
1515915625528994122,130,1,16.11,1,1,1,3
1515915625528998221,130,3,126.18,1,3,3,7
1515915625529001723,130,1,24.92,1,1,1,3
1515915625529006743,130,5,164.89999999999998,1,4,3,8
1515915625529011435,127,2,176.28,1,2,3,6
1515915625529017310,130,1,20.56,1,1,1,3
1515915625529018148,130,1,162.51,1,1,3,5
1515915625529018369,130,1,127.08,1,1,3,5
1515915625529019107,128,1,164.33,1,1,3,5
1515915625529023611,130,1,30.38,1,1,1,3
1515915625529032908,130,1,43.11,1,1,2,4
1515915625529037024,130,1,87.05,1,1,2,4
1515915625529038807,130,1,51.75,1,1,2,4
1515915625529039662,130,1,149.32,1,1,3,5
1515915625529041195,130,1,1.57,1,1,1,3
1515915625529042358,130,1,68.25,1,1,2,4
1515915625529043205,130,1,42.98,1,1,2,4
1515915625529050561,130,1,26.22,1,1,1,3
1515915625529055173,130,1,75.79,1,1,2,4
1515915625529058133,80,1,27.84,2,1,1,4
1515915625529059396,130,2,21.58,1,2,1,4
1515915625529060213,114,1,30.48,1,1,1,3
1515915625529062641,96,1,5.75,2,1,1,4
1515915625529062993,130,2,108.74,1,2,3,6
1515915625529068754,130,5,278.0,1,4,3,8
1515915625529074776,130,1,42.98,1,1,2,4
1515915625529075369,130,1,100.75,1,1,3,5
1515915625529077930,130,2,15.42,1,2,1,4
1515915625529078631,130,3,53.67,1,3,2,6
1515915625529086602,130,1,15.08,1,1,1,3
1515915625529090682,130,4,117.96,1,3,3,7
1515915625529096576,129,1,98.32,1,1,3,5
1515915625529106556,130,1,35.08,1,1,2,4
1515915625529109921,130,2,34.66,1,2,2,5
1515915625529111036,130,2,254.16,1,2,3,6
1515915625529114605,130,1,13.52,1,1,1,3
1515915625529114895,130,1,204.29,1,1,3,5
1515915625529116963,96,5,170.65,2,4,3,9
1515915625529117005,130,1,13.29,1,1,1,3
1515915625529119540,130,3,96.66,1,3,3,7
1515915625529121189,110,2,280.38,2,2,3,7
1515915625529128436,130,1,60.83,1,1,2,4
1515915625529128514,130,1,9.35,1,1,1,3
1515915625529130150,112,3,1033.32,2,3,4,9
1515915625529135498,130,2,34.98,1,2,2,5
1515915625529136154,117,2,83.28,1,2,2,5
1515915625529136768,130,1,21.21,1,1,1,3
1515915625529136892,130,1,13.57,1,1,1,3
1515915625529140294,130,1,43.11,1,1,2,4
1515915625529144067,130,1,26.19,1,1,1,3
1515915625529144644,122,1,16.35,1,1,1,3
1515915625529146513,128,1,15.3,1,1,1,3
1515915625529150171,130,1,32.22,1,1,1,3
1515915625529150181,130,1,126.68,1,1,3,5
1515915625529151739,32,11,1153.46,4,4,4,12
1515915625529154793,130,4,172.52,1,3,3,7
1515915625529154830,130,1,75.95,1,1,2,4
1515915625529156013,130,1,32.22,1,1,1,3
1515915625529156032,130,1,44.92,1,1,2,4
1515915625529160510,113,1,569.59,2,1,4,7
1515915625529160864,130,1,29.22,1,1,1,3
1515915625529161567,122,1,150.79,1,1,3,5
1515915625529162085,130,1,43.11,1,1,2,4
1515915625529163525,130,1,12.22,1,1,1,3
1515915625529163702,130,1,32.22,1,1,1,3
1515915625529164003,130,1,24.3,1,1,1,3
1515915625529167642,130,1,10.84,1,1,1,3
1515915625529174796,130,1,26.46,1,1,1,3
1515915625529175062,129,4,75.76,1,3,2,6
1515915625529181173,122,2,296.74,1,2,4,7
1515915625529185450,130,1,36.22,1,1,2,4
1515915625529190063,130,1,36.49,1,1,2,4
1515915625529190594,130,1,23.17,1,1,1,3
1515915625529194120,130,2,85.78,1,2,2,5
1515915625529196517,42,4,37.4,3,3,2,8
1515915625529197863,130,2,52.38,1,2,2,5
1515915625529203474,130,1,9.35,1,1,1,3
1515915625529205182,130,1,25.08,1,1,1,3
1515915625529205790,130,1,63.33,1,1,2,4
1515915625529207715,129,1,35.25,1,1,2,4
1515915625529209216,37,1,599.6,3,1,4,8
1515915625529209279,126,3,40.95,1,3,2,6
1515915625529211253,130,1,11.65,1,1,1,3
1515915625529212581,130,1,284.46,1,1,3,5
1515915625529212730,130,2,24.1,1,2,1,4
1515915625529217105,130,1,32.22,1,1,1,3
1515915625529217916,130,1,75.67,1,1,2,4
1515915625529223230,130,1,17.62,1,1,1,3
1515915625529223748,130,1,33.97,1,1,2,4
1515915625529225303,130,1,66.21,1,1,2,4
1515915625529227203,129,8,806.0,1,4,4,9
1515915625529231498,130,2,134.86,1,2,3,6
1515915625529247491,130,1,144.51,1,1,3,5
1515915625529247747,79,1,77.73,2,1,2,5
1515915625529252372,130,4,654.08,1,3,4,8
1515915625529253466,130,1,347.6,1,1,4,6
1515915625529256150,130,2,145.38,1,2,3,6
1515915625529258532,130,1,21.75,1,1,1,3
1515915625529266629,130,1,87.16,1,1,2,4
1515915625529266801,130,1,15.08,1,1,1,3
1515915625529271510,122,1,85.84,1,1,2,4
1515915625529274357,130,1,26.57,1,1,1,3
1515915625529277357,130,2,18.7,1,2,1,4
1515915625529277702,130,1,80.67,1,1,2,4
1515915625529277740,130,1,26.46,1,1,1,3
1515915625529289151,130,1,11.11,1,1,1,3
1515915625529292691,128,1,103.83,1,1,3,5
1515915625529293028,130,1,25.71,1,1,1,3
1515915625529293554,130,1,69.54,1,1,2,4
1515915625529293580,130,1,51.11,1,1,2,4
1515915625529296319,130,1,11.65,1,1,1,3
1515915625529297084,130,1,16.19,1,1,1,3
1515915625529297459,130,1,27.78,1,1,1,3
1515915625529301186,129,4,116.03999999999999,1,3,3,7
1515915625529305313,130,1,1.57,1,1,1,3
1515915625529306161,130,2,19.68,1,2,1,4
1515915625529306773,130,1,105.87,1,1,3,5
1515915625529308563,130,1,26.19,1,1,1,3
1515915625529310564,130,1,1.57,1,1,1,3
1515915625529312012,130,1,78.89,1,1,2,4
1515915625529318121,130,1,129.52,1,1,3,5
1515915625529322934,130,1,64.48,1,1,2,4
1515915625529323762,130,1,12.94,1,1,1,3
1515915625529324180,130,1,21.43,1,1,1,3
1515915625529325178,130,1,77.32,1,1,2,4
1515915625529328991,130,1,202.95,1,1,3,5
1515915625529333682,110,1,399.48,2,1,4,7
1515915625529336110,95,1,65.06,2,1,2,5
1515915625529348640,130,1,15.02,1,1,1,3
1515915625529353101,130,1,32.94,1,1,2,4
1515915625529355545,130,2,33.94,1,2,2,5
1515915625529357026,130,1,229.38,1,1,3,5
1515915625529361280,126,2,43.34,1,2,2,5
1515915625529380823,129,4,460.4,1,3,4,8
1515915625529381645,129,1,205.25,1,1,3,5
1515915625529383366,129,1,257.87,1,1,3,5
1515915625529384931,129,2,142.58,1,2,3,6
1515915625529389475,126,1,137.63,1,1,3,5
1515915625529397933,30,3,275.34000000000003,4,3,3,10
1515915625529402494,124,6,167.49,1,4,3,8
1515915625529404025,129,1,327.43,1,1,4,6
1515915625529404320,125,2,322.53999999999996,1,2,4,7
1515915625529405452,129,2,20.96,1,2,1,4
1515915625529410789,129,1,20.79,1,1,1,3
1515915625529413277,129,3,433.53,1,3,4,8
1515915625529413613,129,2,93.8,1,2,3,6
1515915625529418919,129,1,215.4,1,1,3,5
1515915625529424413,129,1,21.9,1,1,1,3
1515915625529426242,129,1,60.54,1,1,2,4
1515915625529426975,129,1,108.56,1,1,3,5
1515915625529427475,129,1,34.08,1,1,2,4
1515915625529430200,24,1,215.06,4,1,3,8
1515915625529435582,110,9,1067.1299999999999,2,4,4,10
1515915625529436493,129,1,18.57,1,1,1,3
1515915625529437552,129,1,268.17,1,1,3,5
1515915625529438691,129,1,218.98,1,1,3,5
1515915625529442855,129,4,87.78,1,3,2,6
1515915625529463215,129,1,23.33,1,1,1,3
1515915625529466486,108,1,33.65,2,1,2,5
1515915625529467937,129,1,112.22,1,1,3,5
1515915625529469589,129,1,17.9,1,1,1,3
1515915625529470430,129,2,53.61,1,2,2,5
1515915625529472671,129,1,26.46,1,1,1,3
1515915625529472674,129,1,20.52,1,1,1,3
1515915625529483255,129,3,105.4,1,3,3,7
1515915625529484410,129,2,123.4,1,2,3,6
1515915625529488619,129,1,29.22,1,1,1,3
1515915625529490864,129,1,87.63,1,1,2,4
1515915625529492039,129,3,79.38,1,3,2,6
1515915625529493853,129,1,210.19,1,1,3,5
1515915625529494749,129,1,15.1,1,1,1,3
1515915625529496061,129,1,126.68,1,1,3,5
1515915625529496692,128,1,15.08,1,1,1,3
1515915625529500545,129,2,30.2,1,2,1,4
1515915625529502776,104,2,88.35,2,2,2,6
1515915625529504341,129,3,262.68,1,3,3,7
1515915625529506221,121,1,163.52,1,1,3,5
1515915625529510099,129,1,19.52,1,1,1,3
1515915625529513487,129,3,70.71000000000001,1,3,2,6
1515915625529518684,129,2,61.08,1,2,2,5
1515915625529520994,129,1,42.6,1,1,2,4
1515915625529522333,129,1,122.86,1,1,3,5
1515915625529524073,129,1,129.14,1,1,3,5
1515915625529528152,129,1,30.0,1,1,1,3
1515915625529534516,128,1,14.57,1,1,1,3
1515915625529536770,11,5,1027.45,4,4,4,12
1515915625529536965,129,1,199.37,1,1,3,5
1515915625529537454,129,1,44.13,1,1,2,4
1515915625529538498,129,1,20.63,1,1,1,3
1515915625529539705,129,2,138.95,1,2,3,6
1515915625529540479,129,3,900.51,1,3,4,8
1515915625529541448,129,1,457.51,1,1,4,6
1515915625529543739,129,1,479.51,1,1,4,6
1515915625529546913,59,7,102.87,3,4,3,10
1515915625529548292,128,1,18.57,1,1,1,3
1515915625529551570,103,1,21.43,2,1,1,4
1515915625529553347,129,2,246.7,1,2,3,6
1515915625529554561,129,1,14.37,1,1,1,3
1515915625529555942,129,1,9.81,1,1,1,3
1515915625529558402,129,2,29.34,1,2,1,4
1515915625529558804,31,1,178.22,4,1,3,8
1515915625529561943,129,1,87.56,1,1,2,4
1515915625529563809,101,6,911.49,2,4,4,10
1515915625529564858,129,3,380.04,1,3,4,8
1515915625529567943,129,2,79.5,1,2,2,5
1515915625529568205,129,1,13.71,1,1,1,3
1515915625529569041,129,1,152.27,1,1,3,5
1515915625529577929,129,1,21.9,1,1,1,3
1515915625529578115,129,1,16.19,1,1,1,3
1515915625529582615,79,4,85.72,2,3,2,7
1515915625529583754,129,4,157.84,1,3,3,7
1515915625529584345,129,1,163.52,1,1,3,5
1515915625529589895,117,1,199.37,1,1,3,5
1515915625529590598,40,4,408.44,3,3,4,10
1515915625529591378,129,1,23.33,1,1,1,3
1515915625529593341,129,1,23.02,1,1,1,3
1515915625529593467,127,2,14.43,1,2,1,4
1515915625529595633,129,1,1.57,1,1,1,3
1515915625529603816,129,3,721.6600000000001,1,3,4,8
1515915625529605266,129,1,34.41,1,1,2,4
1515915625529607828,129,4,40.52,1,3,2,6
1515915625529608943,122,1,43.11,1,1,2,4
1515915625529610172,129,1,32.25,1,1,2,4
1515915625529613014,129,1,88.41,1,1,2,4
1515915625529613861,129,1,94.06,1,1,3,5
1515915625529614546,118,1,155.1,1,1,3,5
1515915625529616245,129,1,9.35,1,1,1,3
1515915625529626972,129,2,35.46,1,2,2,5
1515915625529630439,129,1,10.84,1,1,1,3
1515915625529630916,123,2,208.42,1,2,3,6
1515915625529630952,128,1,259.38,1,1,3,5
1515915625529631107,119,3,41.67,1,3,2,6
1515915625529637144,129,1,259.38,1,1,3,5
1515915625529637202,11,1,214.1,4,1,3,8
1515915625529638924,129,1,23.33,1,1,1,3
1515915625529640606,129,1,69.35,1,1,2,4
1515915625529643743,129,1,70.75,1,1,2,4
1515915625529649233,71,1,26.57,3,1,1,5
1515915625529653610,129,1,18.13,1,1,1,3
1515915625529656231,129,1,34.56,1,1,2,4
1515915625529658002,129,1,64.48,1,1,2,4
1515915625529658325,129,2,64.44,1,2,2,5
1515915625529659332,129,4,174.6,1,3,3,7
1515915625529665008,129,1,204.29,1,1,3,5
1515915625529670504,129,1,23.17,1,1,1,3
1515915625529672535,129,1,35.25,1,1,2,4
1515915625529676926,129,2,53.04,1,2,2,5
1515915625529684528,129,1,292.83,1,1,4,6
1515915625529684867,129,1,204.29,1,1,3,5
1515915625529686185,129,2,103.36,1,2,3,6
1515915625529690741,103,2,405.34,2,2,4,8
1515915625529691781,129,1,29.22,1,1,1,3
1515915625529691960,129,1,409.79,1,1,4,6
1515915625529696020,74,3,314.13,2,3,4,9
1515915625529704488,129,1,415.54,1,1,4,6
1515915625529705216,129,3,93.81,1,3,3,7
1515915625529708945,129,1,331.59,1,1,4,6
1515915625529720966,129,1,322.57,1,1,4,6
1515915625529727713,129,1,87.56,1,1,2,4
1515915625529728066,129,4,1031.48,1,3,4,8
1515915625529734691,129,1,20.19,1,1,1,3
1515915625529735469,129,1,33.19,1,1,2,4
1515915625529745855,129,2,408.58,1,2,4,7
1515915625529749920,129,1,103.83,1,1,3,5
1515915625529766265,129,1,44.68,1,1,2,4
1515915625529766557,129,2,118.59,1,2,3,6
1515915625529768668,129,2,31.74,1,2,1,4
1515915625529778241,128,1,11.6,1,1,1,3
1515915625529790968,74,1,991.1,2,1,4,7
1515915625529792290,128,1,177.95,1,1,3,5
1515915625529799988,128,1,194.6,1,1,3,5
1515915625529800078,128,1,11.9,1,1,1,3
1515915625529802917,128,1,28.1,1,1,1,3
1515915625529811419,128,2,3.14,1,2,1,4
1515915625529811972,113,1,24.6,2,1,1,4
1515915625529814691,128,1,23.49,1,1,1,3
1515915625529818323,128,1,55.65,1,1,2,4
1515915625529826063,128,1,96.9,1,1,3,5
1515915625529829869,128,1,35.08,1,1,2,4
1515915625529830352,128,1,47.14,1,1,2,4
1515915625529830735,128,1,29.22,1,1,1,3
1515915625529832563,128,1,56.27,1,1,2,4
1515915625529834197,128,1,35.08,1,1,2,4
1515915625529838424,128,2,77.66,1,2,2,5
1515915625529839265,96,1,40.0,2,1,2,5
1515915625529842775,97,1,32.22,2,1,1,4
1515915625529843189,128,2,301.3,1,2,4,7
1515915625529847776,128,2,82.86,1,2,2,5
1515915625529852041,128,1,15.87,1,1,1,3
1515915625529856608,128,1,29.22,1,1,1,3
1515915625529865511,128,1,27.32,1,1,1,3
1515915625529865948,50,4,628.56,3,3,4,10
1515915625529866520,128,2,67.3,1,2,2,5
1515915625529867380,128,2,52.92,1,2,2,5
1515915625529869807,128,1,56.27,1,1,2,4
1515915625529871072,10,2,53.14,4,2,2,8
1515915625529871568,59,2,748.76,3,2,4,9
1515915625529873192,128,2,23.3,1,2,1,4
1515915625529873534,128,2,45.39,1,2,2,5
1515915625529876835,128,1,257.87,1,1,3,5
1515915625529877437,128,2,312.42,1,2,4,7
1515915625529879406,128,2,552.4100000000001,1,2,4,7
1515915625529880051,126,6,366.78000000000003,1,4,4,9
1515915625529886963,125,1,23.37,1,1,1,3
1515915625529887342,128,1,67.35,1,1,2,4
1515915625529887804,128,2,30.16,1,2,1,4
1515915625529889293,126,1,23.7,1,1,1,3
1515915625529889373,128,1,67.35,1,1,2,4
1515915625529890558,128,1,13.86,1,1,1,3
1515915625529892098,128,1,26.46,1,1,1,3
1515915625529898825,128,3,363.57,1,3,4,8
1515915625529901043,21,2,108.58,4,2,3,9
1515915625529901373,128,5,213.25,1,4,3,8
1515915625529901532,128,1,69.21,1,1,2,4
1515915625529903256,127,3,256.79999999999995,1,3,3,7
1515915625529903663,128,2,71.74,1,2,2,5
1515915625529907375,128,2,41.9,1,2,2,5
1515915625529910328,128,2,328.66,1,2,4,7
1515915625529924251,128,1,45.1,1,1,2,4
1515915625529929634,128,1,29.22,1,1,1,3
1515915625529930982,128,1,45.1,1,1,2,4
1515915625529932227,128,1,26.37,1,1,1,3
1515915625529933900,128,1,23.48,1,1,1,3
1515915625529936330,128,2,30.16,1,2,1,4
1515915625529940777,128,1,18.9,1,1,1,3
1515915625529943288,128,1,15.08,1,1,1,3
1515915625529943332,127,1,9.84,1,1,1,3
1515915625529946384,128,1,9.14,1,1,1,3
1515915625529951765,128,1,38.59,1,1,2,4
1515915625529952455,128,1,10.83,1,1,1,3
1515915625529953899,128,2,1175.19,1,2,4,7
1515915625529954528,128,2,369.88,1,2,4,7
1515915625529955811,73,1,77.73,2,1,2,5
1515915625529957878,128,2,441.26,1,2,4,7
1515915625529958186,128,2,167.94,1,2,3,6
1515915625529960178,128,1,55.16,1,1,2,4
1515915625529960978,125,1,16.19,1,1,1,3
1515915625529963462,95,3,691.05,2,3,4,9
1515915625529965641,128,2,70.5,1,2,2,5
1515915625529965855,128,2,5.72,1,2,1,4
1515915625529966669,128,1,2.86,1,1,1,3
1515915625529967045,128,1,322.57,1,1,4,6
1515915625529970237,128,1,1385.1,1,1,4,6
1515915625529972118,128,2,63.5,1,2,2,5
1515915625529972699,128,2,112.54,1,2,3,6
1515915625529976925,128,1,202.95,1,1,3,5
1515915625529978656,128,1,202.95,1,1,3,5
1515915625529980506,128,2,64.44,1,2,2,5
1515915625529983550,128,2,3.14,1,2,1,4
1515915625529988453,128,3,302.25,1,3,4,8
1515915625529990917,103,3,835.27,2,3,4,9
1515915625529997386,128,1,198.62,1,1,3,5
1515915625530002767,128,3,312.63,1,3,4,8
1515915625530003145,128,2,27.3,1,2,1,4
1515915625530005060,128,1,22.68,1,1,1,3
1515915625530005298,128,2,33.04,1,2,2,5
1515915625530009362,128,1,16.19,1,1,1,3
1515915625530011567,128,1,16.52,1,1,1,3
1515915625530014466,93,1,154.32,2,1,3,6
1515915625530018072,128,1,502.43,1,1,4,6
1515915625530021363,128,1,56.14,1,1,2,4
1515915625530023928,128,2,207.66,1,2,3,6
1515915625530024291,127,2,110.32,1,2,3,6
1515915625530027227,128,1,15.4,1,1,1,3
1515915625530030619,128,1,64.48,1,1,2,4
1515915625530040719,128,1,121.19,1,1,3,5
1515915625530041810,81,1,23.57,2,1,1,4
1515915625530041916,127,1,26.98,1,1,1,3
1515915625530042547,128,1,23.49,1,1,1,3
1515915625530047641,128,1,10.43,1,1,1,3
1515915625530049271,128,2,27.04,1,2,1,4
1515915625530052006,128,1,20.73,1,1,1,3
1515915625530054294,128,1,27.62,1,1,1,3
1515915625530057490,128,1,32.22,1,1,1,3
1515915625530057934,128,1,33.33,1,1,2,4
1515915625530057940,128,3,82.86,1,3,2,6
1515915625530062421,128,1,17.57,1,1,1,3
1515915625530067901,128,1,32.25,1,1,2,4
1515915625530068448,128,1,11.62,1,1,1,3
1515915625530069402,128,1,43.17,1,1,2,4
1515915625530070341,128,1,104.13,1,1,3,5
1515915625530073953,125,1,17.46,1,1,1,3
1515915625530075188,128,1,63.98,1,1,2,4
1515915625530077924,120,1,81.92,1,1,2,4
1515915625530079763,128,1,109.84,1,1,3,5
1515915625530080974,18,1,152.03,4,1,3,8
1515915625530084745,51,2,406.58,3,2,4,9
1515915625530090820,128,1,105.14,1,1,3,5
1515915625530093101,128,1,29.22,1,1,1,3
1515915625530094292,128,1,21.43,1,1,1,3
1515915625530094644,128,1,130.0,1,1,3,5
1515915625530098600,91,2,33.96,2,2,2,6
1515915625530101724,128,2,473.34,1,2,4,7
1515915625530104830,128,1,12.49,1,1,1,3
1515915625530109061,125,2,585.66,1,2,4,7
1515915625530110581,128,2,147.62,1,2,3,6
1515915625530113464,128,2,37.88,1,2,2,5
1515915625530117159,128,1,202.95,1,1,3,5
1515915625530119586,128,1,91.89,1,1,3,5
1515915625530119735,128,3,78.57000000000001,1,3,2,6
1515915625530119754,95,1,101.05,2,1,3,6
1515915625530121074,128,1,30.54,1,1,1,3
1515915625530135045,125,3,320.39,1,3,4,8
1515915625530135058,128,2,169.78,1,2,3,6
1515915625530135452,128,1,210.19,1,1,3,5
1515915625530136801,126,4,129.53,1,3,3,7
1515915625530137422,117,18,9418.62,1,4,4,9
1515915625530159480,124,1,96.86,1,1,3,5
1515915625530164007,127,2,58.44,1,2,2,5
1515915625530164257,127,1,61.16,1,1,2,4
1515915625530166293,121,1,63.98,1,1,2,4
1515915625530167614,127,2,68.92,1,2,2,5
1515915625530168033,127,3,142.23,1,3,3,7
1515915625530170958,126,1,162.51,1,1,3,5
1515915625530176254,127,1,122.86,1,1,3,5
1515915625530181447,127,1,1.57,1,1,1,3
1515915625530187104,114,1,122.97,1,1,3,5
1515915625530195570,127,1,40.16,1,1,2,4
1515915625530195665,127,1,17.9,1,1,1,3
1515915625530204184,127,1,14.6,1,1,1,3
1515915625530207204,127,1,28.89,1,1,1,3
1515915625530212591,127,1,103.83,1,1,3,5
1515915625530215979,127,1,257.87,1,1,3,5
1515915625530217685,127,1,53.17,1,1,2,4
1515915625530219002,127,1,19.19,1,1,1,3
1515915625530220451,127,1,82.97,1,1,2,4
1515915625530220545,127,1,61.43,1,1,2,4
1515915625530225804,127,1,61.43,1,1,2,4
1515915625530226059,127,1,14.29,1,1,1,3
1515915625530226363,101,1,172.86,2,1,3,6
1515915625530227641,122,2,738.81,1,2,4,7
1515915625530227912,127,1,149.7,1,1,3,5
1515915625530230031,127,4,104.76,1,3,3,7
1515915625530241303,127,1,23.81,1,1,1,3
1515915625530242471,127,1,16.98,1,1,1,3
1515915625530244020,127,1,17.32,1,1,1,3
1515915625530248713,127,1,5.0,1,1,1,3
1515915625530260220,127,1,32.22,1,1,1,3
1515915625530261739,127,1,29.22,1,1,1,3
1515915625530268388,127,1,34.46,1,1,2,4
1515915625530272817,127,1,13.65,1,1,1,3
1515915625530274828,125,1,256.81,1,1,3,5
1515915625530280613,63,1,26.19,3,1,1,5
1515915625530281961,127,1,11.65,1,1,1,3
1515915625530283294,126,2,74.05,1,2,2,5
1515915625530283934,127,1,15.71,1,1,1,3
1515915625530284980,127,1,1.57,1,1,1,3
1515915625530285599,127,1,12.54,1,1,1,3
1515915625530287798,105,2,320.57000000000005,2,2,4,8
1515915625530288111,21,1,82.33,4,1,2,7
1515915625530289554,127,1,65.08,1,1,2,4
1515915625530290676,127,1,80.51,1,1,2,4
1515915625530294206,127,1,43.11,1,1,2,4
1515915625530297741,127,1,13.17,1,1,1,3
1515915625530302043,127,1,42.38,1,1,2,4
1515915625530303328,127,1,31.27,1,1,1,3
1515915625530303635,127,1,33.54,1,1,2,4
1515915625530303839,114,3,99.51,1,3,3,7
1515915625530304024,66,1,616.62,3,1,4,8
1515915625530304655,77,2,259.08,2,2,3,7
1515915625530304953,127,3,58.56,1,3,2,6
1515915625530309045,127,1,20.63,1,1,1,3
1515915625530309735,32,1,32.22,4,1,1,6
1515915625530312867,127,2,67.72,1,2,2,5
1515915625530313357,127,1,292.83,1,1,4,6
1515915625530314941,104,3,185.73000000000002,2,3,3,8
1515915625530315776,127,1,24.6,1,1,1,3
1515915625530315902,127,1,23.17,1,1,1,3
1515915625530316187,127,1,15.24,1,1,1,3
1515915625530316655,127,1,103.83,1,1,3,5
1515915625530319277,127,1,26.19,1,1,1,3
1515915625530321452,127,1,19.37,1,1,1,3
1515915625530321511,127,2,56.82,1,2,2,5
1515915625530321898,127,2,39.25,1,2,2,5
1515915625530323411,127,1,43.11,1,1,2,4
1515915625530323763,108,1,190.46,2,1,3,6
1515915625530329243,109,1,116.83,2,1,3,6
1515915625530331972,33,3,1229.87,4,3,4,11
1515915625530335458,127,1,51.68,1,1,2,4
1515915625530335487,86,2,87.62,2,2,2,6
1515915625530338453,125,5,1021.4499999999999,1,4,4,9
1515915625530344371,127,1,10.16,1,1,1,3
1515915625530352681,127,2,45.08,1,2,2,5
1515915625530356704,127,1,26.19,1,1,1,3
1515915625530358861,118,3,644.95,1,3,4,8
1515915625530359644,126,2,112.54,1,2,3,6
1515915625530360493,62,1,482.52,3,1,4,8
1515915625530360862,64,6,193.32,3,4,3,10
1515915625530361374,127,1,17.3,1,1,1,3
1515915625530371604,127,1,41.51,1,1,2,4
1515915625530372036,126,1,12.86,1,1,1,3
1515915625530374240,127,1,26.17,1,1,1,3
1515915625530378908,127,1,67.78,1,1,2,4
1515915625530379019,127,1,15.4,1,1,1,3
1515915625530391009,127,2,50.8,1,2,2,5
1515915625530393562,88,1,112.06,2,1,3,6
1515915625530395288,127,2,136.66,1,2,3,6
1515915625530399122,121,2,69.2,1,2,2,5
1515915625530400058,127,4,620.4,1,3,4,8
1515915625530400083,109,2,1079.14,2,2,4,8
1515915625530400284,127,1,2.86,1,1,1,3
1515915625530401225,127,2,104.88,1,2,3,6
1515915625530405762,127,5,50.25,1,4,2,7
1515915625530408850,82,2,311.13,2,2,4,8
1515915625530408974,127,3,118.53,1,3,3,7
1515915625530412518,126,1,12.41,1,1,1,3
1515915625530418744,126,1,105.87,1,1,3,5
1515915625530420075,42,1,14.6,3,1,1,5
1515915625530421705,122,1,36.67,1,1,2,4
1515915625530423697,52,2,401.39,3,2,4,9
1515915625530425143,127,1,26.46,1,1,1,3
1515915625530428763,126,4,756.68,1,3,4,8
1515915625530429782,127,4,453.52,1,3,4,8
1515915625530433182,121,1,16.19,1,1,1,3
1515915625530434513,127,1,35.87,1,1,2,4
1515915625530434761,127,1,11.86,1,1,1,3
1515915625530436585,117,2,52.38,1,2,2,5
1515915625530442231,127,1,415.54,1,1,4,6
1515915625530443490,127,2,115.24,1,2,3,6
1515915625530451309,127,4,200.2,1,3,3,7
1515915625530466728,127,1,263.38,1,1,3,5
1515915625530466835,127,3,1467.89,1,3,4,8
1515915625530468654,127,1,26.19,1,1,1,3
1515915625530471170,127,1,257.87,1,1,3,5
1515915625530473711,127,1,155.43,1,1,3,5
1515915625530478447,127,3,62.37,1,3,2,6
1515915625530478692,127,1,29.57,1,1,1,3
1515915625530480301,127,1,10.29,1,1,1,3
1515915625530481280,127,1,201.33,1,1,3,5
1515915625530484444,127,1,30.38,1,1,1,3
1515915625530485560,124,2,52.38,1,2,2,5
1515915625530491062,127,1,63.33,1,1,2,4
1515915625530497599,127,1,218.98,1,1,3,5
1515915625530501908,126,4,982.96,1,3,4,8
1515915625530506332,127,4,113.8,1,3,3,7
1515915625530514048,127,2,515.74,1,2,4,7
1515915625530514067,127,2,34.74,1,2,2,5
1515915625530519264,127,1,218.98,1,1,3,5
1515915625530521931,125,3,91.62,1,3,3,7
1515915625530534149,104,4,415.25,2,3,4,9
1515915625530536466,115,1,65.71,1,1,2,4
1515915625530541327,126,1,20.79,1,1,1,3
1515915625530543819,126,2,29.2,1,2,1,4
1515915625530549435,126,1,32.38,1,1,2,4
1515915625530561433,126,1,37.14,1,1,2,4
1515915625530563431,126,2,74.89,1,2,2,5
1515915625530573074,125,2,155.46,1,2,3,6
1515915625530576214,126,1,14.6,1,1,1,3
1515915625530580933,126,2,525.64,1,2,4,7
1515915625530581820,119,7,1234.3,1,4,4,9
1515915625530582113,126,1,50.11,1,1,2,4
1515915625530582247,126,1,11.98,1,1,1,3
1515915625530586178,92,8,907.04,2,4,4,10
1515915625530592163,125,1,75.73,1,1,2,4
1515915625530597179,126,1,42.89,1,1,2,4
1515915625530598856,126,1,10.05,1,1,1,3
1515915625530599265,126,1,6.79,1,1,1,3
1515915625530607129,126,1,284.3,1,1,3,5
1515915625530607482,126,1,17.78,1,1,1,3
1515915625530608018,126,1,155.1,1,1,3,5
1515915625530612432,126,1,56.62,1,1,2,4
1515915625530618307,126,1,181.98,1,1,3,5
1515915625530622514,126,1,34.95,1,1,2,4
1515915625530625472,80,2,30.2,2,2,1,5
1515915625530627048,126,2,2722.16,1,2,4,7
1515915625530630989,126,1,1.57,1,1,1,3
1515915625530631249,126,2,57.94,1,2,2,5
1515915625530631962,60,1,46.67,3,1,2,6
1515915625530637877,126,1,9.84,1,1,1,3
1515915625530639975,126,2,31.12,1,2,1,4
1515915625530644565,126,3,101.13,1,3,3,7
1515915625530646928,126,1,57.13,1,1,2,4
1515915625530647539,126,1,43.13,1,1,2,4
1515915625530649178,115,2,720.74,1,2,4,7
1515915625530650342,101,3,598.11,2,3,4,9
1515915625530650586,126,1,1.57,1,1,1,3
1515915625530657120,126,1,82.86,1,1,2,4
1515915625530657128,126,1,39.21,1,1,2,4
1515915625530658228,109,3,578.58,2,3,4,9
1515915625530661510,126,1,22.87,1,1,1,3
1515915625530662855,125,1,52.44,1,1,2,4
1515915625530664260,126,1,399.48,1,1,4,6
1515915625530664642,126,3,304.90000000000003,1,3,4,8
1515915625530668485,126,1,11.9,1,1,1,3
1515915625530669418,126,1,42.75,1,1,2,4
1515915625530670821,126,1,33.97,1,1,2,4
1515915625530671070,126,1,50.05,1,1,2,4
1515915625530675864,126,2,33.94,1,2,2,5
1515915625530678688,115,9,1822.33,1,4,4,9
1515915625530681947,126,1,26.57,1,1,1,3
1515915625530682219,74,3,179.94,2,3,3,8
1515915625530684203,126,1,16.19,1,1,1,3
1515915625530689022,126,2,10.44,1,2,1,4
1515915625530691800,124,2,86.38,1,2,2,5
1515915625530691827,126,1,55.38,1,1,2,4
1515915625530692934,63,3,66.66,3,3,2,8
1515915625530693425,126,2,59.36,1,2,2,5
1515915625530693735,126,1,43.11,1,1,2,4
1515915625530694036,126,2,207.66,1,2,3,6
1515915625530696161,78,4,94.28,2,3,3,8
1515915625530696720,126,2,90.48,1,2,2,5
1515915625530698473,126,2,237.14,1,2,3,6
1515915625530703517,126,1,19.27,1,1,1,3
1515915625530704531,126,1,155.1,1,1,3,5
1515915625530705631,126,1,17.92,1,1,1,3
1515915625530706058,126,1,42.98,1,1,2,4
1515915625530706598,126,1,74.46,1,1,2,4
1515915625530706712,126,1,14.86,1,1,1,3
1515915625530714700,126,1,189.17,1,1,3,5
1515915625530715320,126,1,15.87,1,1,1,3
1515915625530716700,126,1,83.02,1,1,2,4
1515915625530721195,126,2,30.0,1,2,1,4
1515915625530724198,126,2,245.72,1,2,3,6
1515915625530725209,126,2,105.4,1,2,3,6
1515915625530725481,126,3,368.58,1,3,4,8
1515915625530725518,126,1,13.81,1,1,1,3
1515915625530725570,126,2,75.96,1,2,2,5
1515915625530728535,126,1,21.75,1,1,1,3
1515915625530728578,126,4,121.52,1,3,3,7
1515915625530729466,126,1,100.75,1,1,3,5
1515915625530733664,124,1,37.87,1,1,2,4
1515915625530735203,126,3,51.27,1,3,2,6
1515915625530742250,124,1,26.46,1,1,1,3
1515915625530744739,126,1,18.89,1,1,1,3
1515915625530747649,126,1,154.06,1,1,3,5
1515915625530748138,99,1,96.37,2,1,3,6
1515915625530749309,48,2,50.8,3,2,2,7
1515915625530749601,112,4,100.79,2,3,3,8
1515915625530754168,126,1,111.27,1,1,3,5
1515915625530757171,126,1,123.44,1,1,3,5
1515915625530757789,124,1,192.86,1,1,3,5
1515915625530764815,126,1,115.79,1,1,3,5
1515915625530766955,126,1,27.65,1,1,1,3
1515915625530767686,119,1,647.29,1,1,4,6
1515915625530768299,126,1,449.51,1,1,4,6
1515915625530769695,126,1,30.63,1,1,1,3
1515915625530769841,126,4,47.92,1,3,2,6
1515915625530772964,126,1,50.03,1,1,2,4
1515915625530773598,126,1,60.16,1,1,2,4
1515915625530776863,126,1,43.11,1,1,2,4
1515915625530780618,126,3,261.48,1,3,3,7
1515915625530783273,126,2,481.96,1,2,4,7
1515915625530784672,46,2,231.42,3,2,3,8
1515915625530793892,126,2,75.96,1,2,2,5
1515915625530794224,123,1,15.87,1,1,1,3
1515915625530799405,110,5,972.08,2,4,4,10
1515915625530803233,126,2,126.66,1,2,3,6
1515915625530806791,126,1,230.48,1,1,3,5
1515915625530822588,126,3,165.48,1,3,3,7
1515915625530824487,125,3,1883.1000000000001,1,3,4,8
1515915625530828323,126,1,33.19,1,1,2,4
1515915625530832177,126,1,29.57,1,1,1,3
1515915625530836738,126,1,82.97,1,1,2,4
1515915625530838202,126,1,292.83,1,1,4,6
1515915625530840759,126,1,77.73,1,1,2,4
1515915625530841947,124,2,127.96,1,2,3,6
1515915625530848590,126,1,257.87,1,1,3,5
1515915625530853536,126,1,33.65,1,1,2,4
1515915625530854173,126,2,195.88,1,2,3,6
1515915625530856347,28,1,227.3,4,1,3,8
1515915625530857148,126,1,230.35,1,1,3,5
1515915625530859522,126,4,41.92,1,3,2,6
1515915625530860415,126,1,246.51,1,1,3,5
1515915625530862178,126,1,10.48,1,1,1,3
1515915625530867624,125,1,1428.11,1,1,4,6
1515915625530873236,59,1,179.94,3,1,3,7
1515915625530874328,125,2,1039.12,1,2,4,7
1515915625530877296,11,1,27.14,4,1,1,6
1515915625530878063,126,1,14.19,1,1,1,3
1515915625530884191,126,1,337.44,1,1,4,6
1515915625530885383,126,1,75.67,1,1,2,4
1515915625530889362,98,1,101.05,2,1,3,6
1515915625530889375,126,1,471.52,1,1,4,6
1515915625530896231,125,1,18.41,1,1,1,3
1515915625530900152,125,2,556.06,1,2,4,7
1515915625530901141,126,1,10.59,1,1,1,3
1515915625530905249,126,3,167.28,1,3,3,7
1515915625530911091,125,1,202.67,1,1,3,5
1515915625530911823,126,5,861.9,1,4,4,9
1515915625530913543,125,2,155.46,1,2,3,6
1515915625530937775,123,3,28.049999999999997,1,3,1,5
1515915625530940559,52,1,1.57,3,1,1,5
1515915625530941523,125,2,29.76,1,2,1,4
1515915625530945098,125,3,519.9000000000001,1,3,4,8
1515915625530958759,125,6,450.36,1,4,4,9
1515915625530964860,125,1,14.76,1,1,1,3
1515915625530968361,125,2,405.9,1,2,4,7
1515915625530970131,125,1,37.11,1,1,2,4
1515915625530975360,125,4,349.84000000000003,1,3,4,8
1515915625530978855,125,1,278.03,1,1,3,5
1515915625530982363,125,4,69.52,1,3,2,6
1515915625530985035,111,1,29.37,2,1,1,4
1515915625530987574,125,1,75.67,1,1,2,4
1515915625530987914,125,1,119.7,1,1,3,5
1515915625530988119,125,2,30.2,1,2,1,4
1515915625530988990,125,1,188.41,1,1,3,5
1515915625530990538,125,1,53.17,1,1,2,4
1515915625530995356,125,2,22.38,1,2,1,4
1515915625530996394,125,1,14.08,1,1,1,3
1515915625530998225,96,2,4.43,2,2,1,5
1515915625531001006,125,1,56.16,1,1,2,4
1515915625531002035,125,5,160.36,1,4,3,8
1515915625531003671,125,2,46.34,1,2,2,5
1515915625531004943,125,6,72.74,1,4,2,7
1515915625531005001,125,1,26.19,1,1,1,3
1515915625531005078,125,1,230.35,1,1,3,5
1515915625531005524,125,1,48.57,1,1,2,4
1515915625531006693,125,2,60.96,1,2,2,5
1515915625531006878,12,2,408.58,4,2,4,10
1515915625531009180,74,2,3.14,2,2,1,5
1515915625531011584,110,1,52.49,2,1,2,5
1515915625531016669,125,2,85.14,1,2,2,5
1515915625531018040,125,3,78.57000000000001,1,3,2,6
1515915625531024126,78,2,315.56,2,2,4,8
1515915625531027191,125,1,204.29,1,1,3,5
1515915625531029654,84,11,3291.96,2,4,4,10
1515915625531034082,125,1,224.76,1,1,3,5
1515915625531035844,125,1,31.27,1,1,1,3
1515915625531035888,125,2,31.8,1,2,1,4
1515915625531036834,125,2,26.11,1,2,1,4
1515915625531039327,125,2,46.98,1,2,2,5
1515915625531040538,125,8,217.28,1,4,3,8
1515915625531043067,36,1,519.56,3,1,4,8
1515915625531043828,69,7,10.99,3,4,1,8
1515915625531051199,123,4,856.4,1,3,4,8
1515915625531051787,125,1,397.79,1,1,4,6
1515915625531054003,125,2,146.95999999999998,1,2,3,6
1515915625531058345,125,1,123.73,1,1,3,5
1515915625531065980,125,1,18.19,1,1,1,3
1515915625531069665,125,1,35.87,1,1,2,4
1515915625531069781,125,1,118.57,1,1,3,5
1515915625531071049,125,1,11.9,1,1,1,3
1515915625531071313,125,4,74.92,1,3,2,6
1515915625531074125,125,1,49.84,1,1,2,4
1515915625531082490,125,1,61.29,1,1,2,4
1515915625531087725,125,2,51.74,1,2,2,5
1515915625531088457,125,1,22.86,1,1,1,3
1515915625531088934,125,1,50.32,1,1,2,4
1515915625531090967,125,1,1.57,1,1,1,3
1515915625531094611,125,1,12.38,1,1,1,3
1515915625531094912,114,2,23.8,1,2,1,4
1515915625531098038,124,1,86.48,1,1,2,4
1515915625531100390,125,1,21.43,1,1,1,3
1515915625531103527,84,1,294.41,2,1,4,7
1515915625531106287,125,1,155.1,1,1,3,5
1515915625531108218,125,1,43.7,1,1,2,4
1515915625531110827,124,2,151.52,1,2,3,6
1515915625531118421,125,1,34.65,1,1,2,4
1515915625531128009,125,1,16.19,1,1,1,3
1515915625531128391,125,1,9.37,1,1,1,3
1515915625531129347,125,1,26.98,1,1,1,3
1515915625531130989,125,1,149.05,1,1,3,5
1515915625531131492,125,3,63.63,1,3,2,6
1515915625531132213,125,2,20.26,1,2,1,4
1515915625531132939,124,1,9.35,1,1,1,3
1515915625531136870,91,1,364.46,2,1,4,7
1515915625531138670,125,1,381.62,1,1,4,6
1515915625531138832,125,3,571.62,1,3,4,8
1515915625531140863,113,1,162.86,2,1,3,6
1515915625531141716,125,1,1090.7,1,1,4,6
1515915625531142992,125,2,27.72,1,2,1,4
1515915625531146221,125,1,56.27,1,1,2,4
1515915625531149280,125,8,243.72,1,4,3,8
1515915625531155588,125,1,112.22,1,1,3,5
1515915625531165354,104,8,353.4,2,4,4,10
1515915625531174504,125,1,374.38,1,1,4,6
1515915625531176504,125,1,59.6,1,1,2,4
1515915625531176607,125,1,1.57,1,1,1,3
1515915625531177462,125,1,22.22,1,1,1,3
1515915625531179831,125,1,35.87,1,1,2,4
1515915625531180761,118,3,69.51,1,3,2,6
1515915625531183190,125,2,42.74,1,2,2,5
1515915625531187144,125,1,71.75,1,1,2,4
1515915625531196792,125,1,224.76,1,1,3,5
1515915625531198560,125,1,540.14,1,1,4,6
1515915625531199338,69,4,107.92,3,3,3,9
1515915625531199845,123,3,45.24,1,3,2,6
1515915625531201499,125,1,13.02,1,1,1,3
1515915625531203769,125,1,292.83,1,1,4,6
1515915625531204657,114,2,198.1,1,2,3,6
1515915625531207268,125,1,18.65,1,1,1,3
1515915625531207957,125,1,12.48,1,1,1,3
1515915625531213675,125,1,29.22,1,1,1,3
1515915625531215141,125,1,30.38,1,1,1,3
1515915625531221523,27,2,19.9,4,2,1,7
1515915625531221778,125,1,113.48,1,1,3,5
1515915625531222359,6,1,11.13,4,1,1,6
1515915625531226667,125,1,482.76,1,1,4,6
1515915625531228636,125,1,178.22,1,1,3,5
1515915625531235063,123,1,28.41,1,1,1,3
1515915625531237788,125,4,51.120000000000005,1,3,2,6
1515915625531238042,122,4,241.28,1,3,3,7
1515915625531238570,124,1,86.37,1,1,2,4
1515915625531239425,124,2,408.58,1,2,4,7
1515915625531243027,125,3,1578.69,1,3,4,8
1515915625531243161,89,1,256.94,2,1,3,6
1515915625531244870,125,1,20.71,1,1,1,3
1515915625531249451,125,2,3.14,1,2,1,4
1515915625531250490,89,2,58.96,2,2,2,6
1515915625531254682,125,1,31.11,1,1,1,3
1515915625531257869,125,1,65.32,1,1,2,4
1515915625531257895,125,2,35.24,1,2,2,5
1515915625531257922,125,1,43.11,1,1,2,4
1515915625531259218,125,1,18.57,1,1,1,3
1515915625531263160,125,1,23.13,1,1,1,3
1515915625531264654,123,7,522.05,1,4,4,9
1515915625531265417,116,1,28.1,1,1,1,3
1515915625531266487,125,1,205.32,1,1,3,5
1515915625531267071,125,1,12.21,1,1,1,3
1515915625531267618,125,3,57.150000000000006,1,3,2,6
1515915625531269660,124,4,152.24,1,3,3,7
1515915625531272459,125,6,628.44,1,4,4,9
1515915625531274744,124,1,32.22,1,1,1,3
1515915625531276646,124,3,214.14,1,3,3,7
1515915625531278062,125,1,75.67,1,1,2,4
1515915625531280108,124,2,32.09,1,2,1,4
1515915625531281365,125,2,20.86,1,2,1,4
1515915625531282588,18,2,197.24,4,2,3,9
1515915625531283375,125,1,33.97,1,1,2,4
1515915625531285669,120,2,331.24,1,2,4,7
1515915625531287806,125,1,33.16,1,1,2,4
1515915625531291596,125,1,104.86,1,1,3,5
1515915625531294590,124,2,398.74,1,2,4,7
1515915625531295839,56,3,311.49,3,3,4,10
1515915625531303178,110,12,1322.29,2,4,4,10
1515915625531305147,125,1,7.0,1,1,1,3
1515915625531315820,124,4,104.29,1,3,3,7
1515915625531316501,91,2,39.84,2,2,2,6
1515915625531317525,123,2,506.76,1,2,4,7
1515915625531318337,124,1,55.38,1,1,2,4
1515915625531320178,124,3,95.85,1,3,3,7
1515915625531329068,84,1,339.51,2,1,4,7
1515915625531332975,124,1,55.35,1,1,2,4
1515915625531335856,124,2,41.26,1,2,2,5
1515915625531337052,124,1,29.52,1,1,1,3
1515915625531337976,123,3,94.28999999999999,1,3,3,7
1515915625531339818,121,6,92.58,1,4,3,8
1515915625531340896,120,1,292.83,1,1,4,6
1515915625531342651,124,1,144.51,1,1,3,5
1515915625531347583,124,2,141.14,1,2,3,6
1515915625531353203,124,1,266.75,1,1,3,5
1515915625531353794,124,3,129.75,1,3,3,7
1515915625531355495,124,1,9.71,1,1,1,3
1515915625531356291,112,1,22.4,2,1,1,4
1515915625531357780,124,1,155.43,1,1,3,5
1515915625531364451,124,2,39.04,1,2,2,5
1515915625531367959,124,2,48.13,1,2,2,5
1515915625531368217,124,1,16.67,1,1,1,3
1515915625531372651,124,1,13.86,1,1,1,3
1515915625531372779,116,1,284.46,1,1,3,5
1515915625531382320,124,1,29.68,1,1,1,3
1515915625531382529,121,4,496.52,1,3,4,8
1515915625531384743,119,2,38.74,1,2,2,5
1515915625531387120,124,1,17.08,1,1,1,3
1515915625531390233,124,1,11.27,1,1,1,3
1515915625531395952,124,1,40.16,1,1,2,4
1515915625531396194,124,1,86.48,1,1,2,4
1515915625531398187,123,5,172.2,1,4,3,8
1515915625531398309,122,5,251.75,1,4,3,8
1515915625531402059,124,1,26.46,1,1,1,3
1515915625531404401,123,1,20.83,1,1,1,3
1515915625531408156,118,2,103.36,1,2,3,6
1515915625531410549,124,2,85.14,1,2,2,5
1515915625531416750,118,2,79.36,1,2,2,5
1515915625531417139,124,1,202.67,1,1,3,5
1515915625531419079,37,1,17.78,3,1,1,5
1515915625531420811,124,2,103.36,1,2,3,6
1515915625531426466,124,1,22.22,1,1,1,3
1515915625531429107,124,1,26.46,1,1,1,3
1515915625531429349,124,1,103.83,1,1,3,5
1515915625531435599,124,1,9.81,1,1,1,3
1515915625531435907,124,1,16.19,1,1,1,3
1515915625531435917,124,7,3192.98,1,4,4,9
1515915625531438979,124,1,86.16,1,1,2,4
1515915625531443207,124,2,46.04,1,2,2,5
1515915625531446355,124,1,59.68,1,1,2,4
1515915625531446900,13,1,71.27,4,1,2,7
1515915625531447064,124,2,1339.26,1,2,4,7
1515915625531452445,124,2,33.96,1,2,2,5
1515915625531453146,124,1,11.62,1,1,1,3
1515915625531459889,124,2,241.98000000000002,1,2,3,6
1515915625531462429,124,1,1.57,1,1,1,3
1515915625531464325,124,1,65.08,1,1,2,4
1515915625531465429,124,1,93.43,1,1,3,5
1515915625531465615,124,1,26.46,1,1,1,3
1515915625531465818,124,1,97.35,1,1,3,5
1515915625531468853,124,1,163.52,1,1,3,5
1515915625531469891,124,2,361.42,1,2,4,7
1515915625531472335,124,1,12.7,1,1,1,3
1515915625531473245,124,1,43.13,1,1,2,4
1515915625531475255,89,2,56.82,2,2,2,6
1515915625531476659,124,1,385.44,1,1,4,6
1515915625531477358,124,2,18.049999999999997,1,2,1,4
1515915625531477915,124,1,43.11,1,1,2,4
1515915625531478584,124,2,915.02,1,2,4,7
1515915625531480352,124,5,1765.3,1,4,4,9
1515915625531481083,68,3,1409.55,3,3,4,10
1515915625531481428,124,1,42.06,1,1,2,4
1515915625531483203,124,1,50.63,1,1,2,4
1515915625531488525,124,1,12.83,1,1,1,3
1515915625531491068,22,6,786.81,4,4,4,12
1515915625531492301,124,2,651.9,1,2,4,7
1515915625531493087,124,1,9.79,1,1,1,3
1515915625531497027,124,1,69.3,1,1,2,4
1515915625531499379,124,1,11.11,1,1,1,3
1515915625531499634,124,2,55.78,1,2,2,5
1515915625531503340,124,1,17.46,1,1,1,3
1515915625531503361,36,1,449.51,3,1,4,8
1515915625531507655,124,2,111.56,1,2,3,6
1515915625531508998,123,1,21.59,1,1,1,3
1515915625531512241,124,1,257.87,1,1,3,5
1515915625531516468,124,1,28.71,1,1,1,3
1515915625531522062,112,2,64.44,2,2,2,6
1515915625531523172,124,1,210.9,1,1,3,5
1515915625531524012,89,3,827.06,2,3,4,9
1515915625531524700,124,2,748.76,1,2,4,7
1515915625531527345,124,1,204.29,1,1,3,5
1515915625531527481,119,2,40.96,1,2,2,5
1515915625531528332,124,1,42.06,1,1,2,4
1515915625531533871,124,1,23.49,1,1,1,3
1515915625531534150,124,3,261.48,1,3,3,7
1515915625531534277,124,1,98.41,1,1,3,5
1515915625531536018,124,1,21.27,1,1,1,3
1515915625531537009,73,1,345.44,2,1,4,7
1515915625531540447,124,2,127.96,1,2,3,6
1515915625531543890,124,1,63.98,1,1,2,4
1515915625531545144,124,2,33.56,1,2,2,5
1515915625531545699,123,7,577.64,1,4,4,9
1515915625531547319,124,4,104.76,1,3,3,7
1515915625531558310,32,2,23.04,4,2,1,7
1515915625531561274,124,1,20.56,1,1,1,3
1515915625531565790,55,2,473.94,3,2,4,9
1515915625531568591,114,2,935.0999999999999,1,2,4,7
1515915625531568759,124,1,23.13,1,1,1,3
1515915625531573547,124,1,14.29,1,1,1,3
1515915625531576542,124,1,18.73,1,1,1,3
1515915625531577454,124,1,29.37,1,1,1,3
1515915625531577538,124,2,23.84,1,2,1,4
1515915625531579473,124,2,44.66,1,2,2,5
1515915625531581190,122,2,322.6,1,2,4,7
1515915625531582047,115,1,14.22,1,1,1,3
1515915625531587556,124,1,149.05,1,1,3,5
1515915625531588222,124,1,204.29,1,1,3,5
1515915625531594944,124,1,1.57,1,1,1,3
1515915625531595351,124,1,181.67,1,1,3,5
1515915625531598728,124,1,51.75,1,1,2,4
1515915625531600474,124,1,115.71,1,1,3,5
1515915625531600727,124,1,1.57,1,1,1,3
1515915625531603001,124,1,52.71,1,1,2,4
1515915625531604323,124,1,33.19,1,1,2,4
1515915625531614105,123,1,63.33,1,1,2,4
1515915625531621540,75,1,117.75,2,1,3,6
1515915625531621668,123,1,122.86,1,1,3,5
1515915625531623414,124,1,29.68,1,1,1,3
1515915625531624890,124,1,64.48,1,1,2,4
1515915625531627703,124,1,34.44,1,1,2,4
1515915625531628376,121,3,158.82,1,3,3,7
1515915625531628416,124,1,13.86,1,1,1,3
1515915625531636489,118,1,189.17,1,1,3,5
1515915625531638237,79,1,107.95,2,1,3,6
1515915625531640736,73,3,166.37,2,3,3,8
1515915625531641377,104,1,12.71,2,1,1,4
1515915625531645494,108,1,28.57,2,1,1,4
1515915625531646509,124,1,35.24,1,1,2,4
1515915625531651268,124,1,15.3,1,1,1,3
1515915625531651744,124,1,73.81,1,1,2,4
1515915625531652821,124,3,91.80000000000001,1,3,3,7
1515915625531654691,58,1,51.33,3,1,2,6
1515915625531657149,124,2,70.78,1,2,2,5
1515915625531658295,124,2,248.69,1,2,3,6
1515915625531659637,124,1,314.97,1,1,4,6
1515915625531660760,124,1,29.57,1,1,1,3
1515915625531661522,124,1,268.17,1,1,3,5
1515915625531672823,124,1,28.1,1,1,1,3
1515915625531673533,100,1,569.59,2,1,4,7
1515915625531674172,122,1,86.37,1,1,2,4
1515915625531677188,124,3,900.51,1,3,4,8
1515915625531678737,124,1,7.67,1,1,1,3
1515915625531683972,124,2,351.62,1,2,4,7
1515915625531684234,58,1,103.83,3,1,3,7
1515915625531684927,118,2,101.74,1,2,3,6
1515915625531686851,124,2,165.94,1,2,3,6
1515915625531691701,124,1,14.08,1,1,1,3
1515915625531692154,124,1,107.79,1,1,3,5
1515915625531697927,124,1,25.86,1,1,1,3
1515915625531700059,124,1,10.71,1,1,1,3
1515915625531700934,46,3,50.099999999999994,3,3,2,8
1515915625531703410,124,1,1003.68,1,1,4,6
1515915625531707299,124,1,230.35,1,1,3,5
1515915625531710707,123,2,1294.58,1,2,4,7
1515915625531721231,123,1,268.17,1,1,3,5
1515915625531725002,123,1,268.17,1,1,3,5
1515915625531732001,123,1,110.78,1,1,3,5
1515915625531733517,107,1,124.81,2,1,3,6
1515915625531739959,123,1,23.81,1,1,1,3
1515915625531742710,123,3,36.660000000000004,1,3,2,6
1515915625531742993,123,1,119.7,1,1,3,5
1515915625531752701,123,2,138.76,1,2,3,6
1515915625531769095,123,1,53.33,1,1,2,4
1515915625531770707,123,1,1.57,1,1,1,3
1515915625531779796,123,1,26.19,1,1,1,3
1515915625531779958,123,1,545.13,1,1,4,6
1515915625531781998,123,1,56.27,1,1,2,4
1515915625531787306,122,2,310.2,1,2,4,7
1515915625531789442,123,1,17.44,1,1,1,3
1515915625531790066,123,1,204.29,1,1,3,5
1515915625531790196,121,1,10.08,1,1,1,3
1515915625531791065,103,1,127.08,2,1,3,6
1515915625531792121,123,1,23.17,1,1,1,3
1515915625531795556,123,1,14.86,1,1,1,3
1515915625531797504,105,2,193.2,2,2,3,7
1515915625531799548,123,1,137.57,1,1,3,5
1515915625531802838,123,1,58.95,1,1,2,4
1515915625531806365,123,3,347.94,1,3,4,8
1515915625531806425,123,1,16.7,1,1,1,3
1515915625531807129,123,1,240.98,1,1,3,5
1515915625531807718,123,2,48.6,1,2,2,5
1515915625531807804,123,1,53.37,1,1,2,4
1515915625531808164,123,1,32.86,1,1,2,4
1515915625531809636,123,1,42.17,1,1,2,4
1515915625531810063,122,1,102.95,1,1,3,5
1515915625531814704,123,2,101.2,1,2,3,6
1515915625531817400,123,1,85.11,1,1,2,4
1515915625531820926,123,1,146.32,1,1,3,5
1515915625531821996,107,2,155.46,2,2,3,7
1515915625531822127,123,1,18.41,1,1,1,3
1515915625531822280,123,1,153.83,1,1,3,5
1515915625531827271,123,1,415.54,1,1,4,6
1515915625531828736,123,5,220.65,1,4,3,8
1515915625531828993,123,1,57.63,1,1,2,4
1515915625531829105,118,2,187.3,1,2,3,6
1515915625531829357,123,1,27.14,1,1,1,3
1515915625531832142,123,1,28.41,1,1,1,3
1515915625531836044,123,1,25.08,1,1,1,3
1515915625531839320,123,1,479.51,1,1,4,6
1515915625531848213,13,1,839.75,4,1,4,9
1515915625531852708,123,2,233.66,1,2,3,6
1515915625531853853,123,1,64.48,1,1,2,4
1515915625531854185,123,1,38.1,1,1,2,4
1515915625531854605,119,2,20.06,1,2,1,4
1515915625531856167,123,2,18.7,1,2,1,4
1515915625531858190,123,4,491.44,1,3,4,8
1515915625531862631,123,2,703.34,1,2,4,7
1515915625531869277,123,1,20.95,1,1,1,3
1515915625531870159,113,4,580.22,2,3,4,9
1515915625531878125,123,4,244.64,1,3,3,7
1515915625531879970,123,1,9.35,1,1,1,3
1515915625531882233,123,1,202.95,1,1,3,5
1515915625531885004,87,2,919.04,2,2,4,8
1515915625531893495,123,2,410.98,1,2,4,7
1515915625531896894,123,1,4.14,1,1,1,3
1515915625531897539,68,1,15.4,3,1,1,5
1515915625531898940,95,1,28.14,2,1,1,4
1515915625531900311,111,6,2488.08,2,4,4,10
1515915625531902815,123,1,87.16,1,1,2,4
1515915625531902851,123,1,22.22,1,1,1,3
1515915625531905329,123,1,96.37,1,1,3,5
1515915625531906060,123,2,194.7,1,2,3,6
1515915625531907685,123,1,284.3,1,1,3,5
1515915625531909309,123,1,15.68,1,1,1,3
1515915625531910386,122,3,40.56,1,3,2,6
1515915625531914541,123,1,20.95,1,1,1,3
1515915625531915985,123,1,294.41,1,1,4,6
1515915625531916891,123,8,599.6,1,4,4,9
1515915625531920733,123,1,46.98,1,1,2,4
1515915625531924904,96,1,73.65,2,1,2,5
1515915625531925817,123,1,415.54,1,1,4,6
1515915625531925822,123,2,41.75,1,2,2,5
1515915625531926227,123,1,16.98,1,1,1,3
1515915625531927088,123,1,303.02,1,1,4,6
1515915625531930739,123,2,37.46,1,2,2,5
1515915625531934896,122,4,138.92,1,3,3,7
1515915625531937185,118,2,44.44,1,2,2,5
1515915625531938568,123,1,397.48,1,1,4,6
1515915625531940441,123,1,72.98,1,1,2,4
1515915625531941133,122,1,155.1,1,1,3,5
1515915625531941827,123,1,230.48,1,1,3,5
1515915625531943407,47,1,195.22,3,1,3,7
1515915625531945984,123,2,594.82,1,2,4,7
1515915625531947457,48,1,37.17,3,1,2,6
1515915625531948019,123,1,163.52,1,1,3,5
1515915625531953304,123,3,79.38,1,3,2,6
1515915625531964756,123,1,9.35,1,1,1,3
1515915625531970939,123,1,31.87,1,1,1,3
1515915625531971419,123,1,10.08,1,1,1,3
1515915625531972219,123,2,405.34,1,2,4,7
1515915625531974169,123,1,19.05,1,1,1,3
1515915625531975200,123,1,98.73,1,1,3,5
1515915625531975724,123,1,210.19,1,1,3,5
1515915625531977468,123,1,46.92,1,1,2,4
1515915625531977998,123,1,96.86,1,1,3,5
1515915625531979043,123,1,31.59,1,1,1,3
1515915625531980846,123,1,18.19,1,1,1,3
1515915625531981113,123,1,23.81,1,1,1,3
1515915625531985068,41,2,165.94,3,2,3,8
1515915625531989986,123,2,154.12,1,2,3,6
1515915625531990224,108,5,784.94,2,4,4,10
1515915625531990919,123,1,184.29,1,1,3,5
1515915625531993193,123,2,42.86,1,2,2,5
1515915625531997198,122,1,13.02,1,1,1,3
1515915625532000531,123,1,11.98,1,1,1,3
1515915625532002239,123,1,77.73,1,1,2,4
1515915625532004657,123,1,155.1,1,1,3,5
1515915625532004807,5,2,170.82,4,2,3,9
1515915625532006464,108,2,56.2,2,2,2,6
1515915625532014195,123,1,9.84,1,1,1,3
1515915625532015143,121,5,378.65000000000003,1,4,4,9
1515915625532015597,123,1,26.46,1,1,1,3
1515915625532016529,123,2,46.34,1,2,2,5
1515915625532020686,123,3,144.81,1,3,3,7
1515915625532021713,123,3,24.39,1,3,1,5
1515915625532025497,27,1,10.16,4,1,1,6
1515915625532026064,123,2,39.04,1,2,2,5
1515915625532030659,123,2,23.96,1,2,1,4
1515915625532034232,123,1,119.7,1,1,3,5
1515915625532034872,85,7,157.55,2,4,3,9
1515915625532041614,122,2,24.92,1,2,1,4
1515915625532046268,123,1,10.59,1,1,1,3
1515915625532049828,122,2,85.14,1,2,2,5
1515915625532052010,119,5,745.25,1,4,4,9
1515915625532065009,123,1,36.51,1,1,2,4
1515915625532070456,123,2,52.92,1,2,2,5
1515915625532075496,123,1,12.46,1,1,1,3
1515915625532077180,123,1,18.25,1,1,1,3
1515915625532085906,122,2,307.66,1,2,4,7
1515915625532087318,101,4,426.28,2,3,4,9
1515915625532098883,122,1,104.86,1,1,3,5
1515915625532109995,122,4,665.08,1,3,4,8
1515915625532111016,122,2,34.44,1,2,2,5
1515915625532112294,122,2,76.82,1,2,2,5
1515915625532116892,122,1,51.43,1,1,2,4
1515915625532119098,122,1,17.41,1,1,1,3
1515915625532120679,122,1,79.68,1,1,2,4
1515915625532127944,116,2,42.42,1,2,2,5
1515915625532129435,122,1,23.65,1,1,1,3
1515915625532132006,122,3,57.150000000000006,1,3,2,6
1515915625532132856,122,1,14.86,1,1,1,3
1515915625532134714,122,1,15.87,1,1,1,3
1515915625532136020,122,1,31.59,1,1,1,3
1515915625532139354,122,1,23.33,1,1,1,3
1515915625532140756,122,1,50.6,1,1,2,4
1515915625532141947,122,1,293.49,1,1,4,6
1515915625532142870,122,3,48.480000000000004,1,3,2,6
1515915625532143491,122,1,11.13,1,1,1,3
1515915625532145508,122,1,274.4,1,1,3,5
1515915625532145897,122,1,17.41,1,1,1,3
1515915625532147010,122,1,11.62,1,1,1,3
1515915625532150938,82,2,32.38,2,2,2,6
1515915625532152840,122,1,68.73,1,1,2,4
1515915625532153127,122,1,12.46,1,1,1,3
1515915625532156477,71,8,1230.64,3,4,4,11
1515915625532163015,122,2,46.66,1,2,2,5
1515915625532164637,122,2,246.88,1,2,3,6
1515915625532168832,122,1,87.16,1,1,2,4
1515915625532169369,1,2,846.99,4,2,4,10
1515915625532175674,122,6,103.44,1,4,3,8
1515915625532177344,122,1,254.38,1,1,3,5
1515915625532180790,122,1,133.17,1,1,3,5
1515915625532184618,122,1,230.35,1,1,3,5
1515915625532186874,122,1,679.67,1,1,4,6
1515915625532193007,122,11,653.8399999999999,1,4,4,9
1515915625532194323,122,1,43.17,1,1,2,4
1515915625532197442,122,1,19.92,1,1,1,3
1515915625532197461,122,1,201.43,1,1,3,5
1515915625532197652,118,2,32.38,1,2,2,5
1515915625532198398,110,1,8.03,2,1,1,4
1515915625532198648,122,1,12.59,1,1,1,3
1515915625532199186,122,2,21.68,1,2,1,4
1515915625532199190,122,1,30.83,1,1,1,3
1515915625532209498,63,1,52.9,3,1,2,6
1515915625532210641,122,1,37.62,1,1,2,4
1515915625532217335,122,1,49.52,1,1,2,4
1515915625532219399,122,2,128.96,1,2,3,6
1515915625532221094,95,1,61.17,2,1,2,5
1515915625532221566,122,1,43.11,1,1,2,4
1515915625532225381,122,1,14.08,1,1,1,3
1515915625532227250,104,1,9.87,2,1,1,4
1515915625532236655,122,2,37.78,1,2,2,5
1515915625532239057,112,2,217.18,2,2,3,7
1515915625532239879,122,1,12.98,1,1,1,3
1515915625532240888,122,2,186.86,1,2,3,6
1515915625532242393,122,2,310.2,1,2,4,7
1515915625532248916,122,1,32.19,1,1,1,3
1515915625532251395,25,1,50.63,4,1,2,7
1515915625532257586,122,1,26.46,1,1,1,3
1515915625532262298,122,1,23.81,1,1,1,3
1515915625532264305,122,13,1119.1599999999999,1,4,4,9
1515915625532266069,122,1,192.86,1,1,3,5
1515915625532266123,122,1,9.57,1,1,1,3
1515915625532268408,122,3,687.0,1,3,4,8
1515915625532275687,121,2,20.86,1,2,1,4
1515915625532282974,120,4,88.24,1,3,2,6
1515915625532283625,113,5,258.4,2,4,3,9
1515915625532285463,122,1,9.57,1,1,1,3
1515915625532292322,122,1,502.87,1,1,4,6
1515915625532294427,122,1,17.73,1,1,1,3
1515915625532295777,122,1,111.92,1,1,3,5
1515915625532297636,122,2,32.86,1,2,2,5
1515915625532298840,122,2,27.62,1,2,1,4
1515915625532300068,122,1,63.02,1,1,2,4
1515915625532303130,121,2,161.4,1,2,3,6
1515915625532308217,109,3,52.38,2,3,2,7
1515915625532308993,122,2,50.16,1,2,2,5
1515915625532310577,122,2,28.409999999999997,1,2,1,4
1515915625532311320,122,4,171.92,1,3,3,7
1515915625532315373,100,1,226.84,2,1,3,6
1515915625532316240,122,1,17.44,1,1,1,3
1515915625532327739,110,2,1039.12,2,2,4,8
1515915625532327917,122,1,94.41,1,1,3,5
1515915625532329254,122,7,371.05,1,4,4,9
1515915625532333464,118,2,41.11,1,2,2,5
1515915625532336141,122,1,106.13,1,1,3,5
1515915625532338910,122,1,1.57,1,1,1,3
1515915625532339841,122,2,20.0,1,2,1,4
1515915625532342858,122,1,11.13,1,1,1,3
1515915625532344153,122,3,257.13,1,3,3,7
1515915625532350325,87,1,34.44,2,1,2,5
1515915625532352979,122,1,11.98,1,1,1,3
1515915625532354773,121,2,190.16,1,2,3,6
1515915625532354799,122,1,15.08,1,1,1,3
1515915625532355559,122,1,28.1,1,1,1,3
1515915625532357344,122,1,13.62,1,1,1,3
1515915625532357790,122,1,1.57,1,1,1,3
1515915625532361083,122,1,21.51,1,1,1,3
1515915625532361488,122,1,87.16,1,1,2,4
1515915625532363808,122,1,16.19,1,1,1,3
1515915625532365172,122,3,1838.25,1,3,4,8
1515915625532366067,122,1,8.29,1,1,1,3
1515915625532368267,122,2,84.12,1,2,2,5
1515915625532369532,122,1,25.57,1,1,1,3
1515915625532373046,122,1,26.46,1,1,1,3
1515915625532373229,122,1,9.35,1,1,1,3
1515915625532376600,122,1,32.22,1,1,1,3
1515915625532379158,122,2,52.92,1,2,2,5
1515915625532384046,122,1,99.33,1,1,3,5
1515915625532384126,122,1,11.27,1,1,1,3
1515915625532384781,120,2,307.66,1,2,4,7
1515915625532385720,122,1,128.17,1,1,3,5
1515915625532388474,122,1,55.6,1,1,2,4
1515915625532389962,122,1,21.56,1,1,1,3
1515915625532390191,121,2,39.04,1,2,2,5
1515915625532396536,120,2,403.88,1,2,4,7
1515915625532398003,122,1,9.35,1,1,1,3
1515915625532402535,121,1,249.02,1,1,3,5
1515915625532403543,122,2,3.14,1,2,1,4
1515915625532416174,122,1,23.57,1,1,1,3
1515915625532416717,91,6,74.28,2,4,2,8
1515915625532418249,122,1,192.86,1,1,3,5
1515915625532419121,15,1,15.0,4,1,1,6
1515915625532419774,122,1,701.22,1,1,4,6
1515915625532421416,72,1,41.51,3,1,2,6
1515915625532426718,122,1,40.41,1,1,2,4
1515915625532427017,122,1,701.22,1,1,4,6
1515915625532427026,122,1,1.57,1,1,1,3
1515915625532437170,120,4,1172.02,1,3,4,8
1515915625532443557,102,2,79.36,2,2,2,6
1515915625532445161,122,2,64.44,1,2,2,5
1515915625532447866,118,1,197.46,1,1,3,5
1515915625532448324,122,1,177.59,1,1,3,5
1515915625532458208,122,1,32.22,1,1,1,3
1515915625532460161,122,1,49.21,1,1,2,4
1515915625532462749,37,1,51.33,3,1,2,6
1515915625532466257,121,1,10.43,1,1,1,3
1515915625532485790,121,5,166.85,1,4,3,8
1515915625532493168,121,1,11.7,1,1,1,3
1515915625532494555,121,1,11.27,1,1,1,3
1515915625532495860,121,1,43.11,1,1,2,4
1515915625532498558,121,1,28.89,1,1,1,3
1515915625532505829,121,1,32.22,1,1,1,3
1515915625532517970,121,1,31.27,1,1,1,3
1515915625532518355,121,3,109.47,1,3,3,7
1515915625532519404,121,1,17.33,1,1,1,3
1515915625532522919,121,1,9.35,1,1,1,3
1515915625532523492,121,1,32.38,1,1,2,4
1515915625532529187,121,1,202.67,1,1,3,5
1515915625532530043,121,1,13.33,1,1,1,3
1515915625532531698,121,1,28.3,1,1,1,3
1515915625532534852,121,2,35.46,1,2,2,5
1515915625532535096,121,1,19.3,1,1,1,3
1515915625532536527,121,1,177.59,1,1,3,5
1515915625532540952,121,1,26.46,1,1,1,3
1515915625532541036,121,2,339.74,1,2,4,7
1515915625532543532,121,2,62.7,1,2,2,5
1515915625532549994,121,1,43.11,1,1,2,4
1515915625532550291,121,1,90.62,1,1,2,4
1515915625532550929,121,2,420.38,1,2,4,7
1515915625532553111,121,1,101.67,1,1,3,5
1515915625532556610,10,3,843.6299999999999,4,3,4,11
1515915625532556701,121,1,22.54,1,1,1,3
1515915625532557183,121,1,446.21,1,1,4,6
1515915625532560577,121,1,32.22,1,1,1,3
1515915625532565333,121,1,30.63,1,1,1,3
1515915625532569336,121,2,75.24,1,2,2,5
1515915625532570838,57,2,129.2,3,2,3,8
1515915625532571986,121,1,32.86,1,1,2,4
1515915625532574585,121,1,257.87,1,1,3,5
1515915625532575222,121,6,88.23,1,4,2,7
1515915625532575273,121,7,162.19,1,4,3,8
1515915625532579324,121,1,29.22,1,1,1,3
1515915625532582529,121,1,126.68,1,1,3,5
1515915625532584766,95,2,86.22,2,2,2,6
1515915625532585532,121,1,13.86,1,1,1,3
1515915625532587649,121,2,454.6,1,2,4,7
1515915625532587923,119,1,50.32,1,1,2,4
1515915625532588304,98,1,218.1,2,1,3,6
1515915625532602573,121,1,17.9,1,1,1,3
1515915625532603952,121,1,116.0,1,1,3,5
1515915625532606277,121,1,18.37,1,1,1,3
1515915625532609304,121,1,32.22,1,1,1,3
1515915625532610617,121,1,95.08,1,1,3,5
1515915625532610817,121,2,112.54,1,2,3,6
1515915625532615740,120,5,1021.4499999999999,1,4,4,9
1515915625532618039,18,1,72.98,4,1,2,7
1515915625532620213,120,2,174.32,1,2,3,6
1515915625532623075,121,1,15.08,1,1,1,3
1515915625532624048,121,1,6.68,1,1,1,3
1515915625532626975,121,1,10.43,1,1,1,3
1515915625532627414,121,1,56.27,1,1,2,4
1515915625532629204,121,3,107.60999999999999,1,3,3,7
1515915625532629594,121,1,46.75,1,1,2,4
1515915625532630662,121,1,10.43,1,1,1,3
1515915625532632095,121,1,11.98,1,1,1,3
1515915625532632590,69,1,587.6,3,1,4,8
1515915625532635191,121,3,153.51,1,3,3,7
1515915625532640351,121,2,114.92,1,2,3,6
1515915625532642147,121,1,612.75,1,1,4,6
1515915625532646163,121,1,38.41,1,1,2,4
1515915625532650496,121,1,57.62,1,1,2,4
1515915625532651728,121,1,113.48,1,1,3,5
1515915625532654879,121,5,1392.81,1,4,4,9
1515915625532660264,113,3,663.24,2,3,4,9
1515915625532663133,121,2,434.77,1,2,4,7
1515915625532665758,18,1,13.54,4,1,1,6
1515915625532665867,112,1,255.16,2,1,3,6
1515915625532668571,121,2,258.45,1,2,3,6
1515915625532673490,121,1,29.22,1,1,1,3
1515915625532674607,121,1,23.48,1,1,1,3
1515915625532683209,121,1,63.98,1,1,2,4
1515915625532685325,121,2,26.96,1,2,1,4
1515915625532686262,65,2,207.66,3,2,3,8
1515915625532686920,121,1,32.22,1,1,1,3
1515915625532687551,121,1,12.94,1,1,1,3
1515915625532693016,121,2,52.38,1,2,2,5
1515915625532693198,90,1,32.7,2,1,2,5
1515915625532696903,121,2,665.74,1,2,4,7
1515915625532699608,121,1,103.83,1,1,3,5
1515915625532699853,99,1,26.19,2,1,1,4
1515915625532700690,121,1,16.35,1,1,1,3
1515915625532705818,121,4,89.37,1,3,2,6
1515915625532709423,121,2,88.35,1,2,2,5
1515915625532710623,121,1,50.79,1,1,2,4
1515915625532710866,121,4,173.0,1,3,3,7
1515915625532712074,85,2,47.14,2,2,2,6
1515915625532712388,121,2,52.38,1,2,2,5
1515915625532713767,121,1,10.05,1,1,1,3
1515915625532715912,121,1,149.05,1,1,3,5
1515915625532719624,119,5,46.75,1,4,2,7
1515915625532720665,118,1,87.16,1,1,2,4
1515915625532727657,121,1,98.21,1,1,3,5
1515915625532737428,121,1,106.98,1,1,3,5
1515915625532739318,121,1,13.48,1,1,1,3
1515915625532740939,97,2,402.66,2,2,4,8
1515915625532741658,121,2,67.74,1,2,2,5
1515915625532741858,106,1,10.87,2,1,1,4
1515915625532741943,121,1,38.41,1,1,2,4
1515915625532744861,120,3,493.86,1,3,4,8
1515915625532746660,121,2,44.76,1,2,2,5
1515915625532748256,121,2,177.08,1,2,3,6
1515915625532757018,121,3,253.29999999999998,1,3,3,7
1515915625532761522,49,3,329.52,3,3,4,10
1515915625532764760,121,2,186.86,1,2,3,6
1515915625532767502,121,1,159.68,1,1,3,5
1515915625532776179,29,1,140.86,4,1,3,8
1515915625532777414,121,3,378.81,1,3,4,8
1515915625532777769,121,1,163.52,1,1,3,5
1515915625532782237,121,1,471.52,1,1,4,6
1515915625532790521,120,1,169.67,1,1,3,5
1515915625532828178,120,1,54.02,1,1,2,4
1515915625532828655,112,2,235.56,2,2,3,7
1515915625532828906,59,1,10.16,3,1,1,5
1515915625532835114,120,1,139.52,1,1,3,5
1515915625532838978,120,1,14.95,1,1,1,3
1515915625532864773,120,1,37.3,1,1,2,4
1515915625532876196,111,5,276.75,2,4,3,9
1515915625532890211,120,3,45.24,1,3,2,6
1515915625532895143,120,3,124.77000000000001,1,3,3,7
1515915625532920354,120,1,32.22,1,1,1,3
1515915625532926782,120,1,8.7,1,1,1,3
1515915625532927627,120,1,13.81,1,1,1,3
1515915625532932635,109,2,42.86,2,2,2,6
1515915625532939477,120,2,63.8,1,2,2,5
1515915625532947060,120,1,97.35,1,1,3,5
1515915625532955816,120,3,490.56000000000006,1,3,4,8
1515915625532959915,24,1,45.24,4,1,2,7
1515915625532974480,120,1,9.37,1,1,1,3
1515915625532974746,116,1,43.11,1,1,2,4
1515915625532984190,119,1,304.41,1,1,4,6
1515915625532984514,120,1,34.73,1,1,2,4
1515915625532993619,118,6,119.03999999999999,1,4,3,8
1515915625532998157,120,1,33.29,1,1,2,4
1515915625532999615,120,1,288.89,1,1,4,6
1515915625533002437,105,1,33.81,2,1,2,5
1515915625533004674,120,1,24.6,1,1,1,3
1515915625533013090,120,1,80.06,1,1,2,4
1515915625533013809,120,1,28.21,1,1,1,3
1515915625533016850,120,1,77.73,1,1,2,4
1515915625533021663,120,1,30.48,1,1,1,3
1515915625533021679,120,1,204.29,1,1,3,5
1515915625533032123,119,1,101.9,1,1,3,5
1515915625533032207,120,1,642.62,1,1,4,6
1515915625533040665,117,3,636.13,1,3,4,8
1515915625533044326,120,1,339.51,1,1,4,6
1515915625533045938,120,1,15.08,1,1,1,3
1515915625533046597,120,1,188.06,1,1,3,5
1515915625533057655,120,2,54.64,1,2,2,5
1515915625533057819,120,1,65.08,1,1,2,4
1515915625533067580,120,1,94.41,1,1,3,5
1515915625533076058,113,4,694.01,2,3,4,9
1515915625533078411,120,1,130.0,1,1,3,5
1515915625533080956,117,1,323.43,1,1,4,6
1515915625533090038,10,1,21.81,4,1,1,6
1515915625533091900,120,1,10.48,1,1,1,3
1515915625533096281,120,1,73.81,1,1,2,4
1515915625533097735,120,1,41.27,1,1,2,4
1515915625533102447,120,1,15.08,1,1,1,3
1515915625533106149,120,1,19.22,1,1,1,3
1515915625533106342,120,1,93.43,1,1,3,5
1515915625533128206,120,1,163.52,1,1,3,5
1515915625533129533,120,1,18.08,1,1,1,3
1515915625533135514,120,1,75.29,1,1,2,4
1515915625533136772,120,1,11.62,1,1,1,3
1515915625533145747,120,1,33.33,1,1,2,4
1515915625533146301,120,1,55.16,1,1,2,4
1515915625533151327,120,1,246.02,1,1,3,5
1515915625533155531,120,2,308.64,1,2,4,7
1515915625533157693,119,3,69.51,1,3,2,6
1515915625533164232,120,2,42.92,1,2,2,5
1515915625533175156,120,1,13.86,1,1,1,3
1515915625533175637,120,1,15.08,1,1,1,3
1515915625533176832,52,4,144.56,3,3,3,9
1515915625533181232,120,1,9.81,1,1,1,3
1515915625533197250,120,1,1.57,1,1,1,3
1515915625533198359,117,6,90.6,1,4,2,7
1515915625533199330,119,1,140.11,1,1,3,5
1515915625533202774,120,2,90.48,1,2,2,5
1515915625533205831,120,1,202.67,1,1,3,5
1515915625533208797,97,6,175.32,2,4,3,9
1515915625533211504,120,1,29.22,1,1,1,3
1515915625533218136,120,1,28.89,1,1,1,3
1515915625533220042,120,1,298.32,1,1,4,6
1515915625533221730,115,1,14.19,1,1,1,3
1515915625533224237,120,1,180.73,1,1,3,5
1515915625533230231,120,1,11.9,1,1,1,3
1515915625533231805,120,2,113.97,1,2,3,6
1515915625533242423,120,1,39.75,1,1,2,4
1515915625533245805,120,6,138.96,1,4,3,8
1515915625533251561,120,1,121.4,1,1,3,5
1515915625533252148,119,4,268.4,1,3,3,7
1515915625533259006,120,1,10.68,1,1,1,3
1515915625533262957,120,1,10.68,1,1,1,3
1515915625533268984,120,2,17.4,1,2,1,4
1515915625533270719,120,1,36.59,1,1,2,4
1515915625533271113,120,1,63.35,1,1,2,4
1515915625533287974,120,1,142.38,1,1,3,5
1515915625533288913,116,3,50.94,1,3,2,6
1515915625533291619,120,1,263.52,1,1,3,5
1515915625533293568,105,2,140.32,2,2,3,7
1515915625533294254,120,1,11.11,1,1,1,3
1515915625533294681,120,1,1.57,1,1,1,3
1515915625533299330,120,1,15.08,1,1,1,3
1515915625533301998,120,3,22.799999999999997,1,3,1,5
1515915625533306471,120,1,268.11,1,1,3,5
1515915625533310962,100,1,61.43,2,1,2,5
1515915625533313909,120,1,15.87,1,1,1,3
1515915625533314326,120,1,55.65,1,1,2,4
1515915625533314862,47,1,32.22,3,1,1,5
1515915625533319075,120,1,140.86,1,1,3,5
1515915625533324281,120,1,19.37,1,1,1,3
1515915625533325928,120,2,82.86,1,2,2,5
1515915625533328441,120,1,229.38,1,1,3,5
1515915625533329384,120,2,172.96,1,2,3,6
1515915625533335454,110,8,1638.32,2,4,4,10
1515915625533336721,120,4,84.94,1,3,2,6
1515915625533337383,120,3,539.8499999999999,1,3,4,8
1515915625533337459,119,2,587.24,1,2,4,7
1515915625533338955,118,2,64.44,1,2,2,5
1515915625533339261,120,6,630.84,1,4,4,9
1515915625533339635,120,5,1464.1499999999999,1,4,4,9
1515915625533345520,120,2,33.34,1,2,2,5
1515915625533345635,120,1,10.43,1,1,1,3
1515915625533353755,120,1,10.71,1,1,1,3
1515915625533355660,120,1,32.56,1,1,2,4
1515915625533358213,120,1,36.51,1,1,2,4
1515915625533358333,120,1,100.75,1,1,3,5
1515915625533361712,120,1,126.27,1,1,3,5
1515915625533364189,120,2,37.14,1,2,2,5
1515915625533368707,120,2,458.0,1,2,4,7
1515915625533371256,120,2,84.8,1,2,2,5
1515915625533372557,120,1,20.95,1,1,1,3
1515915625533374369,114,2,143.5,1,2,3,6
1515915625533377324,120,2,32.589999999999996,1,2,2,5
1515915625533384405,83,2,137.14,2,2,3,7
1515915625533385039,120,4,77.72,1,3,2,6
1515915625533385201,120,2,350.1,1,2,4,7
1515915625533386648,120,1,29.84,1,1,1,3
1515915625533388154,120,2,32.1,1,2,1,4
1515915625533388796,119,1,71.02,1,1,2,4
1515915625533389628,120,1,15.08,1,1,1,3
1515915625533389675,120,2,246.04,1,2,3,6
1515915625533392001,119,3,599.0999999999999,1,3,4,8
1515915625533401499,120,1,24.29,1,1,1,3
1515915625533402612,120,5,639.7,1,4,4,9
1515915625533403778,120,1,32.76,1,1,2,4
1515915625533404372,120,1,11.06,1,1,1,3
1515915625533404987,96,5,1021.4499999999999,2,4,4,10
1515915625533417658,120,1,17.3,1,1,1,3
1515915625533435126,77,1,155.1,2,1,3,6
1515915625533437323,119,1,32.54,1,1,2,4
1515915625533443672,119,1,47.14,1,1,2,4
1515915625533444500,119,1,65.32,1,1,2,4
1515915625533445284,119,6,58.980000000000004,1,4,2,7
1515915625533450597,119,1,33.54,1,1,2,4
1515915625533451593,119,1,35.87,1,1,2,4
1515915625533452243,119,1,11.43,1,1,1,3
1515915625533458767,119,1,14.6,1,1,1,3
1515915625533459854,119,1,27.62,1,1,1,3
1515915625533459994,119,1,42.0,1,1,2,4
1515915625533463449,119,1,26.19,1,1,1,3
1515915625533466257,119,1,33.65,1,1,2,4
1515915625533469055,119,1,33.17,1,1,2,4
1515915625533470634,119,2,752.22,1,2,4,7
1515915625533471604,119,1,5.14,1,1,1,3
1515915625533473814,118,2,137.12,1,2,3,6
1515915625533474034,119,1,223.33,1,1,3,5
1515915625533477292,119,2,103.5,1,2,3,6
1515915625533477585,119,1,24.13,1,1,1,3
1515915625533478974,119,1,13.86,1,1,1,3
1515915625533479116,119,1,15.16,1,1,1,3
1515915625533480608,119,1,16.98,1,1,1,3
1515915625533484271,119,1,11.62,1,1,1,3
1515915625533484763,119,2,108.58,1,2,3,6
1515915625533485800,119,1,123.03,1,1,3,5
1515915625533497245,115,1,45.24,1,1,2,4
1515915625533503355,119,2,567.23,1,2,4,7
1515915625533503762,119,1,192.86,1,1,3,5
1515915625533510668,119,1,29.68,1,1,1,3
1515915625533513688,119,1,20.56,1,1,1,3
1515915625533515131,119,1,34.44,1,1,2,4
1515915625533519832,119,1,22.38,1,1,1,3
1515915625533520047,119,3,188.78000000000003,1,3,3,7
1515915625533520331,119,1,22.54,1,1,1,3
1515915625533528961,112,3,58.56,2,3,2,7
1515915625533531114,118,3,613.17,1,3,4,8
1515915625533531866,103,1,47.78,2,1,2,5
1515915625533537426,73,4,429.2,2,3,4,9
1515915625533537874,119,3,237.73,1,3,3,7
1515915625533556245,119,2,86.22,1,2,2,5
1515915625533582872,119,1,73.81,1,1,2,4
1515915625533583013,82,3,56.099999999999994,2,3,2,7
1515915625533583045,118,1,33.19,1,1,2,4
1515915625533583136,99,2,37.4,2,2,2,6
1515915625533583923,119,9,1530.63,1,4,4,9
1515915625533584154,119,1,28.73,1,1,1,3
1515915625533584561,119,1,23.81,1,1,1,3
1515915625533588620,76,2,52.38,2,2,2,6
1515915625533589575,118,2,831.08,1,2,4,7
1515915625533590093,119,1,23.22,1,1,1,3
1515915625533590757,119,1,12.94,1,1,1,3
1515915625533590838,119,3,283.23,1,3,3,7
1515915625533591024,119,1,43.79,1,1,2,4
1515915625533592718,119,4,560.44,1,3,4,8
1515915625533593140,119,2,103.5,1,2,3,6
1515915625533595599,116,2,577.78,1,2,4,7
1515915625533596889,112,6,431.67999999999995,2,4,4,10
1515915625533606060,119,1,191.52,1,1,3,5
1515915625533634201,119,1,16.67,1,1,1,3
1515915625533670973,119,4,147.16,1,3,3,7
1515915625533675640,119,1,415.54,1,1,4,6
1515915625533705423,119,2,56.9,1,2,2,5
1515915625533719385,119,4,21.84,1,3,1,5
1515915625533720801,119,1,135.87,1,1,3,5
1515915625533723842,119,6,646.74,1,4,4,9
1515915625533725527,119,2,98.42,1,2,3,6
1515915625533725961,119,1,53.33,1,1,2,4
1515915625533726137,119,1,10.05,1,1,1,3
1515915625533727460,109,1,84.89,2,1,2,5
1515915625533728740,119,1,59.11,1,1,2,4
1515915625533729024,119,1,36.67,1,1,2,4
1515915625533731442,116,1,31.29,1,1,1,3
1515915625533736830,119,2,41.04,1,2,2,5
1515915625533737377,112,2,57.46,2,2,2,6
1515915625533737419,119,3,43.8,1,3,2,6
1515915625533737955,119,1,10.24,1,1,1,3
1515915625533737980,115,2,36.82,1,2,2,5
1515915625533738085,119,1,0.37,1,1,1,3
1515915625533738694,119,1,1.57,1,1,1,3
1515915625533749370,109,8,289.52,2,4,4,10
1515915625533750876,118,2,730.1400000000001,1,2,4,7
1515915625533753448,68,3,553.53,3,3,4,10
1515915625533754121,4,1,82.38,4,1,2,7
1515915625533766314,119,2,49.05,1,2,2,5
1515915625533768090,119,1,21.21,1,1,1,3
1515915625533773359,119,2,29.9,1,2,1,4
1515915625533774439,118,2,81.34,1,2,2,5
1515915625533774974,111,1,40.67,2,1,2,5
1515915625533778480,56,1,24.76,3,1,1,5
1515915625533783256,119,6,385.95,1,4,4,9
1515915625533783606,119,1,50.11,1,1,2,4
1515915625533784969,119,1,126.68,1,1,3,5
1515915625533785439,111,1,7.0,2,1,1,4
1515915625533792857,85,2,3600.7,2,2,4,8
1515915625533802187,117,1,204.29,1,1,3,5
1515915625533805098,119,2,165.94,1,2,3,6
1515915625533808310,73,5,3299.2,2,4,4,10
1515915625533808445,114,1,164.33,1,1,3,5
1515915625533810651,119,1,82.97,1,1,2,4
1515915625533815723,106,1,113.38,2,1,3,6
1515915625533817210,119,1,204.29,1,1,3,5
1515915625533819063,119,1,479.51,1,1,4,6
1515915625533819803,119,1,82.97,1,1,2,4
1515915625533823030,119,1,345.44,1,1,4,6
1515915625533824436,119,2,215.58,1,2,3,6
1515915625533827090,119,1,183.67,1,1,3,5
1515915625533831107,119,1,19.98,1,1,1,3
1515915625533832322,119,1,183.67,1,1,3,5
1515915625533834624,118,2,64.44,1,2,2,5
1515915625533835419,117,2,301.58,1,2,4,7
1515915625533836237,119,3,60.42,1,3,2,6
1515915625533836608,111,4,914.28,2,3,4,9
1515915625533839119,119,1,16.98,1,1,1,3
1515915625533841496,119,1,56.21,1,1,2,4
1515915625533843332,119,1,58.54,1,1,2,4
1515915625533843365,119,2,167.94,1,2,3,6
1515915625533845015,119,3,96.66,1,3,3,7
1515915625533845025,119,4,160.0,1,3,3,7
1515915625533846464,76,2,204.2,2,2,3,7
1515915625533847895,49,1,65.94,3,1,2,6
1515915625533849834,113,1,35.1,2,1,2,5
1515915625533852939,119,3,390.0,1,3,4,8
1515915625533856670,119,1,198.62,1,1,3,5
1515915625533860053,119,1,240.11,1,1,3,5
1515915625533862503,119,2,7.96,1,2,1,4
1515915625533866856,88,2,147.62,2,2,3,7
1515915625533867529,118,2,142.97,1,2,3,6
1515915625533872629,118,1,183.67,1,1,3,5
1515915625533873694,119,1,397.48,1,1,4,6
1515915625533875458,119,1,14.1,1,1,1,3
1515915625533883190,116,2,408.58,1,2,4,7
1515915625533883757,119,1,202.95,1,1,3,5
1515915625533886161,118,1,118.57,1,1,3,5
1515915625533888584,119,4,60.2,1,3,2,6
1515915625533891416,118,3,209.61,1,3,3,7
1515915625533892147,119,2,40.64,1,2,2,5
1515915625533892904,119,1,26.57,1,1,1,3
1515915625533895702,103,1,149.05,2,1,3,6
1515915625533896361,119,3,90.48,1,3,2,6
1515915625533899544,119,5,38.55,1,4,2,7
1515915625533904623,119,2,27.94,1,2,1,4
1515915625533909931,119,3,215.25,1,3,3,7
1515915625533913211,118,3,442.14,1,3,4,8
1515915625533919180,108,2,181.26,2,2,3,7
1515915625533922399,119,1,471.52,1,1,4,6
1515915625533924416,102,1,86.48,2,1,2,5
1515915625533927067,119,1,103.29,1,1,3,5
1515915625533929236,119,2,347.34,1,2,4,7
1515915625533933338,119,1,5.16,1,1,1,3
1515915625533935310,119,1,11.37,1,1,1,3
1515915625533959995,75,4,821.96,2,3,4,9
1515915625533967133,118,2,568.6,1,2,4,7
1515915625533967644,118,1,17.62,1,1,1,3
1515915625533969730,118,1,11.11,1,1,1,3
1515915625533974053,118,1,3717.65,1,1,4,6
1515915625533974285,118,2,3.14,1,2,1,4
1515915625533975031,118,1,96.37,1,1,3,5
1515915625533975908,72,2,64.44,3,2,2,7
1515915625533975978,118,1,29.68,1,1,1,3
1515915625533978887,118,1,28.41,1,1,1,3
1515915625533981657,118,3,353.25,1,3,4,8
1515915625533983575,118,1,53.32,1,1,2,4
1515915625533986507,101,2,3.14,2,2,1,5
1515915625533988901,118,2,22.86,1,2,1,4
1515915625533991848,118,1,31.0,1,1,1,3
1515915625533992130,118,1,35.08,1,1,2,4
1515915625533996520,109,2,22.96,2,2,1,5
1515915625533996759,118,1,300.49,1,1,4,6
1515915625534000100,118,4,620.4,1,3,4,8
1515915625534001289,118,1,127.08,1,1,3,5
1515915625534001652,118,1,185.6,1,1,3,5
1515915625534002935,65,2,1461.12,3,2,4,9
1515915625534010319,116,1,28.1,1,1,1,3
1515915625534010592,103,4,106.07000000000001,2,3,3,8
1515915625534014621,118,1,98.41,1,1,3,5
1515915625534018315,118,1,17.4,1,1,1,3
1515915625534020302,118,1,53.32,1,1,2,4
1515915625534022194,118,1,315.22,1,1,4,6
1515915625534024853,118,1,26.46,1,1,1,3
1515915625534027906,118,3,213.81,1,3,3,7
1515915625534032517,118,1,10.32,1,1,1,3
1515915625534033116,116,5,633.4000000000001,1,4,4,9
1515915625534034890,118,1,163.52,1,1,3,5
1515915625534043554,118,1,47.14,1,1,2,4
1515915625534045777,118,2,207.43,1,2,3,6
1515915625534050179,118,1,210.9,1,1,3,5
1515915625534051749,118,1,144.51,1,1,3,5
1515915625534055477,118,1,172.38,1,1,3,5
1515915625534057405,118,1,357.35,1,1,4,6
1515915625534058599,117,2,86.34,1,2,2,5
1515915625534059124,118,1,42.21,1,1,2,4
1515915625534060041,112,3,31.29,2,3,1,6
1515915625534061714,118,1,192.86,1,1,3,5
1515915625534063665,118,3,88.56,1,3,2,6
1515915625534066086,82,4,443.8,2,3,4,9
1515915625534067485,118,1,10.13,1,1,1,3
1515915625534068383,91,1,126.68,2,1,3,6
1515915625534078648,118,1,292.83,1,1,4,6
1515915625534082718,118,2,16.44,1,2,1,4
1515915625534082919,72,1,110.83,3,1,3,7
1515915625534084353,118,1,3.14,1,1,1,3
1515915625534086791,118,1,100.75,1,1,3,5
1515915625534108282,118,1,16.92,1,1,1,3
1515915625534114932,37,1,57.27,3,1,2,6
1515915625534115311,118,3,311.49,1,3,4,8
1515915625534115703,108,1,266.75,2,1,3,6
1515915625534118115,118,2,406.04,1,2,4,7
1515915625534121843,111,1,87.16,2,1,2,5
1515915625534122298,118,2,385.72,1,2,4,7
1515915625534124380,118,1,39.4,1,1,2,4
1515915625534127265,118,3,215.25,1,3,3,7
1515915625534129125,118,1,163.52,1,1,3,5
1515915625534131457,116,1,77.78,1,1,2,4
1515915625534138210,118,3,1246.6200000000001,1,3,4,8
1515915625534138343,118,2,66.34,1,2,2,5
1515915625534143343,111,15,1118.97,2,4,4,10
1515915625534145198,116,1,60.54,1,1,2,4
1515915625534146309,118,2,26.08,1,2,1,4
1515915625534150285,118,1,115.71,1,1,3,5
1515915625534151558,118,1,92.05,1,1,3,5
1515915625534152098,118,1,26.46,1,1,1,3
1515915625534152247,109,1,155.1,2,1,3,6
1515915625534153782,118,1,75.67,1,1,2,4
1515915625534154622,118,2,215.58,1,2,3,6
1515915625534156949,110,1,56.27,2,1,2,5
1515915625534157625,118,1,1.57,1,1,1,3
1515915625534158178,118,6,1321.8000000000002,1,4,4,9
1515915625534165247,118,1,751.62,1,1,4,6
1515915625534168706,118,3,462.54999999999995,1,3,4,8
1515915625534171402,116,3,140.76,1,3,3,7
1515915625534172462,118,1,33.65,1,1,2,4
1515915625534173220,118,1,82.86,1,1,2,4
1515915625534173962,118,2,20.32,1,2,1,4
1515915625534183243,118,1,87.16,1,1,2,4
1515915625534184616,118,1,414.25,1,1,4,6
1515915625534184643,118,1,569.59,1,1,4,6
1515915625534185786,113,2,431.14,2,2,4,8
1515915625534187468,118,2,194.7,1,2,3,6
1515915625534188632,118,1,398.7,1,1,4,6
1515915625534188995,113,3,233.19,2,3,3,8
1515915625534190073,118,1,144.51,1,1,3,5
1515915625534194625,118,4,50.24,1,3,2,6
1515915625534197164,118,3,386.18999999999994,1,3,4,8
1515915625534199788,104,4,129.68,2,3,3,8
1515915625534201096,118,1,214.1,1,1,3,5
1515915625534203158,117,3,78.57000000000001,1,3,2,6
1515915625534203223,118,1,52.83,1,1,2,4
1515915625534203355,118,1,50.03,1,1,2,4
1515915625534204522,118,2,44.64,1,2,2,5
1515915625534205653,118,1,50.03,1,1,2,4
1515915625534206950,118,1,63.02,1,1,2,4
1515915625534213072,118,1,30.41,1,1,1,3
1515915625534214756,118,1,32.22,1,1,1,3
1515915625534215905,118,1,77.73,1,1,2,4
1515915625534216924,60,5,1289.35,3,4,4,11
1515915625534219090,118,2,211.74,1,2,3,6
1515915625534221252,118,1,16.19,1,1,1,3
1515915625534223104,110,1,204.29,2,1,3,6
1515915625534223394,118,2,43.5,1,2,2,5
1515915625534226525,118,1,26.19,1,1,1,3
1515915625534236468,118,1,163.52,1,1,3,5
1515915625534236735,117,6,311.88,1,4,4,9
1515915625534245821,118,1,10.0,1,1,1,3
1515915625534246787,108,2,207.66,2,2,3,7
1515915625534247052,118,1,19.68,1,1,1,3
1515915625534248525,116,1,45.35,1,1,2,4
1515915625534252067,24,2,167.24,4,2,3,9
1515915625534252809,118,1,192.86,1,1,3,5
1515915625534253849,118,1,127.3,1,1,3,5
1515915625534257142,118,1,70.75,1,1,2,4
1515915625534257389,116,2,24.98,1,2,1,4
1515915625534257553,118,1,31.11,1,1,1,3
1515915625534259022,118,1,32.22,1,1,1,3
1515915625534267755,118,1,26.46,1,1,1,3
1515915625534272529,118,1,18.57,1,1,1,3
1515915625534274130,117,1,601.27,1,1,4,6
1515915625534280496,118,1,16.6,1,1,1,3
1515915625534287746,117,9,556.71,1,4,4,9
1515915625534288430,118,1,257.87,1,1,3,5
1515915625534289251,118,1,43.17,1,1,2,4
1515915625534289336,117,1,29.68,1,1,1,3
1515915625534290363,118,1,24.76,1,1,1,3
1515915625534294262,118,1,16.98,1,1,1,3
1515915625534295249,118,1,32.22,1,1,1,3
1515915625534297924,118,1,11.9,1,1,1,3
1515915625534299060,118,1,1.57,1,1,1,3
1515915625534300264,109,1,78.46,2,1,2,5
1515915625534300592,118,1,96.19,1,1,3,5
1515915625534304645,118,1,32.22,1,1,1,3
1515915625534305095,91,1,15.71,2,1,1,4
1515915625534306133,118,1,19.52,1,1,1,3
1515915625534311466,118,1,32.22,1,1,1,3
1515915625534318792,118,8,1207.71,1,4,4,9
1515915625534324969,118,2,307.66,1,2,4,7
1515915625534326045,117,2,36.82,1,2,2,5
1515915625534328310,118,3,59.519999999999996,1,3,2,6
1515915625534331379,118,1,20.76,1,1,1,3
1515915625534342295,117,1,51.33,1,1,2,4
1515915625534343887,116,2,75.55,1,2,2,5
1515915625534352006,117,1,110.63,1,1,3,5
1515915625534354319,117,1,48.41,1,1,2,4
1515915625534374756,117,1,751.62,1,1,4,6
1515915625534378004,117,3,125.69999999999999,1,3,3,7
1515915625534389289,117,1,82.86,1,1,2,4
1515915625534392404,117,1,32.22,1,1,1,3
1515915625534397905,117,2,94.28,1,2,3,6
1515915625534402070,117,1,14.37,1,1,1,3
1515915625534402134,29,1,40.24,4,1,2,7
1515915625534407998,117,2,56.82,1,2,2,5
1515915625534416143,117,2,435.14,1,2,4,7
1515915625534424629,117,1,118.57,1,1,3,5
1515915625534425252,108,1,415.54,2,1,4,7
1515915625534427972,117,1,81.9,1,1,2,4
1515915625534428705,117,1,259.38,1,1,3,5
1515915625534436786,114,1,50.57,1,1,2,4
1515915625534443190,117,1,29.81,1,1,1,3
1515915625534450352,117,1,32.7,1,1,2,4
1515915625534452228,117,1,404.49,1,1,4,6
1515915625534456818,117,2,54.64,1,2,2,5
1515915625534461911,117,1,112.16,1,1,3,5
1515915625534462700,117,1,9.83,1,1,1,3
1515915625534465597,106,1,230.35,2,1,3,6
1515915625534466607,113,7,589.4699999999999,2,4,4,10
1515915625534470226,80,1,33.08,2,1,2,5
1515915625534492749,117,1,30.83,1,1,1,3
1515915625534495736,117,1,19.84,1,1,1,3
1515915625534511094,83,2,58.44,2,2,2,6
1515915625534514763,117,3,878.49,1,3,4,8
1515915625534515711,117,1,32.22,1,1,1,3
1515915625534522194,117,2,75.24,1,2,2,5
1515915625534523012,92,1,50.9,2,1,2,5
1515915625534525828,94,3,1104.43,2,3,4,9
1515915625534525911,117,1,20.16,1,1,1,3
1515915625534532966,117,1,349.46,1,1,4,6
1515915625534533262,117,1,43.11,1,1,2,4
1515915625534539560,117,1,167.62,1,1,3,5
1515915625534545154,117,2,108.57,1,2,3,6
1515915625534548605,117,1,66.21,1,1,2,4
1515915625534549826,72,5,276.75,3,4,3,10
1515915625534550697,77,3,4.71,2,3,1,6
1515915625534555304,117,4,1154.26,1,3,4,8
1515915625534560787,117,1,21.59,1,1,1,3
1515915625534571724,117,2,20.48,1,2,1,4
1515915625534572892,117,2,65.42,1,2,2,5
1515915625534579608,117,1,12.22,1,1,1,3
1515915625534583088,117,1,199.7,1,1,3,5
1515915625534585132,117,1,24.44,1,1,1,3
1515915625534585741,117,2,33.34,1,2,2,5
1515915625534586413,116,4,46.48,1,3,2,6
1515915625534593015,117,1,292.83,1,1,4,6
1515915625534599507,117,1,292.83,1,1,4,6
1515915625534603002,43,1,126.68,3,1,3,7
1515915625534608606,97,2,136.1,2,2,3,7
1515915625534608869,107,2,408.58,2,2,4,8
1515915625534610237,22,1,397.48,4,1,4,9
1515915625534610827,117,2,45.74,1,2,2,5
1515915625534613338,117,1,314.68,1,1,4,6
1515915625534614002,117,1,23.17,1,1,1,3
1515915625534622180,117,1,113.75,1,1,3,5
1515915625534627338,19,2,443.88,4,2,4,10
1515915625534627558,117,3,180.18,1,3,3,7
1515915625534628434,117,1,35.87,1,1,2,4
1515915625534630724,117,1,399.48,1,1,4,6
1515915625534632136,15,1,97.35,4,1,3,8
1515915625534636429,73,2,34.96,2,2,2,6
1515915625534643908,117,2,29.650000000000002,1,2,1,4
1515915625534645254,117,1,30.54,1,1,1,3
1515915625534645785,117,1,68.06,1,1,2,4
1515915625534646426,117,3,988.29,1,3,4,8
1515915625534647578,80,1,43.81,2,1,2,5
1515915625534647670,117,1,1.57,1,1,1,3
1515915625534648667,117,2,200.64,1,2,3,6
1515915625534650223,116,8,174.92000000000002,1,4,3,8
1515915625534656343,117,1,42.06,1,1,2,4
1515915625534656432,117,1,1.57,1,1,1,3
1515915625534663755,117,1,86.48,1,1,2,4
1515915625534670072,117,2,121.66,1,2,3,6
1515915625534672863,117,1,218.98,1,1,3,5
1515915625534686048,117,2,22.86,1,2,1,4
1515915625534686582,117,1,457.51,1,1,4,6
1515915625534688640,117,1,15.08,1,1,1,3
1515915625534689624,113,1,57.62,2,1,2,5
1515915625534689995,7,1,67.62,4,1,2,7
1515915625534691848,117,1,370.46,1,1,4,6
1515915625534692175,117,1,16.67,1,1,1,3
1515915625534692372,77,1,151.32,2,1,3,6
1515915625534701197,117,1,569.59,1,1,4,6
1515915625534701724,110,3,248.91,2,3,3,8
1515915625534703058,117,1,27.62,1,1,1,3
1515915625534716988,117,1,12.27,1,1,1,3
1515915625534723877,117,1,12.51,1,1,1,3
1515915625534725309,117,1,23.81,1,1,1,3
1515915625534730688,117,1,205.25,1,1,3,5
1515915625534735220,117,2,49.2,1,2,2,5
1515915625534736129,117,1,15.08,1,1,1,3
1515915625534738655,117,1,36.51,1,1,2,4
1515915625534748472,115,3,225.87,1,3,3,7
1515915625534748928,117,1,64.48,1,1,2,4
1515915625534751723,117,1,59.95,1,1,2,4
1515915625534756584,100,5,215.55,2,4,3,9
1515915625534756661,117,1,63.35,1,1,2,4
1515915625534761903,117,1,10.21,1,1,1,3
1515915625534763083,117,1,155.1,1,1,3,5
1515915625534763630,117,2,137.14,1,2,3,6
1515915625534766458,116,1,205.25,1,1,3,5
1515915625534769646,116,2,59.4,1,2,2,5
1515915625534770272,101,1,342.13,2,1,4,7
1515915625534771549,116,4,709.2,1,3,4,8
1515915625534776626,113,1,15.87,2,1,1,4
1515915625534776957,117,3,1428.6000000000001,1,3,4,8
1515915625534777090,117,1,415.54,1,1,4,6
1515915625534780106,117,1,130.0,1,1,3,5
1515915625534781652,117,2,3.14,1,2,1,4
1515915625534790129,114,2,458.76,1,2,4,7
1515915625534791058,117,1,29.22,1,1,1,3
1515915625534794372,116,1,229.38,1,1,3,5
1515915625534794900,117,2,70.38,1,2,2,5
1515915625534799301,117,2,112.6,1,2,3,6
1515915625534806691,117,1,13.03,1,1,1,3
1515915625534808445,117,1,18.98,1,1,1,3
1515915625534810494,117,1,34.29,1,1,2,4
1515915625534811772,115,1,236.67,1,1,3,5
1515915625534814154,117,1,25.08,1,1,1,3
1515915625534814366,100,2,139.4,2,2,3,7
1515915625534817648,117,1,51.43,1,1,2,4
1515915625534825699,106,1,11.59,2,1,1,4
1515915625534825805,117,1,199.37,1,1,3,5
1515915625534840728,99,2,356.44,2,2,4,8
1515915625534850099,116,1,58.21,1,1,2,4
1515915625534855852,107,2,463.81,2,2,4,8
1515915625534856197,116,3,68.37,1,3,2,6
1515915625534864038,116,1,61.27,1,1,2,4
1515915625534868143,116,1,28.08,1,1,1,3
1515915625534869046,116,1,9.35,1,1,1,3
1515915625534870698,116,1,45.24,1,1,2,4
1515915625534871173,116,1,28.25,1,1,1,3
1515915625534876463,116,2,30.16,1,2,1,4
1515915625534877704,116,1,23.57,1,1,1,3
1515915625534880102,116,9,262.98,1,4,3,8
1515915625534880324,105,1,61.43,2,1,2,5
1515915625534880661,116,3,62.19,1,3,2,6
1515915625534880879,116,1,16.83,1,1,1,3
1515915625534881895,116,1,172.87,1,1,3,5
1515915625534886044,116,1,35.71,1,1,2,4
1515915625534886056,116,1,16.19,1,1,1,3
1515915625534889264,116,2,831.08,1,2,4,7
1515915625534890108,116,1,349.46,1,1,4,6
1515915625534893939,116,4,172.68,1,3,3,7
1515915625534894810,116,1,53.17,1,1,2,4
1515915625534900729,116,1,322.57,1,1,4,6
1515915625534910409,116,1,58.21,1,1,2,4
1515915625534915960,116,2,102.85,1,2,3,6
1515915625534920953,116,4,3559.92,1,3,4,8
1515915625534921966,116,1,14.08,1,1,1,3
1515915625534922605,116,3,221.43,1,3,3,7
1515915625534925319,116,1,38.1,1,1,2,4
1515915625534942772,116,2,127.96,1,2,3,6
1515915625534991572,116,8,1199.27,1,4,4,9
1515915625535006233,116,1,17.46,1,1,1,3
1515915625535021898,116,1,126.68,1,1,3,5
1515915625535057677,116,1,108.65,1,1,3,5
1515915625535103973,116,1,15.08,1,1,1,3
1515915625535139247,116,1,20.32,1,1,1,3
1515915625535178217,116,1,302.59,1,1,4,6
1515915625535187995,116,1,75.67,1,1,2,4
1515915625535210557,112,1,39.21,2,1,2,5
1515915625535227096,116,1,129.6,1,1,3,5
1515915625535230170,116,1,30.48,1,1,1,3
1515915625535248359,116,1,302.59,1,1,4,6
1515915625535251291,116,1,27.46,1,1,1,3
1515915625535361524,116,1,90.63,1,1,2,4
1515915625535382348,116,4,315.56,1,3,4,8
1515915625535428924,116,1,64.48,1,1,2,4
1515915625535435335,112,3,408.15000000000003,2,3,4,9
1515915625535467749,116,1,3.14,1,1,1,3
1515915625535473496,116,1,71.79,1,1,2,4
1515915625535478178,116,1,17.78,1,1,1,3
1515915625535486742,116,1,29.48,1,1,1,3
1515915625535489400,116,1,172.38,1,1,3,5
1515915625535490888,108,2,57.14,2,2,2,6
1515915625535495185,116,1,61.13,1,1,2,4
1515915625535503986,116,1,23.81,1,1,1,3
1515915625535505317,116,1,15.92,1,1,1,3
1515915625535511904,116,1,51.33,1,1,2,4
1515915625535562493,116,1,192.86,1,1,3,5
1515915625535564278,116,1,29.57,1,1,1,3
1515915625535566286,116,1,11.27,1,1,1,3
1515915625535586638,93,1,17.24,2,1,1,4
1515915625535587316,116,1,32.22,1,1,1,3
1515915625535615058,107,1,14.92,2,1,1,4
1515915625535660608,116,1,13.22,1,1,1,3
1515915625535668877,116,5,130.95000000000002,1,4,3,8
1515915625535686680,116,1,27.62,1,1,1,3
1515915625535689206,116,1,297.35,1,1,4,6
1515915625535744959,66,4,50.28,3,3,2,8
1515915625535746276,116,1,42.98,1,1,2,4
1515915625535753901,112,1,68.05,2,1,2,5
1515915625535761056,116,2,62.42,1,2,2,5
1515915625535765987,115,1,15.87,1,1,1,3
1515915625535794233,116,1,87.46,1,1,2,4
1515915625535794484,116,1,1.57,1,1,1,3
1515915625535794814,116,2,44.52,1,2,2,5
1515915625535794820,114,2,310.22,1,2,4,7
1515915625535797328,72,2,458.76,3,2,4,9
1515915625535798377,116,3,30.150000000000002,1,3,1,5
1515915625535803339,112,6,622.98,2,4,4,10
1515915625535804330,110,1,18.02,2,1,1,4
1515915625535807352,116,2,111.74,1,2,3,6
1515915625535808010,116,4,131.24,1,3,3,7
1515915625535808944,46,2,105.8,3,2,3,8
1515915625535809995,116,3,92.42999999999999,1,3,3,7
1515915625535810825,116,1,8.59,1,1,1,3
1515915625535814544,116,1,10.84,1,1,1,3
1515915625535815347,112,1,37.0,2,1,2,5
1515915625535821298,116,1,35.87,1,1,2,4
1515915625535821425,115,18,357.1,1,4,4,9
1515915625535822661,116,2,27.72,1,2,1,4
1515915625535830986,116,1,126.68,1,1,3,5
1515915625535918124,116,2,124.34,1,2,3,6
1515915625535932449,115,3,2248.56,1,3,4,8
1515915625535932688,116,1,43.17,1,1,2,4
1515915625535932699,116,1,9.35,1,1,1,3
1515915625535933677,116,1,43.17,1,1,2,4
1515915625535933870,116,1,15.92,1,1,1,3
1515915625535934888,109,1,35.1,2,1,2,5
1515915625535935952,114,1,29.68,1,1,1,3
1515915625535935993,116,1,624.46,1,1,4,6
1515915625535939606,116,1,453.98,1,1,4,6
1515915625535939623,116,1,157.14,1,1,3,5
1515915625535941344,116,1,399.48,1,1,4,6
1515915625535944578,116,1,58.1,1,1,2,4
1515915625535948896,116,1,155.1,1,1,3,5
1515915625535952427,116,1,438.11,1,1,4,6
1515915625535955310,111,4,128.88,2,3,3,8
1515915625535959009,96,5,52.15,2,4,2,8
1515915625535962099,116,1,16.98,1,1,1,3
1515915625535966450,20,2,380.06,4,2,4,10
1515915625535977768,12,3,680.0999999999999,4,3,4,11
1515915625535982227,116,1,403.46,1,1,4,6
1515915625535993243,116,1,75.76,1,1,2,4
1515915625535997848,116,1,126.68,1,1,3,5
1515915625536001145,116,4,491.88,1,3,4,8
1515915625536001872,112,3,41.58,2,3,2,7
1515915625536004806,116,1,214.1,1,1,3,5
1515915625536006050,116,1,1.57,1,1,1,3
1515915625536006804,115,1,128.79,1,1,3,5
1515915625536007007,116,1,50.79,1,1,2,4
1515915625536009287,116,2,52.38,1,2,2,5
1515915625536012570,116,2,26.04,1,2,1,4
1515915625536016991,112,1,259.94,2,1,3,6
1515915625536017936,116,2,29.52,1,2,1,4
1515915625536019999,116,1,126.68,1,1,3,5
1515915625536021138,116,1,23.17,1,1,1,3
1515915625536029348,116,1,71.29,1,1,2,4
1515915625536047299,116,6,1031.24,1,4,4,9
1515915625536049028,116,4,105.84,1,3,3,7
1515915625536070099,107,1,17.6,2,1,1,4
1515915625536077819,115,3,25.29,1,3,1,5
1515915625536080512,116,1,224.76,1,1,3,5
1515915625536081687,116,1,14.6,1,1,1,3
1515915625536082503,116,1,84.89,1,1,2,4
1515915625536084190,116,1,86.16,1,1,2,4
1515915625536087188,115,2,140.34,1,2,3,6
1515915625536089194,116,1,22.54,1,1,1,3
1515915625536089956,115,1,292.83,1,1,4,6
1515915625536095657,76,2,1080.28,2,2,4,8
1515915625536098165,38,1,32.22,3,1,1,5
1515915625536098891,116,1,82.52,1,1,2,4
1515915625536099437,116,1,82.52,1,1,2,4
1515915625536103569,115,1,36.73,1,1,2,4
1515915625536105473,110,1,66.05,2,1,2,5
1515915625536105727,116,1,192.86,1,1,3,5
1515915625536107413,113,2,385.72,2,2,4,8
1515915625536107674,116,1,13.65,1,1,1,3
1515915625536110243,64,1,106.76,3,1,3,7
1515915625536112100,115,1,23.17,1,1,1,3
1515915625536114552,116,1,32.22,1,1,1,3
1515915625536114871,116,2,33.66,1,2,2,5
1515915625536116124,116,2,40.33,1,2,2,5
1515915625536130515,114,1,172.86,1,1,3,5
1515915625536146111,115,1,35.1,1,1,2,4
1515915625536149112,115,3,51.39,1,3,2,6
1515915625536149986,112,3,50.97,2,3,2,7
1515915625536150239,115,2,352.34,1,2,4,7
1515915625536164263,28,1,298.76,4,1,4,9
1515915625536168584,115,1,415.54,1,1,4,6
1515915625536169528,115,2,327.04,1,2,4,7
1515915625536169555,115,1,35.08,1,1,2,4
1515915625536174453,115,2,42.42,1,2,2,5
1515915625536175473,115,1,17.49,1,1,1,3
1515915625536179497,115,1,9.35,1,1,1,3
1515915625536183471,112,4,311.12,2,3,4,9
1515915625536186970,115,2,237.14,1,2,3,6
1515915625536187799,115,1,23.03,1,1,1,3
1515915625536188220,115,1,173.86,1,1,3,5
1515915625536190276,115,1,1.57,1,1,1,3
1515915625536192452,115,2,47.8,1,2,2,5
1515915625536193456,115,1,415.54,1,1,4,6
1515915625536194692,115,2,86.22,1,2,2,5
1515915625536195124,115,1,13.76,1,1,1,3
1515915625536195451,115,1,15.25,1,1,1,3
1515915625536196554,115,3,183.69,1,3,3,7
1515915625536203378,115,1,10.43,1,1,1,3
1515915625536203541,115,1,61.27,1,1,2,4
1515915625536205031,115,1,22.14,1,1,1,3
1515915625536207517,115,1,16.19,1,1,1,3
1515915625536209139,115,1,21.21,1,1,1,3
1515915625536210207,115,3,128.94,1,3,3,7
1515915625536210560,115,1,18.94,1,1,1,3
1515915625536212916,115,2,50.8,1,2,2,5
1515915625536216713,115,1,523.56,1,1,4,6
1515915625536222903,115,1,284.46,1,1,3,5
1515915625536224064,115,1,13.65,1,1,1,3
1515915625536227219,115,1,61.27,1,1,2,4
1515915625536227933,115,2,126.63,1,2,3,6
1515915625536230520,115,1,14.6,1,1,1,3
1515915625536232458,115,2,27.72,1,2,1,4
1515915625536233954,115,2,65.94,1,2,2,5
1515915625536235295,109,2,103.5,2,2,3,7
1515915625536239718,115,1,37.75,1,1,2,4
1515915625536252795,115,1,47.84,1,1,2,4
1515915625536254635,97,1,49.52,2,1,2,5
1515915625536255336,115,6,100.71,1,4,3,8
1515915625536255785,115,1,64.48,1,1,2,4
1515915625536259235,96,2,70.16,2,2,2,6
1515915625536259321,87,2,23.98,2,2,1,5
1515915625536262766,115,2,56.64,1,2,2,5
1515915625536265701,115,1,4.14,1,1,1,3
1515915625536267664,115,1,294.41,1,1,4,6
1515915625536269074,107,3,612.87,2,3,4,9
1515915625536269590,115,1,19.68,1,1,1,3
1515915625536270946,115,2,112.54,1,2,3,6
1515915625536271258,13,2,204.2,4,2,3,9
1515915625536271384,111,2,882.98,2,2,4,8
1515915625536273316,113,2,113.24,2,2,3,7
1515915625536274022,115,1,12.83,1,1,1,3
1515915625536274067,115,3,169.85999999999999,1,3,3,7
1515915625536274134,115,1,256.67,1,1,3,5
1515915625536278657,104,5,368.39,2,4,4,10
1515915625536281476,112,3,233.34,2,3,3,8
1515915625536281967,11,1,64.14,4,1,2,7
1515915625536282326,115,1,126.68,1,1,3,5
1515915625536285203,100,1,37.46,2,1,2,5
1515915625536285851,115,2,94.82,1,2,3,6
1515915625536286143,115,1,12.46,1,1,1,3
1515915625536293050,98,1,86.94,2,1,2,5
1515915625536295204,115,1,1.57,1,1,1,3
1515915625536299777,115,2,207.66,1,2,3,6
1515915625536300074,115,1,111.08,1,1,3,5
1515915625536301015,115,2,99.04,1,2,3,6
1515915625536303147,111,1,55.16,2,1,2,5
1515915625536314289,32,2,385.02,4,2,4,10
1515915625536314808,115,1,190.03,1,1,3,5
1515915625536316744,115,1,13.86,1,1,1,3
1515915625536317988,111,3,49.85,2,3,2,7
1515915625536320292,115,1,10.43,1,1,1,3
1515915625536326544,115,1,32.22,1,1,1,3
1515915625536328244,115,2,165.94,1,2,3,6
1515915625536329346,115,1,10.84,1,1,1,3
1515915625536333922,115,1,21.43,1,1,1,3
1515915625536339626,115,1,1.57,1,1,1,3
1515915625536339738,114,1,9.37,1,1,1,3
1515915625536339996,115,1,15.08,1,1,1,3
1515915625536341938,115,2,38.54,1,2,2,5
1515915625536349916,115,1,155.1,1,1,3,5
1515915625536352455,115,1,26.46,1,1,1,3
1515915625536357678,115,3,210.48,1,3,3,7
1515915625536358377,115,1,15.08,1,1,1,3
1515915625536362118,115,1,15.08,1,1,1,3
1515915625536363481,115,1,70.16,1,1,2,4
1515915625536369952,115,4,309.94,1,3,4,8
1515915625536370147,115,1,95.52,1,1,3,5
1515915625536377801,114,3,1093.3799999999999,1,3,4,8
1515915625536378601,115,1,427.75,1,1,4,6
1515915625536378925,114,1,230.48,1,1,3,5
1515915625536380715,115,1,26.19,1,1,1,3
1515915625536381408,115,1,50.11,1,1,2,4
1515915625536382663,115,1,15.4,1,1,1,3
1515915625536394101,115,1,50.11,1,1,2,4
1515915625536398857,115,2,46.19,1,2,2,5
1515915625536400672,115,1,9.81,1,1,1,3
1515915625536402298,104,2,597.76,2,2,4,8
1515915625536403061,115,1,63.98,1,1,2,4
1515915625536411306,115,1,82.97,1,1,2,4
1515915625536414775,114,1,88.33,1,1,2,4
1515915625536421025,114,3,674.28,1,3,4,8
1515915625536423428,114,1,45.14,1,1,2,4
1515915625536424351,100,5,388.65000000000003,2,4,4,10
1515915625536432321,106,7,544.11,2,4,4,10
1515915625536432344,115,4,91.0,1,3,3,7
1515915625536434201,115,1,26.46,1,1,1,3
1515915625536435293,115,1,22.22,1,1,1,3
1515915625536436094,115,2,29.2,1,2,1,4
1515915625536436700,110,1,176.17,2,1,3,6
1515915625536437586,115,1,15.68,1,1,1,3
1515915625536438609,114,4,1461.0,1,3,4,8
1515915625536440039,103,7,2202.76,2,4,4,10
1515915625536440423,115,1,42.57,1,1,2,4
1515915625536440640,115,1,35.22,1,1,2,4
1515915625536441405,35,1,415.54,4,1,4,9
1515915625536441447,115,1,33.49,1,1,2,4
1515915625536442165,114,1,46.98,1,1,2,4
1515915625536443712,110,3,343.79999999999995,2,3,4,9
1515915625536447710,107,3,155.25,2,3,3,8
1515915625536447881,88,1,409.49,2,1,4,7
1515915625536449287,113,2,281.72,2,2,3,7
1515915625536450574,115,1,82.97,1,1,2,4
1515915625536452972,115,1,177.87,1,1,3,5
1515915625536453422,110,5,2118.34,2,4,4,10
1515915625536453546,115,1,61.16,1,1,2,4
1515915625536461052,115,1,56.27,1,1,2,4
1515915625536461316,115,1,46.03,1,1,2,4
1515915625536461589,115,1,154.32,1,1,3,5
1515915625536461950,114,1,37.57,1,1,2,4
1515915625536462626,115,2,7.72,1,2,1,4
1515915625536462822,115,9,178.56,1,4,3,8
1515915625536463364,115,2,227.62,1,2,3,6
1515915625536464335,115,1,10.71,1,1,1,3
1515915625536464551,79,2,455.43,2,2,4,8
1515915625536464577,115,4,81.06,1,3,2,6
1515915625536468527,114,1,15.08,1,1,1,3
1515915625536470380,115,2,1308.88,1,2,4,7
1515915625536472856,115,2,9.65,1,2,1,4
1515915625536472924,115,1,45.24,1,1,2,4
1515915625536474665,115,1,71.75,1,1,2,4
1515915625536477472,115,1,118.57,1,1,3,5
1515915625536480811,115,2,237.14,1,2,3,6
1515915625536482355,115,1,292.83,1,1,4,6
1515915625536484287,113,7,481.49,2,4,4,10
1515915625536486571,115,1,201.35,1,1,3,5
1515915625536489254,107,2,398.74,2,2,4,8
1515915625536491021,115,1,3.54,1,1,1,3
1515915625536509513,114,6,1048.69,1,4,4,9
1515915625536513517,114,3,615.75,1,3,4,8
1515915625536515869,44,2,328.66,3,2,4,9
1515915625536533633,114,1,25.08,1,1,1,3
1515915625536538858,114,2,62.54,1,2,2,5
1515915625536541876,114,1,204.29,1,1,3,5
1515915625536543771,114,7,125.66000000000001,1,4,3,8
1515915625536546246,114,1,16.02,1,1,1,3
1515915625536547817,81,1,22.22,2,1,1,4
1515915625536551612,114,1,10.0,1,1,1,3
1515915625536553062,114,4,60.84,1,3,2,6
1515915625536555259,114,1,22.79,1,1,1,3
1515915625536559735,114,1,294.41,1,1,4,6
1515915625536560184,114,1,15.21,1,1,1,3
1515915625536566126,92,2,1039.0900000000001,2,2,4,8
1515915625536567608,11,19,1888.1299999999999,4,4,4,12
1515915625536570320,114,1,1.57,1,1,1,3
1515915625536570694,114,2,408.58,1,2,4,7
1515915625536574395,114,1,12.27,1,1,1,3
1515915625536574680,54,1,612.6,3,1,4,8
1515915625536578617,114,2,43.5,1,2,2,5
1515915625536580011,114,1,204.29,1,1,3,5
1515915625536584277,39,8,435.81000000000006,3,4,4,11
1515915625536588444,114,1,13.65,1,1,1,3
1515915625536593478,114,1,55.16,1,1,2,4
1515915625536596573,114,1,63.33,1,1,2,4
1515915625536597915,113,1,15.4,2,1,1,4
1515915625536598539,114,1,50.63,1,1,2,4
1515915625536598854,114,1,82.97,1,1,2,4
1515915625536599026,114,1,118.57,1,1,3,5
1515915625536601531,15,1,1275.02,4,1,4,9
1515915625536602577,114,1,55.87,1,1,2,4
1515915625536609877,114,3,74.76,1,3,2,6
1515915625536610024,114,2,59.04,1,2,2,5
1515915625536612391,114,3,595.89,1,3,4,8
1515915625536619433,114,1,60.32,1,1,2,4
1515915625536621266,114,1,107.79,1,1,3,5
1515915625536621758,113,2,64.44,2,2,2,6
1515915625536622038,114,4,74.92,1,3,2,6
1515915625536626301,114,1,103.59,1,1,3,5
1515915625536635161,114,1,24.76,1,1,1,3
1515915625536636860,114,1,58.71,1,1,2,4
1515915625536638434,114,2,794.96,1,2,4,7
1515915625536646497,114,2,145.72,1,2,3,6
1515915625536647842,114,1,282.65,1,1,3,5
1515915625536649145,114,2,66.66,1,2,2,5
1515915625536650367,114,1,10.89,1,1,1,3
1515915625536653320,104,4,452.44,2,3,4,9
1515915625536653515,114,5,46.75,1,4,2,7
1515915625536654580,114,1,1.57,1,1,1,3
1515915625536655088,114,3,590.25,1,3,4,8
1515915625536656564,114,2,30.8,1,2,1,4
1515915625536659936,112,7,431.25,2,4,4,10
1515915625536660149,114,1,14.6,1,1,1,3
1515915625536661972,114,1,398.7,1,1,4,6
1515915625536665827,16,2,406.04,4,2,4,10
1515915625536665868,114,1,174.73,1,1,3,5
1515915625536666396,113,2,73.18,2,2,2,6
1515915625536671265,114,1,9.81,1,1,1,3
1515915625536672596,114,2,38.74,1,2,2,5
1515915625536676050,114,1,35.87,1,1,2,4
1515915625536680191,114,2,52.38,1,2,2,5
1515915625536680384,114,4,130.16,1,3,3,7
1515915625536680859,88,1,441.49,2,1,4,7
1515915625536681182,114,1,18.73,1,1,1,3
1515915625536682496,114,1,9.68,1,1,1,3
1515915625536684624,109,2,147.62,2,2,3,7
1515915625536687862,114,1,26.19,1,1,1,3
1515915625536691371,114,1,26.98,1,1,1,3
1515915625536694342,114,2,49.24,1,2,2,5
1515915625536696658,114,1,82.38,1,1,2,4
1515915625536697789,113,1,28.14,2,1,1,4
1515915625536698758,114,1,134.13,1,1,3,5
1515915625536698810,114,1,23.17,1,1,1,3
1515915625536699212,114,1,257.87,1,1,3,5
1515915625536699635,114,1,128.79,1,1,3,5
1515915625536701160,114,1,414.13,1,1,4,6
1515915625536705457,114,1,1.57,1,1,1,3
1515915625536712849,114,1,204.29,1,1,3,5
1515915625536714343,108,2,18.7,2,2,1,5
1515915625536718037,114,1,26.71,1,1,1,3
1515915625536718955,113,2,403.66,2,2,4,8
1515915625536722860,100,2,191.04,2,2,3,7
1515915625536730409,114,1,26.46,1,1,1,3
1515915625536730625,114,1,38.1,1,1,2,4
1515915625536734264,114,1,8.57,1,1,1,3
1515915625536735025,114,6,68.58,1,4,2,7
1515915625536737208,114,3,135.72,1,3,3,7
1515915625536740912,110,2,738.89,2,2,4,8
1515915625536742963,114,1,415.54,1,1,4,6
1515915625536743541,114,2,58.42,1,2,2,5
1515915625536745687,114,2,46.04,1,2,2,5
1515915625536746417,113,1,31.43,2,1,1,4
1515915625536750499,114,4,294.72,1,3,4,8
1515915625536751753,114,3,81.42,1,3,2,6
1515915625536755896,106,1,104.46,2,1,3,6
1515915625536758873,114,1,187.78,1,1,3,5
1515915625536759840,114,1,154.32,1,1,3,5
1515915625536762609,102,4,786.68,2,3,4,9
1515915625536763748,114,1,29.52,1,1,1,3
1515915625536766735,110,1,163.52,2,1,3,6
1515915625536767573,114,1,165.33,1,1,3,5
1515915625536769539,110,8,1615.6799999999998,2,4,4,10
1515915625536772008,102,3,78.57000000000001,2,3,2,7
1515915625536772723,114,1,9.79,1,1,1,3
1515915625536772853,114,1,52.83,1,1,2,4
1515915625536773547,114,1,77.73,1,1,2,4
1515915625536777177,110,3,128.52,2,3,3,8
1515915625536777378,114,5,134.14999999999998,1,4,3,8
1515915625536777731,114,1,4.11,1,1,1,3
1515915625536778213,112,2,402.66,2,2,4,8
1515915625536779780,114,2,64.44,1,2,2,5
1515915625536783347,25,5,2597.7999999999997,4,4,4,12
1515915625536784280,114,1,145.38,1,1,3,5
1515915625536786225,114,1,57.14,1,1,2,4
1515915625536787030,114,1,145.38,1,1,3,5
1515915625536787309,113,8,2382.92,2,4,4,10
1515915625536790114,114,1,50.03,1,1,2,4
1515915625536790634,110,1,413.83,2,1,4,7
1515915625536794526,114,1,6.0,1,1,1,3
1515915625536795573,114,2,251.72,1,2,3,6
1515915625536795882,52,6,133.32,3,4,3,10
1515915625536797844,96,8,1409.36,2,4,4,10
1515915625536797969,114,1,24.13,1,1,1,3
1515915625536798719,95,3,192.94,2,3,3,8
1515915625536799334,114,1,192.86,1,1,3,5
1515915625536802052,114,2,245.72,1,2,3,6
1515915625536807023,114,1,18.73,1,1,1,3
1515915625536808347,114,1,55.6,1,1,2,4
1515915625536811149,114,1,204.29,1,1,3,5
1515915625536817969,114,2,58.44,1,2,2,5
1515915625536821501,81,1,115.27,2,1,3,6
1515915625536823526,95,3,645.55,2,3,4,9
1515915625536823619,114,1,26.19,1,1,1,3
1515915625536824238,114,1,149.05,1,1,3,5
1515915625536825622,114,1,153.83,1,1,3,5
1515915625536826589,112,1,85.24,2,1,2,5
1515915625536831464,114,2,147.62,1,2,3,6
1515915625536838384,113,2,290.82,2,2,4,8
1515915625536839525,114,1,7.52,1,1,1,3
1515915625536840787,108,3,302.31,2,3,4,9
1515915625536845241,112,1,10.43,2,1,1,4
1515915625536848125,114,1,257.87,1,1,3,5
1515915625536856591,113,1,20.51,2,1,1,4
1515915625536867623,113,1,166.51,2,1,3,6
1515915625536879832,113,1,23.17,2,1,1,4
1515915625536880330,112,2,166.04,2,2,3,7
1515915625536891459,113,1,370.46,2,1,4,7
1515915625536893213,113,1,17.19,2,1,1,4
1515915625536893675,113,2,35.46,2,2,2,6
1515915625536895927,113,3,56.19,2,3,2,7
1515915625536896492,113,3,90.48,2,3,2,7
1515915625536897477,113,1,31.32,2,1,1,4
1515915625536901352,113,1,133.03,2,1,3,6
1515915625536903516,111,6,210.8,2,4,3,9
1515915625536904017,113,1,30.16,2,1,1,4
1515915625536904312,113,4,893.26,2,3,4,9
1515915625536909325,113,2,52.38,2,2,2,6
1515915625536910905,113,1,18.19,2,1,1,4
1515915625536912260,113,1,42.86,2,1,2,5
1515915625536918398,113,1,22.22,2,1,1,4
1515915625536920561,113,2,55.5,2,2,2,6
1515915625536920650,113,1,14.6,2,1,1,4
1515915625536924216,14,1,65.32,4,1,2,7
1515915625536925711,113,1,39.75,2,1,2,5
1515915625536926760,113,3,609.9100000000001,2,3,4,9
1515915625536927955,113,1,10.24,2,1,1,4
1515915625536928634,31,1,624.62,4,1,4,9
1515915625536929087,104,1,22.03,2,1,1,4
1515915625536929406,113,2,284.8,2,2,3,7
1515915625536931323,113,1,164.33,2,1,3,6
1515915625536933976,113,3,105.24,2,3,3,8
1515915625536934060,113,1,22.51,2,1,1,4
1515915625536935639,113,1,20.79,2,1,1,4
1515915625536940894,81,10,441.75,2,4,4,10
1515915625536941178,113,2,37.68,2,2,2,6
1515915625536941639,113,3,248.91,2,3,3,8
1515915625536945099,113,2,111.3,2,2,3,7
1515915625536945250,113,3,34.29,2,3,2,7
1515915625536948651,113,1,74.06,2,1,2,5
1515915625536956689,113,4,54.28,2,3,2,7
1515915625536959950,113,1,27.14,2,1,1,4
1515915625536964454,110,1,35.08,2,1,2,5
1515915625536966114,113,5,1907.3,2,4,4,10
1515915625536970374,112,7,1059.24,2,4,4,10
1515915625536970465,113,1,381.46,2,1,4,7
1515915625536971565,112,3,465.29999999999995,2,3,4,9
1515915625536972066,112,2,32.7,2,2,2,6
1515915625536974120,113,1,35.1,2,1,2,5
1515915625536978670,113,1,14.57,2,1,1,4
1515915625536979400,113,1,24.6,2,1,1,4
1515915625536980514,113,1,82.97,2,1,2,5
1515915625536982752,113,1,61.27,2,1,2,5
1515915625536984246,113,1,155.1,2,1,3,6
1515915625536988356,113,2,405.34,2,2,4,8
1515915625536990008,113,1,314.68,2,1,4,7
1515915625536991206,112,1,43.11,2,1,2,5
1515915625536991792,113,1,61.75,2,1,2,5
1515915625536997996,113,2,227.62,2,2,3,7
1515915625536998374,67,1,23.81,3,1,1,5
1515915625536999325,99,3,53.19,2,3,2,7
1515915625537000638,113,1,49.43,2,1,2,5
1515915625537004281,112,1,229.38,2,1,3,6
1515915625537004815,113,1,28.33,2,1,1,4
1515915625537008065,111,2,29.72,2,2,1,5
1515915625537010945,103,1,365.38,2,1,4,7
1515915625537012565,113,1,26.46,2,1,1,4
1515915625537014986,113,2,421.8,2,2,4,8
1515915625537019896,113,2,50.8,2,2,2,6
1515915625537021957,26,3,153.72,4,3,3,10
1515915625537022626,113,1,22.7,2,1,1,4
1515915625537023286,98,4,840.76,2,3,4,9
1515915625537023676,113,2,305.02,2,2,4,8
1515915625537027264,96,4,64.76,2,3,2,7
1515915625537027929,48,1,26.19,3,1,1,5
1515915625537032566,63,3,1216.47,3,3,4,10
1515915625537032857,113,7,2257.99,2,4,4,10
1515915625537033087,113,1,12.22,2,1,1,4
1515915625537033384,113,1,40.48,2,1,2,5
1515915625537034048,113,1,398.7,2,1,4,7
1515915625537037200,113,1,12.03,2,1,1,4
1515915625537041176,113,1,397.48,2,1,4,7
1515915625537041394,113,1,16.19,2,1,1,4
1515915625537041961,113,2,169.24,2,2,3,7
1515915625537043460,113,1,153.83,2,1,3,6
1515915625537044817,113,1,1.57,2,1,1,4
1515915625537046320,113,1,82.97,2,1,2,5
1515915625537047055,113,3,181.89000000000001,2,3,3,8
1515915625537049718,113,1,21.59,2,1,1,4
1515915625537050670,113,1,9.35,2,1,1,4
1515915625537052226,113,4,257.92,2,3,3,8
1515915625537060590,113,1,10.68,2,1,1,4
1515915625537063248,113,1,103.44,2,1,3,6
1515915625537063442,113,1,26.98,2,1,1,4
1515915625537064656,113,1,18.25,2,1,1,4
1515915625537065804,82,1,11.86,2,1,1,4
1515915625537065829,113,1,170.79,2,1,3,6
1515915625537068659,110,3,165.48,2,3,3,8
1515915625537085327,113,2,151.54000000000002,2,2,3,7
1515915625537086105,113,1,35.25,2,1,2,5
1515915625537086530,113,1,29.22,2,1,1,4
1515915625537092628,99,3,129.39000000000001,2,3,3,8
1515915625537096918,101,1,35.24,2,1,2,5
1515915625537099704,113,1,21.21,2,1,1,4
1515915625537103850,113,1,32.22,2,1,1,4
1515915625537106724,113,2,132.54,2,2,3,7
1515915625537114740,113,2,145.18,2,2,3,7
1515915625537115215,110,3,214.77,2,3,3,8
1515915625537119361,113,1,397.48,2,1,4,7
1515915625537121413,113,4,76.2,2,3,2,7
1515915625537121708,110,1,10.43,2,1,1,4
1515915625537122629,107,7,185.22,2,4,3,9
1515915625537123611,113,2,64.44,2,2,2,6
1515915625537124526,113,1,26.19,2,1,1,4
1515915625537124779,113,2,44.44,2,2,2,6
1515915625537125919,113,1,136.92,2,1,3,6
1515915625537128463,113,2,52.92,2,2,2,6
1515915625537128486,113,1,26.46,2,1,1,4
1515915625537129799,106,2,449.52,2,2,4,8
1515915625537131080,113,2,545.5600000000001,2,2,4,8
1515915625537132357,113,2,54.7,2,2,2,6
1515915625537134156,113,3,37.53,2,3,2,7
1515915625537135939,112,2,262.88,2,2,3,7
1515915625537141393,113,1,64.6,2,1,2,5
1515915625537144111,113,1,66.29,2,1,2,5
1515915625537146351,107,1,52.7,2,1,2,5
1515915625537151850,113,2,359.88,2,2,4,8
1515915625537152497,113,1,16.19,2,1,1,4
1515915625537154133,113,3,48.57000000000001,2,3,2,7
1515915625537154426,113,1,9.84,2,1,1,4
1515915625537156208,113,3,55.29,2,3,2,7
1515915625537159665,113,2,698.92,2,2,4,8
1515915625537161515,102,5,435.25,2,4,4,10
1515915625537162089,113,1,97.35,2,1,3,6
1515915625537163186,113,1,97.35,2,1,3,6
1515915625537163414,113,2,64.44,2,2,2,6
1515915625537165090,113,1,109.11,2,1,3,6
1515915625537165573,113,1,60.83,2,1,2,5
1515915625537166652,77,3,510.0,2,3,4,9
1515915625537171333,87,1,32.22,2,1,1,4
1515915625537172630,109,1,43.33,2,1,2,5
1515915625537172900,113,1,25.56,2,1,1,4
1515915625537173357,113,2,128.96,2,2,3,7
1515915625537174290,113,1,9.14,2,1,1,4
1515915625537174518,108,1,77.73,2,1,2,5
1515915625537175599,49,4,1005.49,3,3,4,10
1515915625537176660,88,1,30.0,2,1,1,4
1515915625537190381,102,3,389.57000000000005,2,3,4,9
1515915625537190733,113,2,44.44,2,2,2,6
1515915625537192267,113,1,52.9,2,1,2,5
1515915625537195298,113,2,154.82,2,2,3,7
1515915625537198657,83,5,1050.95,2,4,4,10
1515915625537205456,113,1,164.33,2,1,3,6
1515915625537206919,113,1,164.33,2,1,3,6
1515915625537206922,113,1,36.49,2,1,2,5
1515915625537210208,87,1,446.51,2,1,4,7
1515915625537218712,113,1,53.33,2,1,2,5
1515915625537221039,113,1,24.79,2,1,1,4
1515915625537222460,113,1,615.6,2,1,4,7
1515915625537222722,41,5,245.07999999999998,3,4,3,10
1515915625537226183,112,1,26.46,2,1,1,4
1515915625537226873,112,1,9.0,2,1,1,4
1515915625537239607,112,1,58.25,2,1,2,5
1515915625537244605,47,2,302.86,3,2,4,9
1515915625537255164,112,2,1219.2,2,2,4,8
1515915625537261125,98,5,161.1,2,4,3,9
1515915625537269194,112,1,207.27,2,1,3,6
1515915625537277393,39,2,212.26,3,2,3,8
1515915625537279957,112,1,33.54,2,1,2,5
1515915625537281078,112,1,72.38,2,1,2,5
1515915625537281778,112,1,213.83,2,1,3,6
1515915625537282357,112,2,86.34,2,2,2,6
1515915625537288174,112,1,55.56,2,1,2,5
1515915625537288836,112,4,257.48,2,3,3,8
1515915625537295581,112,1,75.29,2,1,2,5
1515915625537295691,112,2,428.2,2,2,4,8
1515915625537298577,110,1,35.9,2,1,2,5
1515915625537300251,112,1,21.21,2,1,1,4
1515915625537302050,112,1,29.57,2,1,1,4
1515915625537303134,112,1,47.41,2,1,2,5
1515915625537304001,112,1,9.83,2,1,1,4
1515915625537305605,112,1,11.32,2,1,1,4
1515915625537306014,112,1,55.0,2,1,2,5
1515915625537306521,112,1,13.71,2,1,1,4
1515915625537308562,112,1,16.44,2,1,1,4
1515915625537309115,112,3,128.94,2,3,3,8
1515915625537311950,112,1,38.83,2,1,2,5
1515915625537312623,112,1,30.63,2,1,1,4
1515915625537316073,87,2,151.42,2,2,3,7
1515915625537316236,112,2,167.18,2,2,3,7
1515915625537320555,112,3,55.71,2,3,2,7
1515915625537321979,112,1,453.98,2,1,4,7
1515915625537325008,94,1,177.95,2,1,3,6
1515915625537326521,112,1,43.33,2,1,2,5
1515915625537326928,112,1,36.14,2,1,2,5
1515915625537326935,112,1,15.08,2,1,1,4
1515915625537327867,112,3,103.32,2,3,3,8
1515915625537329081,112,1,98.41,2,1,3,6
1515915625537330472,112,2,24.11,2,2,1,5
1515915625537331695,112,4,176.12,2,3,3,8
1515915625537334638,112,1,10.57,2,1,1,4
1515915625537334968,112,1,19.52,2,1,1,4
1515915625537338785,112,2,18.7,2,2,1,5
1515915625537338817,112,1,15.08,2,1,1,4
1515915625537338823,112,1,19.9,2,1,1,4
1515915625537340426,112,1,21.21,2,1,1,4
1515915625537342956,112,2,94.6,2,2,3,7
1515915625537344585,111,2,103.46,2,2,3,7
1515915625537345072,112,1,32.22,2,1,1,4
1515915625537345703,112,1,21.21,2,1,1,4
1515915625537346052,112,1,9.35,2,1,1,4
1515915625537346634,112,1,16.73,2,1,1,4
1515915625537349823,112,3,669.7,2,3,4,9
1515915625537350083,112,1,14.6,2,1,1,4
1515915625537350596,112,1,11.98,2,1,1,4
1515915625537350915,112,1,51.97,2,1,2,5
1515915625537357214,112,1,9.84,2,1,1,4
1515915625537357492,112,2,629.64,2,2,4,8
1515915625537361676,112,2,308.64,2,2,4,8
1515915625537362526,112,2,33.52,2,2,2,6
1515915625537366003,112,1,18.41,2,1,1,4
1515915625537366774,112,2,629.36,2,2,4,8
1515915625537366777,40,1,11.62,3,1,1,5
1515915625537368353,112,1,82.97,2,1,2,5
1515915625537368585,112,2,86.26,2,2,2,6
1515915625537371487,112,2,44.52,2,2,2,6
1515915625537372804,112,1,9.35,2,1,1,4
1515915625537373571,105,2,596.64,2,2,4,8
1515915625537375012,112,1,21.21,2,1,1,4
1515915625537375465,112,1,43.13,2,1,2,5
1515915625537376271,112,1,214.1,2,1,3,6
1515915625537380868,112,1,9.37,2,1,1,4
1515915625537384574,110,3,927.72,2,3,4,9
1515915625537387442,21,2,460.96,4,2,4,10
1515915625537387639,112,1,370.46,2,1,4,7
1515915625537388977,112,1,13.29,2,1,1,4
1515915625537389005,112,1,122.08,2,1,3,6
1515915625537390285,112,1,82.97,2,1,2,5
1515915625537392324,42,2,240.32,3,2,3,8
1515915625537398354,109,3,160.9,2,3,3,8
1515915625537400265,12,2,81.58,4,2,2,8
1515915625537402904,110,1,34.9,2,1,2,5
1515915625537405531,112,1,26.19,2,1,1,4
1515915625537406759,112,2,33.66,2,2,2,6
1515915625537408329,112,1,15.1,2,1,1,4
1515915625537408902,112,1,82.97,2,1,2,5
1515915625537414795,112,3,190.05,2,3,3,8
1515915625537415259,112,1,32.7,2,1,2,5
1515915625537419224,111,3,172.85999999999999,2,3,3,8
1515915625537427300,88,1,10.0,2,1,1,4
1515915625537431383,112,4,118.28,2,3,3,8
1515915625537432719,109,3,371.82,2,3,4,9
1515915625537433896,83,2,19.9,2,2,1,5
1515915625537435795,112,5,215.55,2,4,3,9
1515915625537435844,105,3,41.9,2,3,2,7
1515915625537436687,112,1,168.59,2,1,3,6
1515915625537442837,112,1,29.22,2,1,1,4
1515915625537443740,45,9,248.58,3,4,3,10
1515915625537446643,111,2,39.94,2,2,2,6
1515915625537449497,99,2,298.02,2,2,4,8
1515915625537452678,112,1,26.46,2,1,1,4
1515915625537456954,111,2,298.1,2,2,4,8
1515915625537458645,112,2,19.9,2,2,1,5
1515915625537458981,112,4,1560.8400000000001,2,3,4,9
1515915625537459008,112,1,31.44,2,1,1,4
1515915625537459204,112,1,195.22,2,1,3,6
1515915625537461924,112,1,23.17,2,1,1,4
1515915625537469282,112,2,49.52,2,2,2,6
1515915625537477401,112,1,93.13,2,1,3,6
1515915625537478071,112,1,33.19,2,1,2,5
1515915625537480514,112,2,42.379999999999995,2,2,2,6
1515915625537480624,112,2,93.34,2,2,3,7
1515915625537486355,112,1,19.33,2,1,1,4
1515915625537486418,112,6,178.07999999999998,2,4,3,9
1515915625537486425,112,1,236.97,2,1,3,6
1515915625537488388,112,1,236.97,2,1,3,6
1515915625537489105,112,1,166.02,2,1,3,6
1515915625537489881,112,1,10.32,2,1,1,4
1515915625537492632,112,1,32.81,2,1,2,5
1515915625537494955,99,2,87.4,2,2,2,6
1515915625537497531,112,1,32.81,2,1,2,5
1515915625537501307,94,1,82.89,2,1,2,5
1515915625537505290,112,2,116.22,2,2,3,7
1515915625537506952,5,1,42.84,4,1,2,7
1515915625537513806,111,5,465.85,2,4,4,10
1515915625537514165,109,1,173.86,2,1,3,6
1515915625537515919,112,1,56.67,2,1,2,5
1515915625537521467,105,1,24.92,2,1,1,4
1515915625537527190,112,4,6.28,2,3,1,6
1515915625537528822,112,1,33.65,2,1,2,5
1515915625537535728,112,1,415.54,2,1,4,7
1515915625537536139,112,2,568.6,2,2,4,8
1515915625537537089,112,1,17.71,2,1,1,4
1515915625537538230,108,5,406.75,2,4,4,10
1515915625537539631,7,4,39.36,4,3,2,9
1515915625537542680,112,1,57.62,2,1,2,5
1515915625537553104,112,1,20.79,2,1,1,4
1515915625537554692,112,1,151.32,2,1,3,6
1515915625537555152,106,5,336.1,2,4,4,10
1515915625537558438,109,2,289.02,2,2,4,8
1515915625537561209,112,1,40.63,2,1,2,5
1515915625537564354,112,2,52.92,2,2,2,6
1515915625537568374,112,1,26.03,2,1,1,4
1515915625537569166,111,4,204.02,2,3,3,8
1515915625537571432,112,1,13.49,2,1,1,4
1515915625537572048,112,1,1090.7,2,1,4,7
1515915625537578512,111,1,63.35,2,1,2,5
1515915625537581410,112,1,12.83,2,1,1,4
1515915625537585724,112,1,14.6,2,1,1,4
1515915625537587241,112,1,42.22,2,1,2,5
1515915625537588868,111,1,22.22,2,1,1,4
1515915625537594311,111,1,202.67,2,1,3,6
1515915625537595448,111,1,30.38,2,1,1,4
1515915625537596929,107,1,118.57,2,1,3,6
1515915625537599608,111,1,28.71,2,1,1,4
1515915625537601488,111,1,24.76,2,1,1,4
1515915625537603274,111,1,198.62,2,1,3,6
1515915625537603445,111,1,16.51,2,1,1,4
1515915625537607079,111,2,913.02,2,2,4,8
1515915625537607468,111,1,64.48,2,1,2,5
1515915625537612559,111,1,139.44,2,1,3,6
1515915625537616158,111,1,34.65,2,1,2,5
1515915625537618280,111,2,115.24,2,2,3,7
1515915625537621084,111,4,113.8,2,3,3,8
1515915625537622449,55,1,107.79,3,1,3,7
1515915625537626859,111,2,88.35,2,2,2,6
1515915625537630874,111,8,838.88,2,4,4,10
1515915625537634592,108,1,156.73,2,1,3,6
1515915625537634766,111,2,64.44,2,2,2,6
1515915625537639637,111,2,72.34,2,2,2,6
1515915625537640167,111,1,13.52,2,1,1,4
1515915625537640247,111,1,15.92,2,1,1,4
1515915625537640337,111,1,58.11,2,1,2,5
1515915625537641492,111,1,26.19,2,1,1,4
1515915625537643701,98,3,128.94,2,3,3,8
1515915625537644878,110,1,40.48,2,1,2,5
1515915625537646365,111,1,26.19,2,1,1,4
1515915625537646587,111,1,16.19,2,1,1,4
1515915625537646616,111,2,30.48,2,2,1,5
1515915625537647921,106,1,154.32,2,1,3,6
1515915625537649052,111,1,55.16,2,1,2,5
1515915625537652112,111,1,28.89,2,1,1,4
1515915625537652315,103,5,413.15,2,4,4,10
1515915625537655921,104,1,224.76,2,1,3,6
1515915625537657664,111,1,187.29,2,1,3,6
1515915625537658571,111,4,57.92,2,3,2,7
1515915625537661479,111,1,84.89,2,1,2,5
1515915625537661977,109,2,32.8,2,2,2,6
1515915625537667673,6,1,23.9,4,1,1,6
1515915625537670620,111,1,29.68,2,1,1,4
1515915625537670948,111,1,19.52,2,1,1,4
1515915625537674781,110,1,73.81,2,1,2,5
1515915625537675329,111,1,13.57,2,1,1,4
1515915625537676082,111,1,26.17,2,1,1,4
1515915625537678004,111,1,29.68,2,1,1,4
1515915625537681022,111,1,163.52,2,1,3,6
1515915625537682419,111,1,26.19,2,1,1,4
1515915625537690927,77,4,118.72,2,3,3,8
1515915625537701799,111,1,148.37,2,1,3,6
1515915625537701984,109,5,493.65000000000003,2,4,4,10
1515915625537703303,111,1,18.89,2,1,1,4
1515915625537703553,111,1,63.33,2,1,2,5
1515915625537711610,111,1,64.48,2,1,2,5
1515915625537712723,111,1,59.62,2,1,2,5
1515915625537714760,111,2,14.73,2,2,1,5
1515915625537715514,108,1,26.46,2,1,1,4
1515915625537716986,111,2,53.96,2,2,2,6
1515915625537718592,111,1,26.98,2,1,1,4
1515915625537719374,111,3,353.25,2,3,4,9
1515915625537721208,111,1,28.14,2,1,1,4
1515915625537721597,111,2,405.34,2,2,4,8
1515915625537721739,111,1,26.46,2,1,1,4
1515915625537723260,111,1,17.81,2,1,1,4
1515915625537724359,111,1,292.83,2,1,4,7
1515915625537725830,111,2,245.72,2,2,3,7
1515915625537726280,111,1,9.22,2,1,1,4
1515915625537731937,111,1,23.17,2,1,1,4
1515915625537732930,110,18,4378.56,2,4,4,10
1515915625537734723,111,2,16.54,2,2,1,5
1515915625537736295,111,1,146.51,2,1,3,6
1515915625537738840,111,2,128.96,2,2,3,7
1515915625537738865,107,6,349.62,2,4,4,10
1515915625537739320,111,1,126.68,2,1,3,6
1515915625537739331,111,1,43.33,2,1,2,5
1515915625537740667,111,2,19.3,2,2,1,5
1515915625537743076,111,1,66.05,2,1,2,5
1515915625537745200,111,1,24.6,2,1,1,4
1515915625537745447,111,1,56.32,2,1,2,5
1515915625537745932,108,1,15.08,2,1,1,4
1515915625537748240,111,1,6.79,2,1,1,4
1515915625537749528,111,2,37.46,2,2,2,6
1515915625537750998,111,1,26.57,2,1,1,4
1515915625537759885,111,2,19.18,2,2,1,5
1515915625537760838,111,1,32.22,2,1,1,4
1515915625537761755,111,2,67.8,2,2,2,6
1515915625537766990,21,1,33.65,4,1,2,7
1515915625537767121,111,1,115.41,2,1,3,6
1515915625537767843,111,1,136.05,2,1,3,6
1515915625537772075,111,2,133.68,2,2,3,7
1515915625537772734,111,1,43.33,2,1,2,5
1515915625537777452,111,1,13.03,2,1,1,4
1515915625537777867,111,1,13.52,2,1,1,4
1515915625537777922,111,1,33.33,2,1,2,5
1515915625537783474,111,1,149.62,2,1,3,6
1515915625537786952,111,1,61.16,2,1,2,5
1515915625537789508,111,1,164.92,2,1,3,6
1515915625537789756,111,1,78.41,2,1,2,5
1515915625537792455,111,1,22.41,2,1,1,4
1515915625537795083,111,2,106.74,2,2,3,7
1515915625537796744,106,3,79.06,2,3,2,7
1515915625537799351,111,1,17.62,2,1,1,4
1515915625537799457,111,1,32.22,2,1,1,4
1515915625537800124,111,1,18.13,2,1,1,4
1515915625537800388,111,1,98.41,2,1,3,6
1515915625537800762,111,1,81.81,2,1,2,5
1515915625537801528,111,1,12.22,2,1,1,4
1515915625537803839,29,4,393.34,4,3,4,11
1515915625537804306,111,1,32.22,2,1,1,4
1515915625537804798,111,1,51.73,2,1,2,5
1515915625537806926,79,2,302.12,2,2,4,8
1515915625537810185,111,2,20.42,2,2,1,5
1515915625537820534,111,1,23.81,2,1,1,4
1515915625537823534,111,1,22.22,2,1,1,4
1515915625537825923,110,1,106.98,2,1,3,6
1515915625537831390,111,1,116.83,2,1,3,6
1515915625537834432,109,1,32.38,2,1,2,5
1515915625537835787,111,1,21.75,2,1,1,4
1515915625537836886,111,2,52.34,2,2,2,6
1515915625537845244,111,1,101.67,2,1,3,6
1515915625537849895,105,7,886.76,2,4,4,10
1515915625537851755,111,1,55.16,2,1,2,5
1515915625537852081,110,5,66.2,2,4,2,8
1515915625537852572,110,4,310.92,2,3,4,9
1515915625537852583,111,1,51.11,2,1,2,5
1515915625537855255,111,4,43.58,2,3,2,7
1515915625537860745,111,2,408.58,2,2,4,8
1515915625537862987,111,1,8.59,2,1,1,4
1515915625537863684,49,1,28.1,3,1,1,5
1515915625537864644,111,1,82.97,2,1,2,5
1515915625537867326,111,2,585.66,2,2,4,8
1515915625537869435,57,2,609.26,3,2,4,9
1515915625537870088,111,2,41.58,2,2,2,6
1515915625537871617,111,1,357.35,2,1,4,7
1515915625537872437,111,1,257.87,2,1,3,6
1515915625537873297,111,1,29.68,2,1,1,4
1515915625537873382,80,1,180.79,2,1,3,6
1515915625537878788,111,2,128.96,2,2,3,7
1515915625537879008,110,5,1245.1000000000001,2,4,4,10
1515915625537883597,106,1,48.7,2,1,2,5
1515915625537885394,50,2,75.14,3,2,2,7
1515915625537887841,111,2,58.44,2,2,2,6
1515915625537888623,109,1,164.33,2,1,3,6
1515915625537889161,111,2,23.8,2,2,1,5
1515915625537889223,94,2,27.62,2,2,1,5
1515915625537891772,111,2,28.0,2,2,1,5
1515915625537892478,12,2,1050.1100000000001,4,2,4,10
1515915625537899024,111,1,8.57,2,1,1,4
1515915625537900949,111,2,941.02,2,2,4,8
1515915625537903135,111,1,60.06,2,1,2,5
1515915625537908463,111,2,192.74,2,2,3,7
1515915625537910207,110,8,126.36,2,4,3,9
1515915625537910945,111,1,82.97,2,1,2,5
1515915625537914830,111,1,75.67,2,1,2,5
1515915625537917124,110,1,39.21,2,1,2,5
1515915625537917859,111,2,20.96,2,2,1,5
1515915625537918908,108,1,13.65,2,1,1,4
1515915625537922633,53,2,34.28,3,2,2,7
1515915625537934571,105,1,157.14,2,1,3,6
1515915625537936516,111,4,1410.72,2,3,4,9
1515915625537945319,110,1,13.97,2,1,1,4
1515915625537957300,41,2,374.58,3,2,4,9
1515915625537958116,110,1,201.33,2,1,3,6
1515915625537959833,110,1,9.35,2,1,1,4
1515915625537963153,110,2,497.12,2,2,4,8
1515915625537963542,110,1,205.49,2,1,3,6
1515915625537971414,110,2,58.44,2,2,2,6
1515915625537973304,109,1,10.32,2,1,1,4
1515915625537975367,110,1,107.79,2,1,3,6
1515915625537982600,94,10,2079.08,2,4,4,10
1515915625537983941,110,1,43.13,2,1,2,5
1515915625537988430,110,1,7.49,2,1,1,4
1515915625537992443,110,1,164.92,2,1,3,6
1515915625537993075,110,1,89.22,2,1,2,5
1515915625537993503,107,2,86.26,2,2,2,6
1515915625537995974,110,3,587.99,2,3,4,9
1515915625537997734,110,3,191.94,2,3,3,8
1515915625537999083,110,1,29.22,2,1,1,4
1515915625537999341,109,24,4091.56,2,4,4,10
1515915625538001358,110,1,365.25,2,1,4,7
1515915625538002320,110,1,240.98,2,1,3,6
1515915625538003190,110,1,23.22,2,1,1,4
1515915625538003418,110,1,21.75,2,1,1,4
1515915625538008339,110,3,317.61,2,3,4,9
1515915625538009415,110,1,63.21,2,1,2,5
1515915625538010548,4,3,1255.44,4,3,4,11
1515915625538010756,110,2,77.46,2,2,2,6
1515915625538013848,110,1,83.97,2,1,2,5
1515915625538014356,101,1,176.17,2,1,3,6
1515915625538015443,110,4,1593.8899999999999,2,3,4,9
1515915625538017489,110,1,190.46,2,1,3,6
1515915625538019101,106,1,29.22,2,1,1,4
1515915625538019414,110,1,126.68,2,1,3,6
1515915625538021240,110,1,10.95,2,1,1,4
1515915625538021607,110,1,7.52,2,1,1,4
1515915625538022029,110,1,58.43,2,1,2,5
1515915625538022997,95,3,583.8,2,3,4,9
1515915625538026225,110,1,28.89,2,1,1,4
1515915625538029562,110,1,34.44,2,1,2,5
1515915625538033323,110,1,23.16,2,1,1,4
1515915625538033378,110,3,598.11,2,3,4,9
1515915625538033415,109,2,12.86,2,2,1,5
1515915625538033947,100,1,202.32,2,1,3,6
1515915625538037001,109,1,370.46,2,1,4,7
1515915625538040987,110,3,512.37,2,3,4,9
1515915625538041207,110,2,147.9,2,2,3,7
1515915625538052037,110,2,828.26,2,2,4,8
1515915625538052162,110,1,48.73,2,1,2,5
1515915625538057370,110,1,26.19,2,1,1,4
1515915625538057564,110,1,40.19,2,1,2,5
1515915625538057851,110,1,397.48,2,1,4,7
1515915625538059750,110,1,26.46,2,1,1,4
1515915625538059996,109,2,56.2,2,2,2,6
1515915625538062010,104,1,2.92,2,1,1,4
1515915625538065032,110,1,25.94,2,1,1,4
1515915625538065901,84,1,26.19,2,1,1,4
1515915625538068100,110,3,410.76,2,3,4,9
1515915625538068456,110,1,93.43,2,1,3,6
1515915625538068768,110,1,16.35,2,1,1,4
1515915625538072004,97,1,47.3,2,1,2,5
1515915625538074766,86,1,56.51,2,1,2,5
1515915625538075196,110,2,222.84,2,2,3,7
1515915625538080579,110,1,43.11,2,1,2,5
1515915625538083757,110,1,65.71,2,1,2,5
1515915625538084159,110,1,31.9,2,1,1,4
1515915625538085694,110,1,17.97,2,1,1,4
1515915625538088048,110,2,42.42,2,2,2,6
1515915625538090850,76,1,132.86,2,1,3,6
1515915625538092250,110,1,219.97,2,1,3,6
1515915625538092757,110,1,82.97,2,1,2,5
1515915625538095889,110,1,88.7,2,1,2,5
1515915625538096079,109,2,339.34,2,2,4,8
1515915625538097105,110,1,15.1,2,1,1,4
1515915625538097765,110,3,70.94999999999999,2,3,2,7
1515915625538099245,110,2,402.66,2,2,4,8
1515915625538100033,109,2,588.82,2,2,4,8
1515915625538100040,110,2,127.19,2,2,3,7
1515915625538101220,110,1,10.37,2,1,1,4
1515915625538102866,110,2,175.4,2,2,3,7
1515915625538106770,48,1,519.56,3,1,4,8
1515915625538106898,110,1,257.87,2,1,3,6
1515915625538106938,110,1,257.87,2,1,3,6
1515915625538107947,110,1,32.06,2,1,1,4
1515915625538109815,110,4,105.84,2,3,3,8
1515915625538113841,110,1,8.29,2,1,1,4
1515915625538114466,110,1,77.73,2,1,2,5
1515915625538116983,110,1,63.33,2,1,2,5
1515915625538120730,108,3,1361.94,2,3,4,9
1515915625538120950,110,1,45.24,2,1,2,5
1515915625538123909,77,1,130.0,2,1,3,6
1515915625538124666,110,1,119.7,2,1,3,6
1515915625538124807,110,1,33.97,2,1,2,5
1515915625538128274,101,1,58.78,2,1,2,5
1515915625538135314,110,1,136.83,2,1,3,6
1515915625538136050,110,1,73.97,2,1,2,5
1515915625538137310,108,1,29.52,2,1,1,4
1515915625538139756,88,15,287.3,2,4,3,9
1515915625538140025,20,1,120.06,4,1,3,8
1515915625538140723,110,1,27.62,2,1,1,4
1515915625538141324,110,1,52.94,2,1,2,5
1515915625538144796,110,1,26.46,2,1,1,4
1515915625538148914,110,1,32.81,2,1,2,5
1515915625538148948,110,4,102.97999999999999,2,3,3,8
1515915625538156344,110,3,188.78000000000003,2,3,3,8
1515915625538157897,110,2,34.28,2,2,2,6
1515915625538163247,110,2,56.2,2,2,2,6
1515915625538165756,110,1,9.35,2,1,1,4
1515915625538170736,66,1,22.22,3,1,1,5
1515915625538173588,110,2,168.92,2,2,3,7
1515915625538173789,110,1,21.75,2,1,1,4
1515915625538177438,110,6,219.91,2,4,3,9
1515915625538177440,110,1,103.24,2,1,3,6
1515915625538178189,16,2,214.92,4,2,3,9
1515915625538182733,110,4,239.5,2,3,3,8
1515915625538183012,108,1,453.98,2,1,4,7
1515915625538185093,110,9,2344.44,2,4,4,10
1515915625538185640,110,3,12.98,2,3,1,6
1515915625538188052,110,2,221.9,2,2,3,7
1515915625538189543,109,22,2191.18,2,4,4,10
1515915625538194218,110,1,199.37,2,1,3,6
1515915625538196071,43,1,192.51,3,1,3,7
1515915625538198487,110,1,109.65,2,1,3,6
1515915625538198735,110,1,26.46,2,1,1,4
1515915625538199897,109,3,328.95000000000005,2,3,4,9
1515915625538205258,110,1,64.48,2,1,2,5
1515915625538209648,110,3,29.52,2,3,1,6
1515915625538212379,110,2,142.58,2,2,3,7
1515915625538215589,110,1,25.4,2,1,1,4
1515915625538215874,110,2,3.14,2,2,1,5
1515915625538217380,110,1,17.46,2,1,1,4
1515915625538220955,110,1,43.11,2,1,2,5
1515915625538222740,109,1,8.29,2,1,1,4
1515915625538223744,81,2,20.86,2,2,1,5
1515915625538224116,109,6,1462.8,2,4,4,10
1515915625538225329,109,1,22.79,2,1,1,4
1515915625538229818,110,1,16.7,2,1,1,4
1515915625538230057,110,1,24.6,2,1,1,4
1515915625538237461,110,1,403.46,2,1,4,7
1515915625538237816,108,1,9.0,2,1,1,4
1515915625538242472,110,2,26.04,2,2,1,5
1515915625538248753,96,1,26.46,2,1,1,4
1515915625538251725,110,1,26.57,2,1,1,4
1515915625538252565,110,1,17.29,2,1,1,4
1515915625538252652,108,3,1160.4,2,3,4,9
1515915625538254360,101,3,1192.44,2,3,4,9
1515915625538262209,110,8,227.28,2,4,3,9
1515915625538264908,110,2,45.019999999999996,2,2,2,6
1515915625538264966,110,2,81.26,2,2,2,6
1515915625538267636,107,3,153.32999999999998,2,3,3,8
1515915625538272316,110,1,183.75,2,1,3,6
1515915625538272639,106,1,56.27,2,1,2,5
1515915625538273285,110,1,16.19,2,1,1,4
1515915625538274745,110,2,80.38,2,2,2,6
1515915625538276813,110,2,73.18,2,2,2,6
1515915625538278324,110,1,153.03,2,1,3,6
1515915625538279430,93,1,15.08,2,1,1,4
1515915625538281199,110,2,58.42,2,2,2,6
1515915625538281967,110,1,82.97,2,1,2,5
1515915625538282568,104,2,70.13,2,2,2,6
1515915625538282795,110,1,328.7,2,1,4,7
1515915625538283756,109,1,24.6,2,1,1,4
1515915625538285617,110,1,153.03,2,1,3,6
1515915625538287533,103,6,627.04,2,4,4,10
1515915625538291482,110,1,29.22,2,1,1,4
1515915625538291959,110,1,57.62,2,1,2,5
1515915625538294282,59,1,365.38,3,1,4,8
1515915625538294342,110,1,117.3,2,1,3,6
1515915625538295614,110,1,292.83,2,1,4,7
1515915625538296255,110,3,1246.6200000000001,2,3,4,9
1515915625538297658,50,1,33.08,3,1,2,6
1515915625538297942,110,3,78.57000000000001,2,3,2,7
1515915625538300518,110,1,177.95,2,1,3,6
1515915625538306801,110,1,100.75,2,1,3,6
1515915625538307673,110,2,30.6,2,2,1,5
1515915625538311268,110,2,63.18,2,2,2,6
1515915625538312847,110,1,210.62,2,1,3,6
1515915625538313212,28,9,4041.33,4,4,4,12
1515915625538314821,104,1,54.29,2,1,2,5
1515915625538321161,102,1,224.76,2,1,3,6
1515915625538324371,109,2,548.8,2,2,4,8
1515915625538325486,110,1,274.4,2,1,3,6
1515915625538326610,110,1,136.29,2,1,3,6
1515915625538330692,88,1,21.43,2,1,1,4
1515915625538331633,110,1,284.3,2,1,3,6
1515915625538333885,110,1,57.13,2,1,2,5
1515915625538335444,50,6,280.86,3,4,3,10
1515915625538336324,110,1,264.4,2,1,3,6
1515915625538336661,108,1,229.78,2,1,3,6
1515915625538339130,105,3,165.42,2,3,3,8
1515915625538339371,108,2,92.06,2,2,3,7
1515915625538342917,110,1,12.21,2,1,1,4
1515915625538345998,110,1,164.33,2,1,3,6
1515915625538348574,107,1,204.29,2,1,3,6
1515915625538349486,110,3,172.85999999999999,2,3,3,8
1515915625538350171,110,2,26.740000000000002,2,2,1,5
1515915625538350919,109,2,167.19,2,2,3,7
1515915625538351352,103,3,380.04,2,3,4,9
1515915625538355952,109,2,68.96,2,2,2,6
1515915625538357528,110,4,175.76,2,3,3,8
1515915625538371018,109,1,33.97,2,1,2,5
1515915625538382626,109,2,46.34,2,2,2,6
1515915625538388520,109,1,257.87,2,1,3,6
1515915625538394704,109,1,9.68,2,1,1,4
1515915625538399073,109,1,32.22,2,1,1,4
1515915625538400545,89,3,107.60999999999999,2,3,3,8
1515915625538401984,109,1,32.22,2,1,1,4
1515915625538402688,109,1,32.22,2,1,1,4
1515915625538404843,109,2,409.58,2,2,4,8
1515915625538405776,109,1,19.9,2,1,1,4
1515915625538407411,109,1,23.49,2,1,1,4
1515915625538410234,109,1,50.03,2,1,2,5
1515915625538410284,109,3,150.09,2,3,3,8
1515915625538412412,109,3,20.37,2,3,1,6
1515915625538412538,109,3,159.96,2,3,3,8
1515915625538414094,109,1,35.25,2,1,2,5
1515915625538415857,109,1,16.19,2,1,1,4
1515915625538419006,109,1,543.25,2,1,4,7
1515915625538419279,109,1,204.29,2,1,3,6
1515915625538421435,109,1,15.9,2,1,1,4
1515915625538421947,109,1,120.0,2,1,3,6
1515915625538421978,106,1,52.9,2,1,2,5
1515915625538425023,107,1,201.33,2,1,3,6
1515915625538425264,98,1,1019.51,2,1,4,7
1515915625538426078,109,1,395.54,2,1,4,7
1515915625538426139,109,2,38.86,2,2,2,6
1515915625538426667,108,3,461.49,2,3,4,9
1515915625538427058,109,2,55.56,2,2,2,6
1515915625538427698,109,1,27.14,2,1,1,4
1515915625538428784,108,1,15.67,2,1,1,4
1515915625538429660,109,4,104.76,2,3,3,8
1515915625538430591,109,1,69.6,2,1,2,5
1515915625538432057,25,4,57.92,4,3,2,9
1515915625538436113,109,3,40.56,2,3,2,7
1515915625538436999,109,1,26.19,2,1,1,4
1515915625538437096,109,1,25.3,2,1,1,4
1515915625538437970,109,1,176.17,2,1,3,6
1515915625538438339,109,1,30.38,2,1,1,4
1515915625538438967,109,2,1188.38,2,2,4,8
1515915625538441816,109,1,12.08,2,1,1,4
1515915625538443729,109,1,8.79,2,1,1,4
1515915625538446220,80,1,122.86,2,1,3,6
1515915625538448373,109,1,20.27,2,1,1,4
1515915625538451325,109,1,119.19,2,1,3,6
1515915625538452920,100,13,2226.83,2,4,4,10
1515915625538454586,109,3,107.60999999999999,2,3,3,8
1515915625538459527,108,2,52.38,2,2,2,6
1515915625538464263,109,1,43.11,2,1,2,5
1515915625538464398,90,4,817.16,2,3,4,9
1515915625538464871,109,1,18.73,2,1,1,4
1515915625538466813,109,1,10.16,2,1,1,4
1515915625538471148,109,1,97.14,2,1,3,6
1515915625538476318,109,2,30.48,2,2,1,5
1515915625538478381,109,1,10.48,2,1,1,4
1515915625538480427,109,1,13.97,2,1,1,4
1515915625538485935,109,1,15.43,2,1,1,4
1515915625538486225,109,2,18.74,2,2,1,5
1515915625538486569,109,1,72.29,2,1,2,5
1515915625538487629,109,1,240.98,2,1,3,6
1515915625538488079,109,1,26.57,2,1,1,4
1515915625538488828,109,9,175.5,2,4,3,9
1515915625538489013,109,4,88.88,2,3,2,7
1515915625538489922,109,1,1.57,2,1,1,4
1515915625538491442,13,1,132.37,4,1,3,8
1515915625538499734,109,1,314.97,2,1,4,7
1515915625538503726,109,1,35.24,2,1,2,5
1515915625538509559,109,1,15.92,2,1,1,4
1515915625538510446,109,4,77.14,2,3,2,7
1515915625538512627,109,1,1.57,2,1,1,4
1515915625538514245,109,2,151.34,2,2,3,7
1515915625538515482,109,1,42.14,2,1,2,5
1515915625538516017,109,2,398.74,2,2,4,8
1515915625538516338,109,1,28.98,2,1,1,4
1515915625538518510,108,4,295.24,2,3,4,9
1515915625538519212,108,1,73.81,2,1,2,5
1515915625538522431,109,1,172.86,2,1,3,6
1515915625538523711,102,1,19.37,2,1,1,4
1515915625538524485,10,1,63.98,4,1,2,7
1515915625538529282,109,1,87.51,2,1,2,5
1515915625538532420,108,2,708.37,2,2,4,8
1515915625538533052,109,3,71.69999999999999,2,3,2,7
1515915625538534621,109,1,39.75,2,1,2,5
1515915625538535361,109,2,219.3,2,2,3,7
1515915625538535773,101,3,1192.44,2,3,4,9
1515915625538537521,109,1,63.32,2,1,2,5
1515915625538538168,109,2,20.42,2,2,1,5
1515915625538539418,109,1,43.87,2,1,2,5
1515915625538541892,109,3,261.48,2,3,3,8
1515915625538543607,109,1,12.46,2,1,1,4
1515915625538544935,109,3,479.04,2,3,4,9
1515915625538546704,109,1,292.83,2,1,4,7
1515915625538548557,109,1,38.73,2,1,2,5
1515915625538548688,109,1,215.06,2,1,3,6
1515915625538549182,109,1,10.32,2,1,1,4
1515915625538549468,109,2,52.38,2,2,2,6
1515915625538549757,109,2,27.24,2,2,1,5
1515915625538549805,109,1,40.9,2,1,2,5
1515915625538554181,109,1,20.13,2,1,1,4
1515915625538555954,109,1,9.79,2,1,1,4
1515915625538556121,109,1,23.65,2,1,1,4
1515915625538558157,109,1,68.05,2,1,2,5
1515915625538562554,109,3,368.58,2,3,4,9
1515915625538563228,109,1,16.67,2,1,1,4
1515915625538564491,109,1,13.02,2,1,1,4
1515915625538568069,109,1,50.17,2,1,2,5
1515915625538571820,109,1,40.9,2,1,2,5
1515915625538574020,109,1,331.59,2,1,4,7
1515915625538574101,109,2,52.92,2,2,2,6
1515915625538575554,105,1,164.62,2,1,3,6
1515915625538575764,109,1,155.1,2,1,3,6
1515915625538580178,109,1,133.03,2,1,3,6
1515915625538590759,108,7,754.5300000000001,2,4,4,10
1515915625538592014,109,1,201.33,2,1,3,6
1515915625538596250,109,2,402.66,2,2,4,8
1515915625538600870,109,2,666.66,2,2,4,8
1515915625538603707,109,4,244.64,2,3,3,8
1515915625538604651,109,2,47.4,2,2,2,6
1515915625538605436,109,1,94.86,2,1,3,6
1515915625538608711,105,4,193.08,2,3,3,8
1515915625538611875,53,3,87.66,3,3,2,8
1515915625538615918,109,2,600.74,2,2,4,8
1515915625538620541,109,1,53.17,2,1,2,5
1515915625538622848,109,1,274.4,2,1,3,6
1515915625538626799,108,5,570.65,2,4,4,10
1515915625538627382,108,1,404.49,2,1,4,7
1515915625538631208,109,3,799.18,2,3,4,9
1515915625538632332,19,4,907.36,4,3,4,11
1515915625538635233,102,1,18.76,2,1,1,4
1515915625538638839,109,4,1137.28,2,3,4,9
1515915625538642951,109,1,29.52,2,1,1,4
1515915625538643466,13,2,405.34,4,2,4,10
1515915625538644941,109,1,13.86,2,1,1,4
1515915625538648011,109,1,44.13,2,1,2,5
1515915625538648671,109,2,138.7,2,2,3,7
1515915625538654235,109,1,118.57,2,1,3,6
1515915625538654875,109,2,254.86,2,2,3,7
1515915625538656059,103,4,124.44,2,3,3,8
1515915625538658066,106,2,235.5,2,2,3,7
1515915625538665306,109,1,46.98,2,1,2,5
1515915625538669654,84,1,33.87,2,1,2,5
1515915625538674882,109,1,115.1,2,1,3,6
1515915625538676155,109,1,117.75,2,1,3,6
1515915625538678265,90,1,41.9,2,1,2,5
1515915625538678366,109,1,43.11,2,1,2,5
1515915625538678826,108,3,179.13,2,3,3,8
1515915625538680455,109,2,80.82,2,2,2,6
1515915625538681434,107,5,175.03,2,4,3,9
1515915625538685904,109,1,227.3,2,1,3,6
1515915625538689777,109,1,42.98,2,1,2,5
1515915625538689872,109,1,172.86,2,1,3,6
1515915625538691576,109,2,232.1,2,2,3,7
1515915625538692132,81,2,64.44,2,2,2,6
1515915625538698338,109,2,177.78,2,2,3,7
1515915625538698701,109,1,10.98,2,1,1,4
1515915625538701778,109,1,5.46,2,1,1,4
1515915625538702949,109,1,471.52,2,1,4,7
1515915625538705557,109,1,82.97,2,1,2,5
1515915625538705988,109,1,22.22,2,1,1,4
1515915625538708800,109,1,15.62,2,1,1,4
1515915625538711624,109,1,15.6,2,1,1,4
1515915625538715792,109,2,32.38,2,2,2,6
1515915625538716637,105,1,32.06,2,1,1,4
1515915625538718221,109,1,16.19,2,1,1,4
1515915625538719071,109,1,52.49,2,1,2,5
1515915625538723177,108,1,163.52,2,1,3,6
1515915625538724202,109,1,5.46,2,1,1,4
1515915625538724348,109,2,89.37,2,2,2,6
1515915625538724453,107,3,31.89,2,3,1,6
1515915625538724497,108,3,527.13,2,3,4,9
1515915625538725478,108,2,175.02,2,2,3,7
1515915625538726809,108,6,273.36,2,4,3,9
1515915625538726880,101,1,37.9,2,1,2,5
1515915625538730036,109,1,39.75,2,1,2,5
1515915625538730551,108,2,24.44,2,2,1,5
1515915625538734590,109,1,314.97,2,1,4,7
1515915625538738370,109,2,237.48,2,2,3,7
1515915625538745102,109,1,478.52,2,1,4,7
1515915625538746608,108,2,65.4,2,2,2,6
1515915625538754666,108,2,526.8,2,2,4,8
1515915625538756830,108,3,27.0,2,3,1,6
1515915625538759451,108,1,16.35,2,1,1,4
1515915625538765674,108,2,1285.24,2,2,4,8
1515915625538767443,108,1,34.46,2,1,2,5
1515915625538779067,63,2,780.0,3,2,4,9
1515915625538779392,99,2,116.97999999999999,2,2,3,7
1515915625538785924,108,3,209.22,2,3,3,8
1515915625538786530,108,3,368.58,2,3,4,9
1515915625538787614,108,1,103.83,2,1,3,6
1515915625538789285,108,1,117.75,2,1,3,6
1515915625538789814,108,1,462.56,2,1,4,7
1515915625538794519,108,2,33.66,2,2,2,6
1515915625538794761,108,1,15.56,2,1,1,4
1515915625538795051,108,1,1.57,2,1,1,4
1515915625538797063,108,2,70.2,2,2,2,6
1515915625538800687,108,1,193.54,2,1,3,6
1515915625538800945,108,1,30.48,2,1,1,4
1515915625538801151,108,2,762.92,2,2,4,8
1515915625538801986,108,1,71.75,2,1,2,5
1515915625538808882,108,2,31.04,2,2,1,5
1515915625538810982,108,1,82.52,2,1,2,5
1515915625538814639,108,2,24.92,2,2,1,5
1515915625538815169,103,3,165.48,2,3,3,8
1515915625538815627,108,1,48.81,2,1,2,5
1515915625538817186,108,1,14.79,2,1,1,4
1515915625538822546,108,3,368.58,2,3,4,9
1515915625538827489,108,2,46.82,2,2,2,6
1515915625538832690,108,1,86.13,2,1,2,5
1515915625538832851,108,1,82.97,2,1,2,5
1515915625538834473,108,3,168.81,2,3,3,8
1515915625538835545,95,3,486.44,2,3,4,9
1515915625538838040,108,1,195.59,2,1,3,6
1515915625538841137,108,2,36.0,2,2,2,6
1515915625538842570,108,2,7.72,2,2,1,5
1515915625538844410,108,1,10.24,2,1,1,4
1515915625538847447,108,1,11.43,2,1,1,4
1515915625538847968,108,1,78.3,2,1,2,5
1515915625538848589,108,1,52.33,2,1,2,5
1515915625538849173,76,3,408.15000000000003,2,3,4,9
1515915625538851390,108,1,172.86,2,1,3,6
1515915625538852799,108,1,224.76,2,1,3,6
1515915625538860084,108,1,230.35,2,1,3,6
1515915625538865262,52,1,567.79,3,1,4,8
1515915625538866798,108,2,53.96,2,2,2,6
1515915625538867435,108,1,149.05,2,1,3,6
1515915625538869492,108,1,50.63,2,1,2,5
1515915625538869652,108,4,1045.97,2,3,4,9
1515915625538873141,108,1,103.73,2,1,3,6
1515915625538874596,108,1,153.83,2,1,3,6
1515915625538875408,108,1,153.83,2,1,3,6
1515915625538875823,108,1,153.83,2,1,3,6
1515915625538878776,102,4,244.67,2,3,3,8
1515915625538878999,108,2,375.56,2,2,4,8
1515915625538881252,108,1,292.83,2,1,4,7
1515915625538891174,107,2,125.51,2,2,3,7
1515915625538891977,108,3,158.7,2,3,3,8
1515915625538893990,108,1,292.83,2,1,4,7
1515915625538894423,108,2,3.14,2,2,1,5
1515915625538894776,108,2,126.64,2,2,3,7
1515915625538896170,108,1,31.75,2,1,1,4
1515915625538896374,108,1,116.49,2,1,3,6
1515915625538896465,108,2,143.5,2,2,3,7
1515915625538905544,108,1,9.35,2,1,1,4
1515915625538913153,108,1,236.67,2,1,3,6
1515915625538914402,108,2,165.94,2,2,3,7
1515915625538916732,108,1,32.22,2,1,1,4
1515915625538920728,108,2,339.34,2,2,4,8
1515915625538923160,108,2,193.72,2,2,3,7
1515915625538923473,108,1,180.63,2,1,3,6
1515915625538924191,108,1,629.95,2,1,4,7
1515915625538924392,108,2,40.91,2,2,2,6
1515915625538928592,103,1,45.24,2,1,2,5
1515915625538928811,108,1,25.4,2,1,1,4
1515915625538931089,108,1,10.16,2,1,1,4
1515915625538935349,108,3,1205.24,2,3,4,9
1515915625538935350,4,4,390.61000000000007,4,3,4,11
1515915625538938067,108,1,103.73,2,1,3,6
1515915625538938889,108,1,31.27,2,1,1,4
1515915625538939370,108,1,61.16,2,1,2,5
1515915625538939973,96,1,43.11,2,1,2,5
1515915625538940080,108,3,152.7,2,3,3,8
1515915625538940213,108,1,64.48,2,1,2,5
1515915625538942132,108,1,122.86,2,1,3,6
1515915625538947417,108,1,23.81,2,1,1,4
1515915625538947832,108,1,42.98,2,1,2,5
1515915625538949765,95,9,700.02,2,4,4,10
1515915625538952561,108,2,359.56,2,2,4,8
1515915625538953249,108,2,29.2,2,2,1,5
1515915625538956697,108,1,204.29,2,1,3,6
1515915625538959490,108,5,258.75,2,4,3,9
1515915625538960338,107,3,4.71,2,3,1,6
1515915625538965172,108,1,453.86,2,1,4,7
1515915625538969275,108,3,171.39000000000001,2,3,3,8
1515915625538969572,108,1,284.46,2,1,3,6
1515915625538971785,107,1,25.4,2,1,1,4
1515915625538972161,108,1,134.13,2,1,3,6
1515915625538974353,108,2,73.96,2,2,2,6
1515915625538978179,108,1,32.22,2,1,1,4
1515915625538979306,95,2,395.88,2,2,4,8
1515915625538981109,108,2,226.02999999999997,2,2,3,7
1515915625538981990,108,1,399.43,2,1,4,7
1515915625538983772,108,1,82.33,2,1,2,5
1515915625538986611,42,1,15.87,3,1,1,5
1515915625538991226,108,1,9.84,2,1,1,4
1515915625538992552,108,1,10.43,2,1,1,4
1515915625538992736,108,1,20.19,2,1,1,4
1515915625538993787,108,1,37.46,2,1,2,5
1515915625538996052,108,3,104.28999999999999,2,3,3,8
1515915625538998695,95,4,104.76,2,3,3,8
1515915625539001009,108,1,35.56,2,1,2,5
1515915625539001228,104,2,64.44,2,2,2,6
1515915625539001788,102,3,442.14,2,3,4,9
1515915625539004062,78,1,12.78,2,1,1,4
1515915625539013155,108,1,13.17,2,1,1,4
1515915625539016672,108,3,71.28,2,3,2,7
1515915625539018550,108,3,779.8199999999999,2,3,4,9
1515915625539022618,108,1,64.48,2,1,2,5
1515915625539026262,108,1,31.57,2,1,1,4
1515915625539031991,107,2,23.8,2,2,1,5
1515915625539032526,108,1,21.21,2,1,1,4
1515915625539034824,105,4,104.76,2,3,3,8
1515915625539037174,108,1,33.86,2,1,2,5
1515915625539038383,108,3,109.53,2,3,3,8
1515915625539039334,103,2,272.1,2,2,3,7
1515915625539041435,7,1,45.87,4,1,2,7
1515915625539046632,108,1,127.48,2,1,3,6
1515915625539046692,108,4,69.88,2,3,2,7
1515915625539047176,107,2,322.6,2,2,4,8
1515915625539048488,108,1,56.38,2,1,2,5
1515915625539051341,108,1,18.89,2,1,1,4
1515915625539054810,108,1,166.03,2,1,3,6
1515915625539057068,108,1,482.76,2,1,4,7
1515915625539057619,108,2,253.36,2,2,3,7
1515915625539059030,108,1,259.38,2,1,3,6
1515915625539060203,108,3,98.58,2,3,3,8
1515915625539061448,108,2,144.38,2,2,3,7
1515915625539062487,108,1,9.35,2,1,1,4
1515915625539062540,108,2,100.22,2,2,3,7
1515915625539064119,108,5,120.83,2,4,3,9
1515915625539064215,108,4,207.92,2,3,3,8
1515915625539066457,108,1,257.87,2,1,3,6
1515915625539066569,108,2,42.86,2,2,2,6
1515915625539068338,108,2,52.92,2,2,2,6
1515915625539070206,108,1,294.41,2,1,4,7
1515915625539072229,108,1,210.19,2,1,3,6
1515915625539074177,108,2,194.7,2,2,3,7
1515915625539074817,43,2,139.08,3,2,3,8
1515915625539076394,22,1,449.51,4,1,4,9
1515915625539080013,108,1,15.08,2,1,1,4
1515915625539082192,108,1,15.08,2,1,1,4
1515915625539083086,108,1,82.97,2,1,2,5
1515915625539084481,108,1,166.03,2,1,3,6
1515915625539087817,108,3,318.96,2,3,4,9
1515915625539089917,107,1,47.78,2,1,2,5
1515915625539090524,108,1,64.29,2,1,2,5
1515915625539095709,108,1,45.56,2,1,2,5
1515915625539102859,108,2,47.94,2,2,2,6
1515915625539113305,108,3,307.38,2,3,4,9
1515915625539113453,108,1,64.48,2,1,2,5
1515915625539119726,107,1,569.59,2,1,4,7
1515915625539137959,107,2,29.2,2,2,1,5
1515915625539144475,107,1,5.0,2,1,1,4
1515915625539144993,107,3,224.49,2,3,3,8
1515915625539145227,107,1,163.52,2,1,3,6
1515915625539146082,107,1,32.22,2,1,1,4
1515915625539150431,106,3,221.43,2,3,3,8
1515915625539158169,107,1,231.75,2,1,3,6
1515915625539160903,107,1,1.57,2,1,1,4
1515915625539164881,107,3,84.57000000000001,2,3,2,7
1515915625539167658,107,1,26.46,2,1,1,4
1515915625539168796,107,4,737.91,2,3,4,9
1515915625539169931,107,1,229.0,2,1,3,6
1515915625539171259,105,1,63.98,2,1,2,5
1515915625539171642,107,1,32.22,2,1,1,4
1515915625539172827,107,1,32.22,2,1,1,4
1515915625539173650,107,2,410.98,2,2,4,8
1515915625539176503,107,1,292.83,2,1,4,7
1515915625539178573,107,2,55.24,2,2,2,6
1515915625539179214,107,1,29.57,2,1,1,4
1515915625539181618,107,1,147.21,2,1,3,6
1515915625539184874,107,1,13.86,2,1,1,4
1515915625539187305,107,1,32.22,2,1,1,4
1515915625539193435,107,1,197.46,2,1,3,6
1515915625539194030,107,1,141.33,2,1,3,6
1515915625539194407,107,1,17.62,2,1,1,4
1515915625539204487,107,1,9.35,2,1,1,4
1515915625539209552,107,1,314.97,2,1,4,7
1515915625539212069,107,3,313.79999999999995,2,3,4,9
1515915625539213383,107,1,82.52,2,1,2,5
1515915625539216415,107,1,127.08,2,1,3,6
1515915625539216520,107,1,230.0,2,1,3,6
1515915625539217208,105,5,105.55,2,4,3,9
1515915625539222831,107,2,64.44,2,2,2,6
1515915625539226185,105,1,77.11,2,1,2,5
1515915625539226322,107,1,14.19,2,1,1,4
1515915625539227772,107,2,87.18,2,2,2,6
1515915625539228856,105,8,747.44,2,4,4,10
1515915625539230087,107,2,398.74,2,2,4,8
1515915625539234362,92,4,473.81,2,3,4,9
1515915625539244541,107,1,13.81,2,1,1,4
1515915625539248261,107,1,63.02,2,1,2,5
1515915625539252766,107,1,122.86,2,1,3,6
1515915625539253331,107,1,468.1,2,1,4,7
1515915625539256229,107,1,51.52,2,1,2,5
1515915625539256674,107,1,26.46,2,1,1,4
1515915625539257120,107,1,214.1,2,1,3,6
1515915625539261976,106,1,77.73,2,1,2,5
1515915625539264043,107,1,607.92,2,1,4,7
1515915625539264490,107,2,18.7,2,2,1,5
1515915625539270681,107,1,26.19,2,1,1,4
1515915625539271919,107,1,19.52,2,1,1,4
1515915625539273053,104,1,5.75,2,1,1,4
1515915625539276224,101,4,140.32,2,3,3,8
1515915625539278606,107,1,103.48,2,1,3,6
1515915625539279532,105,5,140.39999999999998,2,4,3,9
1515915625539280784,107,1,600.6,2,1,4,7
1515915625539283688,107,1,603.62,2,1,4,7
1515915625539286508,107,2,566.77,2,2,4,8
1515915625539286697,107,1,268.17,2,1,3,6
1515915625539289965,107,1,15.1,2,1,1,4
1515915625539290414,107,1,229.38,2,1,3,6
1515915625539291030,107,1,47.46,2,1,2,5
1515915625539292063,87,3,732.87,2,3,4,9
1515915625539296005,107,3,778.14,2,3,4,9
1515915625539297236,107,1,3.54,2,1,1,4
1515915625539299548,107,1,24.13,2,1,1,4
1515915625539301136,107,1,56.38,2,1,2,5
1515915625539304035,92,1,144.51,2,1,3,6
1515915625539307941,107,2,31.4,2,2,1,5
1515915625539314272,107,1,16.98,2,1,1,4
1515915625539316032,107,1,314.97,2,1,4,7
1515915625539318381,91,3,88.71000000000001,2,3,2,7
1515915625539318822,107,2,209.2,2,2,3,7
1515915625539319024,107,1,134.13,2,1,3,6
1515915625539319286,107,1,10.16,2,1,1,4
1515915625539323044,107,1,230.48,2,1,3,6
1515915625539323087,107,1,12.35,2,1,1,4
1515915625539323583,107,1,30.95,2,1,1,4
1515915625539327565,107,2,110.32,2,2,3,7
1515915625539328135,107,1,3.57,2,1,1,4
1515915625539332238,107,2,45.26,2,2,2,6
1515915625539332923,107,1,22.22,2,1,1,4
1515915625539335634,107,1,43.33,2,1,2,5
1515915625539335925,107,1,8.13,2,1,1,4
1515915625539336532,107,1,122.86,2,1,3,6
1515915625539336760,23,1,194.95,4,1,3,8
1515915625539337488,107,1,23.02,2,1,1,4
1515915625539342169,107,1,97.35,2,1,3,6
1515915625539344911,107,2,44.52,2,2,2,6
1515915625539345818,106,1,264.4,2,1,3,6
1515915625539347146,106,2,253.36,2,2,3,7
1515915625539348387,6,2,123.02000000000001,4,2,3,9
1515915625539348947,107,3,127.71000000000001,2,3,3,8
1515915625539351587,107,1,16.98,2,1,1,4
1515915625539351769,107,8,3255.88,2,4,4,10
1515915625539361406,107,1,128.79,2,1,3,6
1515915625539363999,107,5,65.1,2,4,2,8
1515915625539365416,107,1,177.95,2,1,3,6
1515915625539365882,107,2,23.8,2,2,1,5
1515915625539368408,68,1,21.35,3,1,1,5
1515915625539368602,107,1,87.16,2,1,2,5
1515915625539370532,107,1,202.67,2,1,3,6
1515915625539371727,107,3,422.58000000000004,2,3,4,9
1515915625539372972,107,3,124.77000000000001,2,3,3,8
1515915625539373452,107,2,64.44,2,2,2,6
1515915625539377564,106,2,49.88,2,2,2,6
1515915625539377916,101,1,13.97,2,1,1,4
1515915625539380913,107,1,36.67,2,1,2,5
1515915625539383308,107,2,151.34,2,2,3,7
1515915625539385052,107,1,14.19,2,1,1,4
1515915625539386320,107,1,13.17,2,1,1,4
1515915625539390705,89,6,800.87,2,4,4,10
1515915625539390898,107,3,91.94999999999999,2,3,3,8
1515915625539393059,107,1,52.9,2,1,2,5
1515915625539393328,107,1,32.22,2,1,1,4
1515915625539395200,107,1,13.29,2,1,1,4
1515915625539395537,107,1,256.81,2,1,3,6
1515915625539396918,58,1,104.17,3,1,3,7
1515915625539397019,72,7,479.98999999999995,3,4,4,11
1515915625539397441,66,3,183.14999999999998,3,3,3,9
1515915625539401058,100,2,883.68,2,2,4,8
1515915625539401688,107,1,163.52,2,1,3,6
1515915625539402217,107,1,64.48,2,1,2,5
1515915625539402528,107,2,24.8,2,2,1,5
1515915625539403336,107,1,48.84,2,1,2,5
1515915625539407204,107,1,19.05,2,1,1,4
1515915625539410138,107,2,130.16,2,2,3,7
1515915625539414062,107,2,52.92,2,2,2,6
1515915625539421139,107,1,31.75,2,1,1,4
1515915625539426769,107,1,13.33,2,1,1,4
1515915625539427421,61,4,42.52,3,3,2,8
1515915625539429138,107,2,64.44,2,2,2,6
1515915625539431928,107,1,72.98,2,1,2,5
1515915625539433904,107,2,35.19,2,2,2,6
1515915625539440520,107,1,10.87,2,1,1,4
1515915625539441005,105,3,380.04,2,3,4,9
1515915625539445200,107,1,163.52,2,1,3,6
1515915625539450081,107,1,203.02,2,1,3,6
1515915625539450365,107,1,94.41,2,1,3,6
1515915625539450694,107,1,81.0,2,1,2,5
1515915625539450905,107,1,90.73,2,1,3,6
1515915625539470453,105,3,518.58,2,3,4,9
1515915625539482380,26,1,104.46,4,1,3,8
1515915625539487753,106,1,231.24,2,1,3,6
1515915625539488638,106,4,85.34,2,3,2,7
1515915625539489222,106,2,54.5,2,2,2,6
1515915625539490707,106,1,43.11,2,1,2,5
1515915625539492066,105,2,144.76,2,2,3,7
1515915625539492677,100,17,4852.82,2,4,4,10
1515915625539494246,106,1,11.57,2,1,1,4
1515915625539498700,32,1,126.68,4,1,3,8
1515915625539504377,92,1,180.73,2,1,3,6
1515915625539505659,106,1,10.24,2,1,1,4
1515915625539507774,106,1,18.73,2,1,1,4
1515915625539511756,106,1,55.16,2,1,2,5
1515915625539515658,106,4,140.27999999999997,2,3,3,8
1515915625539522366,106,1,1.57,2,1,1,4
1515915625539530290,106,1,21.11,2,1,1,4
1515915625539531313,98,3,78.57000000000001,2,3,2,7
1515915625539532315,106,1,29.22,2,1,1,4
1515915625539534672,106,1,56.51,2,1,2,5
1515915625539534834,106,1,21.59,2,1,1,4
1515915625539535727,106,1,12.97,2,1,1,4
1515915625539543521,106,1,55.16,2,1,2,5
1515915625539544127,106,1,17.46,2,1,1,4
1515915625539545728,106,1,17.13,2,1,1,4
1515915625539555369,106,1,19.37,2,1,1,4
1515915625539558908,106,1,16.19,2,1,1,4
1515915625539567558,106,1,94.06,2,1,3,6
1515915625539570132,13,7,164.99,4,4,3,11
1515915625539570514,106,1,179.94,2,1,3,6
1515915625539572121,106,2,108.03999999999999,2,2,3,7
1515915625539572337,64,1,43.11,3,1,2,6
1515915625539572871,106,1,23.49,2,1,1,4
1515915625539574843,106,1,32.22,2,1,1,4
1515915625539575047,106,1,22.86,2,1,1,4
1515915625539577214,105,2,907.96,2,2,4,8
1515915625539577251,76,3,69.04,2,3,2,7
1515915625539581198,106,1,21.21,2,1,1,4
1515915625539582954,106,1,31.16,2,1,1,4
1515915625539583795,106,1,7.71,2,1,1,4
1515915625539585806,106,1,97.57,2,1,3,6
1515915625539587128,52,4,2058.2,3,3,4,10
1515915625539588527,33,2,272.38,4,2,3,9
1515915625539591395,106,1,26.83,2,1,1,4
1515915625539591592,103,1,51.9,2,1,2,5
1515915625539595994,106,1,56.14,2,1,2,5
1515915625539597473,103,9,677.61,2,4,4,10
1515915625539597902,59,6,1324.32,3,4,4,11
1515915625539613797,106,1,23.81,2,1,1,4
1515915625539616156,106,4,381.9,2,3,4,9
1515915625539616389,106,1,32.97,2,1,2,5
1515915625539617306,26,1,600.6,4,1,4,9
1515915625539617846,106,1,89.37,2,1,2,5
1515915625539621420,106,1,54.52,2,1,2,5
1515915625539621464,106,1,50.11,2,1,2,5
1515915625539621914,106,2,64.44,2,2,2,6
1515915625539622593,106,1,57.62,2,1,2,5
1515915625539629002,106,2,107.8,2,2,3,7
1515915625539629221,106,1,34.44,2,1,2,5
1515915625539633618,106,1,40.41,2,1,2,5
1515915625539633836,106,4,23.439999999999998,2,3,1,6
1515915625539634039,106,1,12.46,2,1,1,4
1515915625539635733,106,2,13.790000000000001,2,2,1,5
1515915625539636464,106,2,58.44,2,2,2,6
1515915625539638201,14,9,2006.97,4,4,4,12
1515915625539644767,106,1,83.97,2,1,2,5
1515915625539645360,106,3,233.19,2,3,3,8
1515915625539646142,106,1,26.67,2,1,1,4
1515915625539646553,106,1,16.98,2,1,1,4
1515915625539647224,106,4,532.12,2,3,4,9
1515915625539648169,28,3,179.94,4,3,3,10
1515915625539653769,5,7,459.01,4,4,4,12
1515915625539658557,106,1,23.48,2,1,1,4
1515915625539658590,106,1,26.46,2,1,1,4
1515915625539658878,106,1,133.02,2,1,3,6
1515915625539659303,106,1,53.51,2,1,2,5
1515915625539665456,106,1,14.08,2,1,1,4
1515915625539668158,106,1,12.44,2,1,1,4
1515915625539671684,106,1,110.67,2,1,3,6
1515915625539674252,102,1,32.71,2,1,2,5
1515915625539675493,105,2,68.88,2,2,2,6
1515915625539678675,106,1,1800.35,2,1,4,7
1515915625539680431,106,1,113.81,2,1,3,6
1515915625539691926,62,1,29.68,3,1,1,5
1515915625539692595,106,1,16.19,2,1,1,4
1515915625539694305,106,2,188.82,2,2,3,7
1515915625539694883,106,2,128.46,2,2,3,7
1515915625539699526,103,2,58.92,2,2,2,6
1515915625539700278,106,1,32.37,2,1,2,5
1515915625539701556,106,2,156.28,2,2,3,7
1515915625539705591,106,1,30.16,2,1,1,4
1515915625539717190,106,1,9.79,2,1,1,4
1515915625539719098,106,7,83.02,2,4,2,8
1515915625539722118,106,1,12.43,2,1,1,4
1515915625539722869,106,2,135.56,2,2,3,7
1515915625539740549,106,1,9.84,2,1,1,4
1515915625539741447,106,3,35.099999999999994,2,3,2,7
1515915625539741517,105,2,165.94,2,2,3,7
1515915625539742131,106,5,54.349999999999994,2,4,2,8
1515915625539744782,105,2,402.66,2,2,4,8
1515915625539750660,106,3,233.19,2,3,3,8
1515915625539751268,106,1,399.48,2,1,4,7
1515915625539752163,100,1,67.35,2,1,2,5
1515915625539757967,106,2,20.86,2,2,1,5
1515915625539758656,106,2,34.58,2,2,2,6
1515915625539762154,106,1,86.54,2,1,2,5
1515915625539763970,106,1,59.44,2,1,2,5
1515915625539764944,105,2,195.88,2,2,3,7
1515915625539767263,76,3,45.24,2,3,2,7
1515915625539769228,100,2,405.4,2,2,4,8
1515915625539771566,79,4,310.92,2,3,4,9
1515915625539773416,106,1,52.44,2,1,2,5
1515915625539776903,106,1,38.83,2,1,2,5
1515915625539777777,106,1,26.35,2,1,1,4
1515915625539781128,105,2,52.92,2,2,2,6
1515915625539785872,106,6,1723.53,2,4,4,10
1515915625539791425,106,2,154.82,2,2,3,7
1515915625539794272,106,1,18.11,2,1,1,4
1515915625539796049,106,1,21.9,2,1,1,4
1515915625539797284,106,2,18.7,2,2,1,5
1515915625539798509,106,1,21.59,2,1,1,4
1515915625539799051,106,2,56.2,2,2,2,6
1515915625539800854,106,1,126.68,2,1,3,6
1515915625539803822,60,1,33.19,3,1,2,6
1515915625539804588,33,3,124.10000000000001,4,3,3,10
1515915625539812001,106,1,10.63,2,1,1,4
1515915625539813147,63,1,24.08,3,1,1,5
1515915625539813169,106,1,204.29,2,1,3,6
1515915625539833391,106,2,18.7,2,2,1,5
1515915625539835088,103,8,357.68,2,4,4,10
1515915625539837655,106,3,268.20000000000005,2,3,3,8
1515915625539839664,106,1,119.03,2,1,3,6
1515915625539845852,106,1,32.22,2,1,1,4
1515915625539855051,105,7,106.59,2,4,3,9
1515915625539856401,97,1,259.38,2,1,3,6
1515915625539857767,27,1,45.49,4,1,2,7
1515915625539864747,103,1,58.11,2,1,2,5
1515915625539867957,105,1,119.19,2,1,3,6
1515915625539871640,105,1,66.27,2,1,2,5
1515915625539874759,98,3,332.85,2,3,4,9
1515915625539879643,98,1,1019.51,2,1,4,7
1515915625539881730,41,2,237.14,3,2,3,8
1515915625539889819,105,1,20.95,2,1,1,4
1515915625539892424,105,1,122.86,2,1,3,6
1515915625539895791,70,1,2.86,3,1,1,5
1515915625539900889,105,1,13.57,2,1,1,4
1515915625539901612,105,1,32.38,2,1,2,5
1515915625539903008,105,1,128.73,2,1,3,6
1515915625539903023,105,1,60.32,2,1,2,5
1515915625539908697,105,2,6.04,2,2,1,5
1515915625539909148,77,2,48.5,2,2,2,6
1515915625539909463,105,1,15.87,2,1,1,4
1515915625539910087,105,1,115.1,2,1,3,6
1515915625539910852,100,1,268.17,2,1,3,6
1515915625539912172,105,1,100.75,2,1,3,6
1515915625539913911,105,1,24.6,2,1,1,4
1515915625539914586,105,1,259.38,2,1,3,6
1515915625539918957,105,2,121.08,2,2,3,7
1515915625539921276,105,1,15.16,2,1,1,4
1515915625539922552,105,1,102.46,2,1,3,6
1515915625539923523,105,1,374.38,2,1,4,7
1515915625539924218,105,6,55.739999999999995,2,4,2,8
1515915625539924269,105,3,1123.1399999999999,2,3,4,9
1515915625539924682,105,1,39.67,2,1,2,5
1515915625539924868,105,1,26.98,2,1,1,4
1515915625539926796,105,1,28.14,2,1,1,4
1515915625539927656,105,1,14.27,2,1,1,4
1515915625539927795,105,2,748.76,2,2,4,8
1515915625539928363,105,3,46.05,2,3,2,7
1515915625539930988,105,1,16.19,2,1,1,4
1515915625539931670,93,1,60.54,2,1,2,5
1515915625539932635,105,2,27.94,2,2,1,5
1515915625539936466,105,1,21.59,2,1,1,4
1515915625539939681,11,1,173.86,4,1,3,8
1515915625539946579,103,2,408.58,2,2,4,8
1515915625539947369,67,1,284.3,3,1,3,7
1515915625539947674,105,3,30.150000000000002,2,3,1,6
1515915625539952882,105,2,50.8,2,2,2,6
1515915625539953497,105,1,133.92,2,1,3,6
1515915625539959443,105,1,9.81,2,1,1,4
1515915625539963595,105,1,95.38,2,1,3,6
1515915625539963748,105,2,10.92,2,2,1,5
1515915625539965825,104,1,11.98,2,1,1,4
1515915625539966993,105,1,78.81,2,1,2,5
1515915625539969754,105,1,140.86,2,1,3,6
1515915625539969894,105,1,21.21,2,1,1,4
1515915625539970394,105,1,122.86,2,1,3,6
1515915625539970674,105,1,397.48,2,1,4,7
1515915625539972405,105,2,10.92,2,2,1,5
1515915625539983996,105,1,122.86,2,1,3,6
1515915625539986023,105,1,55.6,2,1,2,5
1515915625539986034,105,1,24.92,2,1,1,4
1515915625539987181,49,3,1134.42,3,3,4,10
1515915625539991852,104,2,102.66,2,2,3,7
1515915625539991994,105,2,90.48,2,2,2,6
1515915625539992824,105,1,163.52,2,1,3,6
1515915625539994258,105,1,19.05,2,1,1,4
1515915625539999061,105,1,21.75,2,1,1,4
1515915625539999114,104,1,180.73,2,1,3,6
1515915625539999779,105,1,164.33,2,1,3,6
1515915625540000155,105,1,26.19,2,1,1,4
1515915625540003559,105,1,59.62,2,1,2,5
1515915625540005881,105,2,165.94,2,2,3,7
1515915625540008123,105,1,22.41,2,1,1,4
1515915625540008856,105,1,95.52,2,1,3,6
1515915625540009105,105,1,244.29,2,1,3,6
1515915625540012158,105,1,127.48,2,1,3,6
1515915625540015510,105,1,164.33,2,1,3,6
1515915625540016064,105,1,29.22,2,1,1,4
1515915625540018380,103,1,25.06,2,1,1,4
1515915625540018584,105,1,29.57,2,1,1,4
1515915625540018644,105,1,32.4,2,1,2,5
1515915625540018855,105,1,4.14,2,1,1,4
1515915625540021234,105,1,155.1,2,1,3,6
1515915625540025458,105,1,16.92,2,1,1,4
1515915625540026984,105,1,82.38,2,1,2,5
1515915625540027778,91,2,585.66,2,2,4,8
1515915625540028340,64,1,187.78,3,1,3,7
1515915625540030858,103,2,254.96,2,2,3,7
1515915625540033709,105,1,147.13,2,1,3,6
1515915625540034105,105,1,1.57,2,1,1,4
1515915625540038572,102,1,17.73,2,1,1,4
1515915625540038834,105,1,60.32,2,1,2,5
1515915625540040406,105,1,16.35,2,1,1,4
1515915625540040565,105,1,42.98,2,1,2,5
1515915625540041447,105,1,147.13,2,1,3,6
1515915625540045648,105,1,139.87,2,1,3,6
1515915625540046429,105,1,71.02,2,1,2,5
1515915625540048185,101,2,288.78,2,2,4,8
1515915625540048289,105,1,33.17,2,1,2,5
1515915625540049527,105,1,419.46,2,1,4,7
1515915625540051796,105,2,19.68,2,2,1,5
1515915625540056992,105,1,23.17,2,1,1,4
1515915625540057751,93,3,29.52,2,3,1,6
1515915625540061408,101,3,878.49,2,3,4,9
1515915625540061624,105,2,35.8,2,2,2,6
1515915625540066144,105,1,190.03,2,1,3,6
1515915625540068182,63,2,36.5,3,2,2,7
1515915625540068808,105,2,441.2,2,2,4,8
1515915625540069116,105,1,26.19,2,1,1,4
1515915625540071326,105,2,473.94,2,2,4,8
1515915625540071442,105,1,1.57,2,1,1,4
1515915625540073063,105,2,178.8,2,2,3,7
1515915625540077435,105,1,1089.62,2,1,4,7
1515915625540078255,98,3,645.55,2,3,4,9
1515915625540081614,105,1,13.52,2,1,1,4
1515915625540082414,105,3,59.34,2,3,2,7
1515915625540085974,105,1,173.67,2,1,3,6
1515915625540086709,105,1,16.98,2,1,1,4
1515915625540087893,105,1,210.68,2,1,3,6
1515915625540091222,103,3,465.29999999999995,2,3,4,9
1515915625540094014,105,1,113.81,2,1,3,6
1515915625540095203,104,2,38.1,2,2,2,6
1515915625540096942,102,1,43.11,2,1,2,5
1515915625540099387,105,1,21.48,2,1,1,4
1515915625540101589,12,3,612.87,4,3,4,11
1515915625540101895,100,1,57.62,2,1,2,5
1515915625540103143,104,2,56.7,2,2,2,6
1515915625540104317,66,1,43.11,3,1,2,6
1515915625540112770,105,1,26.46,2,1,1,4
1515915625540115513,105,2,50.16,2,2,2,6
1515915625540116677,77,1,52.49,2,1,2,5
1515915625540120115,98,2,50.16,2,2,2,6
1515915625540120355,105,2,112.06,2,2,3,7
1515915625540120485,102,2,245.51999999999998,2,2,3,7
1515915625540122896,105,2,87.14,2,2,2,6
1515915625540127380,105,1,9.84,2,1,1,4
1515915625540128932,105,1,13.17,2,1,1,4
1515915625540130563,105,3,963.1199999999999,2,3,4,9
1515915625540130942,105,5,1151.75,2,4,4,10
1515915625540133262,105,1,164.33,2,1,3,6
1515915625540136880,105,3,147.42000000000002,2,3,3,8
1515915625540137799,105,1,122.86,2,1,3,6
1515915625540142425,105,1,1.57,2,1,1,4
1515915625540143056,105,1,32.86,2,1,2,5
1515915625540143764,105,2,17.18,2,2,1,5
1515915625540143862,105,1,42.38,2,1,2,5
1515915625540144358,88,1,26.19,2,1,1,4
1515915625540148727,105,3,823.1999999999999,2,3,4,9
1515915625540150227,105,1,32.86,2,1,2,5
1515915625540154564,100,3,90.15,2,3,2,7
1515915625540155615,105,1,100.75,2,1,3,6
1515915625540155621,105,1,32.22,2,1,1,4
1515915625540156415,26,2,1074.41,4,2,4,10
1515915625540160671,105,1,36.67,2,1,2,5
1515915625540162768,105,1,10.87,2,1,1,4
1515915625540163453,105,3,1095.75,2,3,4,9
1515915625540163493,104,2,68.88,2,2,2,6
1515915625540163651,41,1,60.83,3,1,2,6
1515915625540165054,105,1,16.19,2,1,1,4
1515915625540168356,46,2,244.8,3,2,3,8
1515915625540168622,105,1,135.87,2,1,3,6
1515915625540169035,105,1,173.67,2,1,3,6
1515915625540170350,105,1,95.21,2,1,3,6
1515915625540176627,105,1,21.43,2,1,1,4
1515915625540178336,102,3,69.99,2,3,2,7
1515915625540179973,105,1,163.81,2,1,3,6
1515915625540182822,105,1,16.51,2,1,1,4
1515915625540182859,105,1,26.46,2,1,1,4
1515915625540186309,104,3,87.66,2,3,2,7
1515915625540191115,105,1,381.46,2,1,4,7
1515915625540192492,70,1,16.98,3,1,1,5
1515915625540194320,90,1,427.75,2,1,4,7
1515915625540195736,4,7,551.88,4,4,4,12
1515915625540196418,105,1,251.92,2,1,3,6
1515915625540197343,105,24,706.26,2,4,4,10
1515915625540199202,105,3,626.54,2,3,4,9
1515915625540201793,105,1,105.14,2,1,3,6
1515915625540202032,105,1,11.86,2,1,1,4
1515915625540203749,105,1,32.22,2,1,1,4
1515915625540209465,104,2,147.62,2,2,3,7
1515915625540209657,105,1,23.49,2,1,1,4
1515915625540211394,104,1,43.81,2,1,2,5
1515915625540221918,103,1,14.62,2,1,1,4
1515915625540222321,105,1,113.17,2,1,3,6
1515915625540222786,101,1,56.27,2,1,2,5
1515915625540223664,105,1,164.33,2,1,3,6
1515915625540228290,104,1,43.11,2,1,2,5
1515915625540236673,104,6,1756.98,2,4,4,10
1515915625540240646,52,2,458.63,3,2,4,9
1515915625540240687,104,1,169.57,2,1,3,6
1515915625540243015,104,1,18.19,2,1,1,4
1515915625540244360,99,5,1325.25,2,4,4,10
1515915625540245412,30,4,104.76,4,3,3,10
1515915625540245832,104,2,795.58,2,2,4,8
1515915625540246009,104,1,34.19,2,1,2,5
1515915625540246446,101,1,144.51,2,1,3,6
1515915625540249237,104,1,26.98,2,1,1,4
1515915625540254676,104,1,43.11,2,1,2,5
1515915625540255592,104,1,18.89,2,1,1,4
1515915625540256218,104,2,3.14,2,2,1,5
1515915625540256397,49,1,26.19,3,1,1,5
1515915625540257769,90,1,107.41,2,1,3,6
1515915625540260567,104,1,33.97,2,1,2,5
1515915625540263371,104,1,253.97,2,1,3,6
1515915625540269903,103,1,32.7,2,1,2,5
1515915625540271188,104,1,53.17,2,1,2,5
1515915625540275280,104,1,17.46,2,1,1,4
1515915625540277249,104,2,112.54,2,2,3,7
1515915625540279634,104,1,3.17,2,1,1,4
1515915625540286935,104,6,142.85999999999999,2,4,3,9
1515915625540287389,104,5,339.44,2,4,4,10
1515915625540287994,104,1,32.22,2,1,1,4
1515915625540293857,104,1,274.4,2,1,3,6
1515915625540298997,104,2,221.9,2,2,3,7
1515915625540300098,104,1,153.05,2,1,3,6
1515915625540302145,82,3,401.61,2,3,4,9
1515915625540302933,104,2,139.42,2,2,3,7
1515915625540303089,104,1,23.65,2,1,1,4
1515915625540305739,104,2,39.52,2,2,2,6
1515915625540307034,103,3,264.42,2,3,3,8
1515915625540309826,55,4,147.48999999999998,3,3,3,9
1515915625540311584,103,5,322.40000000000003,2,4,4,10
1515915625540312191,88,2,788.96,2,2,4,8
1515915625540312781,104,1,183.49,2,1,3,6
1515915625540312836,104,3,89.34,2,3,2,7
1515915625540316129,104,1,99.92,2,1,3,6
1515915625540319024,104,1,57.57,2,1,2,5
1515915625540321239,104,2,59.14,2,2,2,6
1515915625540322939,104,1,13.29,2,1,1,4
1515915625540324244,104,1,11.98,2,1,1,4
1515915625540325831,104,2,60.34,2,2,2,6
1515915625540326262,104,1,30.38,2,1,1,4
1515915625540327003,27,5,75.4,4,4,2,10
1515915625540328224,104,1,9.84,2,1,1,4
1515915625540333333,104,1,149.21,2,1,3,6
1515915625540334912,104,1,92.86,2,1,3,6
1515915625540335275,98,2,52.92,2,2,2,6
1515915625540338167,104,1,52.9,2,1,2,5
1515915625540340127,104,1,110.03,2,1,3,6
1515915625540341084,96,17,898.62,2,4,4,10
1515915625540341895,104,2,52.92,2,2,2,6
1515915625540344449,104,3,129.32999999999998,2,3,3,8
1515915625540345840,104,2,65.34,2,2,2,6
1515915625540347677,104,2,32.38,2,2,2,6
1515915625540350258,102,1,22.86,2,1,1,4
1515915625540352020,104,1,59.11,2,1,2,5
1515915625540352566,104,2,352.34,2,2,4,8
1515915625540353795,104,2,253.36,2,2,3,7
1515915625540359375,104,1,91.27,2,1,3,6
1515915625540359533,104,3,800.25,2,3,4,9
1515915625540360380,104,1,88.83,2,1,2,5
1515915625540360886,104,1,26.46,2,1,1,4
1515915625540362677,88,2,44.44,2,2,2,6
1515915625540364177,104,3,79.53,2,3,2,7
1515915625540365919,104,1,229.38,2,1,3,6
1515915625540367695,104,1,164.33,2,1,3,6
1515915625540368578,103,1,73.81,2,1,2,5
1515915625540371112,104,1,20.0,2,1,1,4
1515915625540371946,104,1,80.06,2,1,2,5
1515915625540379683,104,1,10.21,2,1,1,4
1515915625540381880,104,1,11.13,2,1,1,4
1515915625540384535,104,1,73.68,2,1,2,5
1515915625540385547,104,1,10.87,2,1,1,4
1515915625540388804,104,1,26.46,2,1,1,4
1515915625540389995,104,1,10.87,2,1,1,4
1515915625540390014,94,1,204.29,2,1,3,6
1515915625540390272,83,1,19.37,2,1,1,4
1515915625540391065,73,1,16.11,2,1,1,4
1515915625540391682,99,1,97.35,2,1,3,6
1515915625540394503,104,1,21.75,2,1,1,4
1515915625540396205,104,2,86.22,2,2,2,6
1515915625540396927,104,1,36.83,2,1,2,5
1515915625540399427,104,1,56.27,2,1,2,5
1515915625540408173,103,2,91.46,2,2,3,7
1515915625540412766,104,1,63.33,2,1,2,5
1515915625540417259,104,1,13.87,2,1,1,4
1515915625540418097,104,3,49.050000000000004,2,3,2,7
1515915625540422375,102,2,159.29000000000002,2,2,3,7
1515915625540423451,78,1,14.6,2,1,1,4
1515915625540427262,104,1,71.38,2,1,2,5
1515915625540428026,38,5,854.75,3,4,4,11
1515915625540428176,103,5,494.45,2,4,4,10
1515915625540432984,104,1,46.98,2,1,2,5
1515915625540437466,103,1,26.46,2,1,1,4
1515915625540438589,104,1,49.38,2,1,2,5
1515915625540440148,73,1,9.92,2,1,1,4
1515915625540440610,19,2,38.54,4,2,2,8
1515915625540442730,104,3,37.38,2,3,2,7
1515915625540445561,62,1,257.87,3,1,3,7
1515915625540446013,102,2,144.76,2,2,3,7
1515915625540448391,104,1,67.27,2,1,2,5
1515915625540450252,104,1,177.3,2,1,3,6
1515915625540450564,19,1,26.19,4,1,1,6
1515915625540451710,104,1,37.62,2,1,2,5
1515915625540453020,104,1,12.22,2,1,1,4
1515915625540453500,104,1,393.65,2,1,4,7
1515915625540453501,97,2,110.58,2,2,3,7
1515915625540455737,104,2,397.24,2,2,4,8
1515915625540456536,104,1,31.57,2,1,1,4
1515915625540458882,104,1,226.84,2,1,3,6
1515915625540459319,104,1,74.14,2,1,2,5
1515915625540461821,104,1,20.95,2,1,1,4
1515915625540462875,103,2,79.5,2,2,2,6
1515915625540464736,104,1,15.9,2,1,1,4
1515915625540466804,101,2,515.74,2,2,4,8
1515915625540467819,11,1,214.1,4,1,3,8
1515915625540470412,104,3,140.01,2,3,3,8
1515915625540470497,104,1,13.86,2,1,1,4
1515915625540471169,104,1,16.73,2,1,1,4
1515915625540476426,96,1,21.35,2,1,1,4
1515915625540479992,104,1,107.13,2,1,3,6
1515915625540480954,104,1,24.79,2,1,1,4
1515915625540482888,104,1,14.6,2,1,1,4
1515915625540490356,104,3,61.080000000000005,2,3,2,7
1515915625540495202,104,2,317.12,2,2,4,8
1515915625540495491,104,6,129.78,2,4,3,9
1515915625540500705,104,1,17.73,2,1,1,4
1515915625540501411,104,1,18.44,2,1,1,4
1515915625540503967,103,2,63.5,2,2,2,6
1515915625540510133,93,2,58.44,2,2,2,6
1515915625540510683,99,1,127.08,2,1,3,6
1515915625540512110,104,1,16.98,2,1,1,4
1515915625540513880,104,1,93.43,2,1,3,6
1515915625540515970,104,1,23.81,2,1,1,4
1515915625540517161,104,1,9.84,2,1,1,4
1515915625540520693,104,1,212.06,2,1,3,6
1515915625540521000,104,3,261.69,2,3,3,8
1515915625540523971,103,5,537.05,2,4,4,10
1515915625540527751,104,3,116.25,2,3,3,8
1515915625540529839,104,1,55.6,2,1,2,5
1515915625540532791,104,3,636.1800000000001,2,3,4,9
1515915625540532807,104,2,70.16,2,2,2,6
1515915625540532940,104,1,32.22,2,1,1,4
1515915625540533025,23,1,204.79,4,1,3,8
1515915625540533311,104,1,51.43,2,1,2,5
1515915625540535042,104,1,10.32,2,1,1,4
1515915625540538180,104,1,173.67,2,1,3,6
1515915625540538576,104,1,33.16,2,1,2,5
1515915625540541988,37,3,492.99,3,3,4,10
1515915625540542529,104,1,16.35,2,1,1,4
1515915625540542930,104,1,43.11,2,1,2,5
1515915625540542963,98,16,388.83000000000004,2,4,4,10
1515915625540547518,104,1,168.92,2,1,3,6
1515915625540549192,103,1,82.41,2,1,2,5
1515915625540550569,104,1,43.11,2,1,2,5
1515915625540554015,102,8,785.09,2,4,4,10
1515915625540555694,104,1,34.75,2,1,2,5
1515915625540556936,104,1,26.19,2,1,1,4
1515915625540561721,92,2,943.03,2,2,4,8
1515915625540565098,104,2,30.38,2,2,1,5
1515915625540567621,104,1,65.16,2,1,2,5
1515915625540568900,103,1,826.86,2,1,4,7
1515915625540569994,104,1,53.24,2,1,2,5
1515915625540571882,104,2,235.5,2,2,3,7
1515915625540572063,104,1,292.83,2,1,4,7
1515915625540572358,65,1,257.87,3,1,3,7
1515915625540574755,29,5,1289.35,4,4,4,12
1515915625540576418,98,3,590.01,2,3,4,9
1515915625540580309,104,1,11.98,2,1,1,4
1515915625540580697,104,2,190.12,2,2,3,7
1515915625540581119,104,1,163.52,2,1,3,6
1515915625540586796,36,1,51.68,3,1,2,6
1515915625540587215,104,1,30.1,2,1,1,4
1515915625540587475,103,2,62.54,2,2,2,6
1515915625540594307,104,1,204.29,2,1,3,6
1515915625540596990,104,16,470.84,2,4,4,10
1515915625540597700,104,1,41.51,2,1,2,5
1515915625540602608,104,1,257.87,2,1,3,6
1515915625540604549,104,1,20.0,2,1,1,4
1515915625540606231,97,1,133.92,2,1,3,6
1515915625540609303,103,1,187.29,2,1,3,6
1515915625540611688,103,1,10.33,2,1,1,4
1515915625540615157,101,2,129.62,2,2,3,7
1515915625540619656,64,3,192.44,3,3,3,9
1515915625540622937,103,1,113.81,2,1,3,6
1515915625540623900,103,3,141.06,2,3,3,8
1515915625540625796,103,1,418.48,2,1,4,7
1515915625540627736,103,1,19.87,2,1,1,4
1515915625540632079,103,3,60.989999999999995,2,3,2,7
1515915625540635872,103,4,127.30000000000001,2,3,3,8
1515915625540636674,103,2,34.66,2,2,2,6
1515915625540637493,103,1,34.44,2,1,2,5
1515915625540637706,103,1,121.19,2,1,3,6
1515915625540646254,103,1,34.6,2,1,2,5
1515915625540647500,103,2,760.86,2,2,4,8
1515915625540648616,65,3,402.39,3,3,4,10
1515915625540648755,103,1,11.9,2,1,1,4
1515915625540649717,103,2,410.98,2,2,4,8
1515915625540650746,103,1,172.86,2,1,3,6
1515915625540655298,103,3,38.82,2,3,2,7
1515915625540662458,103,1,33.98,2,1,2,5
1515915625540662816,103,1,33.48,2,1,2,5
1515915625540663080,103,1,43.16,2,1,2,5
1515915625540663763,103,2,64.44,2,2,2,6
1515915625540668700,97,2,49.29,2,2,2,6
1515915625540672106,103,2,105.88,2,2,3,7
1515915625540674585,97,1,50.6,2,1,2,5
1515915625540676263,103,1,73.41,2,1,2,5
1515915625540681903,103,1,172.86,2,1,3,6
1515915625540683741,103,1,13.86,2,1,1,4
1515915625540686234,103,2,79.5,2,2,2,6
1515915625540691348,103,1,70.9,2,1,2,5
1515915625540694620,103,1,15.68,2,1,1,4
1515915625540695089,103,1,89.22,2,1,2,5
1515915625540699840,93,1,202.67,2,1,3,6
1515915625540700730,103,1,9.56,2,1,1,4
1515915625540701309,103,1,11.75,2,1,1,4
1515915625540701978,63,6,702.78,3,4,4,11
1515915625540702012,103,3,45.21,2,3,2,7
1515915625540702858,103,1,11.03,2,1,1,4
1515915625540707129,103,1,1.57,2,1,1,4
1515915625540707204,103,1,46.6,2,1,2,5
1515915625540709438,103,1,15.87,2,1,1,4
1515915625540709516,103,1,122.86,2,1,3,6
1515915625540709845,103,3,27.42,2,3,1,6
1515915625540712285,103,1,11.11,2,1,1,4
1515915625540713009,91,3,598.11,2,3,4,9
1515915625540715537,103,1,43.11,2,1,2,5
1515915625540717976,103,2,24.44,2,2,1,5
1515915625540720059,103,3,1196.1,2,3,4,9
1515915625540720808,103,2,585.66,2,2,4,8
1515915625540732098,103,2,226.76,2,2,3,7
1515915625540736897,102,2,266.06,2,2,3,7
1515915625540738944,103,2,42.42,2,2,2,6
1515915625540739174,103,1,113.17,2,1,3,6
1515915625540740615,103,2,121.66,2,2,3,7
1515915625540741278,103,1,46.67,2,1,2,5
1515915625540746495,91,2,74.0,2,2,2,6
1515915625540747506,103,1,16.43,2,1,1,4
1515915625540749331,103,1,10.87,2,1,1,4
1515915625540752812,103,1,100.33,2,1,3,6
1515915625540754307,103,2,195.88,2,2,3,7
1515915625540755791,76,1,177.59,2,1,3,6
1515915625540757987,103,4,596.2,2,3,4,9
1515915625540763103,103,3,31.77,2,3,1,6
1515915625540764477,103,3,687.0,2,3,4,9
1515915625540767158,103,3,387.66,2,3,4,9
1515915625540767438,103,1,307.76,2,1,4,7
1515915625540767526,68,1,115.71,3,1,3,7
1515915625540768579,103,2,169.78,2,2,3,7
1515915625540769710,103,1,140.86,2,1,3,6
1515915625540775375,103,1,35.19,2,1,2,5
1515915625540776521,103,1,43.11,2,1,2,5
1515915625540778732,103,1,164.33,2,1,3,6
1515915625540780637,102,4,2078.24,2,3,4,9
1515915625540780879,103,1,65.13,2,1,2,5
1515915625540781444,21,2,293.03000000000003,4,2,4,10
1515915625540783086,103,1,29.57,2,1,1,4
1515915625540783567,103,2,34.89,2,2,2,6
1515915625540784037,103,1,75.76,2,1,2,5
1515915625540784603,103,1,75.76,2,1,2,5
1515915625540784954,103,1,9.35,2,1,1,4
1515915625540786740,103,1,10.13,2,1,1,4
1515915625540786780,103,1,43.11,2,1,2,5
1515915625540796946,103,2,103.5,2,2,3,7
1515915625540797699,103,2,246.04,2,2,3,7
1515915625540801921,103,1,249.38,2,1,3,6
1515915625540802123,103,1,44.78,2,1,2,5
1515915625540802704,102,1,55.16,2,1,2,5
1515915625540804459,103,1,6.4,2,1,1,4
1515915625540808844,103,1,29.22,2,1,1,4
1515915625540809729,102,3,4.71,2,3,1,6
1515915625540811061,99,2,515.74,2,2,4,8
1515915625540811381,102,3,83.34,2,3,2,7
1515915625540812560,101,2,248.16,2,2,3,7
1515915625540815940,103,2,434.77,2,2,4,8
1515915625540822292,103,1,44.67,2,1,2,5
1515915625540822383,103,1,212.06,2,1,3,6
1515915625540830771,103,1,188.43,2,1,3,6
1515915625540831164,103,5,79.5,2,4,2,8
1515915625540833414,75,1,15.1,2,1,1,4
1515915625540834407,103,1,220.3,2,1,3,6
1515915625540838897,103,2,27.16,2,2,1,5
1515915625540839238,103,1,14.29,2,1,1,4
1515915625540839659,103,3,119.25,2,3,3,8
1515915625540839934,60,4,747.02,3,3,4,10
1515915625540842210,103,3,55.71,2,3,2,7
1515915625540843040,103,2,907.96,2,2,4,8
1515915625540844886,103,1,87.51,2,1,2,5
1515915625540846246,103,1,147.38,2,1,3,6
1515915625540847959,103,2,328.66,2,2,4,8
1515915625540850833,103,3,45.24,2,3,2,7
1515915625540851892,103,3,39.06,2,3,2,7
1515915625540853163,103,1,8.21,2,1,1,4
1515915625540855366,103,1,81.21,2,1,2,5
1515915625540857510,103,3,42.24,2,3,2,7
1515915625540858118,103,2,71.8,2,2,2,6
1515915625540858891,103,1,170.0,2,1,3,6
1515915625540859088,103,1,107.16,2,1,3,6
1515915625540861078,103,3,259.44,2,3,3,8
1515915625540863641,103,1,53.35,2,1,2,5
1515915625540864649,103,3,66.66,2,3,2,7
1515915625540865175,103,4,1886.08,2,3,4,9
1515915625540866258,103,1,28.1,2,1,1,4
1515915625540870128,103,1,47.21,2,1,2,5
1515915625540873696,103,1,33.65,2,1,2,5
1515915625540874601,103,1,15.92,2,1,1,4
1515915625540875847,103,1,18.57,2,1,1,4
1515915625540875993,103,2,899.02,2,2,4,8
1515915625540876175,103,1,161.3,2,1,3,6
1515915625540876952,103,3,612.87,2,3,4,9
1515915625540877357,25,2,139.54,4,2,3,9
1515915625540879952,103,1,9.21,2,1,1,4
1515915625540882651,103,1,36.51,2,1,2,5
1515915625540882940,103,1,449.51,2,1,4,7
1515915625540883198,20,1,42.86,4,1,2,7
1515915625540883673,103,1,30.48,2,1,1,4
1515915625540883898,103,2,568.6,2,2,4,8
1515915625540883920,103,3,175.71,2,3,3,8
1515915625540888370,103,1,21.21,2,1,1,4
1515915625540889168,103,1,43.11,2,1,2,5
1515915625540889185,102,1,613.73,2,1,4,7
1515915625540894225,103,3,48.57000000000001,2,3,2,7
1515915625540894391,103,1,1213.79,2,1,4,7
1515915625540895618,103,4,45.08,2,3,2,7
1515915625540899205,103,1,13.76,2,1,1,4
1515915625540900376,103,2,155.46,2,2,3,7
1515915625540901088,103,1,50.08,2,1,2,5
1515915625540907599,103,1,45.24,2,1,2,5
1515915625540907765,103,2,46.34,2,2,2,6
1515915625540908975,103,1,82.97,2,1,2,5
1515915625540912462,36,1,20.16,3,1,1,5
1515915625540913260,103,1,2.86,2,1,1,4
1515915625540913884,103,2,165.94,2,2,3,7
1515915625540920282,39,2,585.66,3,2,4,9
1515915625540922876,103,1,224.76,2,1,3,6
1515915625540923753,103,1,19.78,2,1,1,4
1515915625540925035,103,1,81.84,2,1,2,5
1515915625540926368,102,1,486.81,2,1,4,7
1515915625540929491,103,1,32.22,2,1,1,4
1515915625540930268,103,3,33.480000000000004,2,3,2,7
1515915625540937208,103,2,34.64,2,2,2,6
1515915625540937376,97,8,245.2,2,4,3,9
1515915625540938748,102,6,1390.18,2,4,4,10
1515915625540939425,103,2,165.94,2,2,3,7
1515915625540939532,103,5,61.2,2,4,2,8
1515915625540941254,103,2,285.26,2,2,3,7
1515915625540941773,81,2,1162.8,2,2,4,8
1515915625540944581,103,1,331.59,2,1,4,7
1515915625540951568,103,2,56.2,2,2,2,6
1515915625540954005,103,2,56.2,2,2,2,6
1515915625540956116,103,1,205.25,2,1,3,6
1515915625540962611,103,2,21.36,2,2,1,5
1515915625540969189,14,2,568.81,4,2,4,10
1515915625540971187,103,1,63.94,2,1,2,5
1515915625540972086,103,1,154.32,2,1,3,6
1515915625540974541,103,4,506.72,2,3,4,9
1515915625540979418,103,2,83.24,2,2,2,6
1515915625540985121,20,1,73.81,4,1,2,7
1515915625540993357,103,1,184.94,2,1,3,6
1515915625541000778,103,1,34.06,2,1,2,5
1515915625541011788,102,6,127.74,2,4,3,9
1515915625541012358,102,1,24.63,2,1,1,4
1515915625541018805,102,2,143.36,2,2,3,7
1515915625541027840,102,3,108.42,2,3,3,8
1515915625541027844,102,1,108.65,2,1,3,6
1515915625541031163,102,1,202.67,2,1,3,6
1515915625541032620,102,1,29.68,2,1,1,4
1515915625541032662,102,1,16.35,2,1,1,4
1515915625541032717,102,2,19.72,2,2,1,5
1515915625541038388,102,1,15.08,2,1,1,4
1515915625541045677,102,1,71.75,2,1,2,5
1515915625541050805,98,1,117.75,2,1,3,6
1515915625541051462,102,1,89.4,2,1,2,5
1515915625541057292,102,2,55.24,2,2,2,6
1515915625541057671,102,1,19.98,2,1,1,4
1515915625541057719,102,2,20.86,2,2,1,5
1515915625541059890,102,1,45.24,2,1,2,5
1515915625541060779,102,1,274.4,2,1,3,6
1515915625541067229,101,3,60.510000000000005,2,3,2,7
1515915625541067929,102,1,19.49,2,1,1,4
1515915625541068593,102,1,250.38,2,1,3,6
1515915625541069551,102,1,187.7,2,1,3,6
1515915625541071679,102,1,17.3,2,1,1,4
1515915625541072344,96,1,26.19,2,1,1,4
1515915625541073076,102,1,17.49,2,1,1,4
1515915625541074481,102,4,1429.4,2,3,4,9
1515915625541076958,102,1,15.68,2,1,1,4
1515915625541078468,102,2,35.8,2,2,2,6
1515915625541081445,102,2,467.64,2,2,4,8
1515915625541082967,66,1,26.98,3,1,1,5
1515915625541084570,5,3,98.58,4,3,3,10
1515915625541087430,102,1,17.02,2,1,1,4
1515915625541092580,102,2,899.02,2,2,4,8
1515915625541095800,102,1,14.46,2,1,1,4
1515915625541096264,102,1,172.86,2,1,3,6
1515915625541096939,102,1,14.29,2,1,1,4
1515915625541100303,102,1,17.49,2,1,1,4
1515915625541100873,102,1,18.4,2,1,1,4
1515915625541103316,102,2,52.38,2,2,2,6
1515915625541103997,30,2,64.44,4,2,2,8
1515915625541105413,102,1,13.86,2,1,1,4
1515915625541106516,102,5,82.15,2,4,2,8
1515915625541149664,96,1,44.03,2,1,2,5
1515915625541151434,102,2,26.04,2,2,1,5
1515915625541162799,96,4,255.76,2,3,3,8
1515915625541163299,102,1,149.32,2,1,3,6
1515915625541166729,102,3,69.51,2,3,2,7
1515915625541166732,102,1,40.79,2,1,2,5
1515915625541167725,102,1,64.89,2,1,2,5
1515915625541170475,35,1,118.57,4,1,3,8
1515915625541173995,102,3,96.66,2,3,3,8
1515915625541175191,102,1,86.48,2,1,2,5
1515915625541175241,101,1,57.62,2,1,2,5
1515915625541175449,102,1,94.1,2,1,3,6
1515915625541176684,102,2,154.22,2,2,3,7
1515915625541179697,102,1,22.86,2,1,1,4
1515915625541181453,102,1,19.92,2,1,1,4
1515915625541184053,102,1,62.7,2,1,2,5
1515915625541185154,102,1,39.9,2,1,2,5
1515915625541187531,102,2,458.76,2,2,4,8
1515915625541188486,101,2,402.66,2,2,4,8
1515915625541190915,102,1,284.3,2,1,3,6
1515915625541190924,102,2,78.71000000000001,2,2,2,6
1515915625541203995,102,1,49.9,2,1,2,5
1515915625541204542,78,4,226.68,2,3,3,8
1515915625541204917,102,1,203.02,2,1,3,6
1515915625541205842,102,1,48.41,2,1,2,5
1515915625541206580,102,1,13.76,2,1,1,4
1515915625541206604,91,5,173.25,2,4,3,9
1515915625541208444,102,5,157.95,2,4,3,9
1515915625541208502,102,2,233.66,2,2,3,7
1515915625541210504,102,1,26.98,2,1,1,4
1515915625541219808,98,3,47.13,2,3,2,7
1515915625541220138,102,3,96.66,2,3,3,8
1515915625541220439,102,1,43.11,2,1,2,5
1515915625541221325,102,1,104.6,2,1,3,6
1515915625541221880,83,1,529.76,2,1,4,7
1515915625541225672,102,1,127.08,2,1,3,6
1515915625541228313,100,3,241.53000000000003,2,3,3,8
1515915625541228662,101,1,93.37,2,1,3,6
1515915625541228991,91,1,33.08,2,1,2,5
1515915625541236205,102,1,19.22,2,1,1,4
1515915625541237454,102,1,1089.62,2,1,4,7
1515915625541238160,102,1,15.08,2,1,1,4
1515915625541242672,102,2,172.43,2,2,3,7
1515915625541257550,28,1,37.75,4,1,2,7
1515915625541265766,102,1,30.48,2,1,1,4
1515915625541267139,102,1,41.41,2,1,2,5
1515915625541269382,102,1,26.19,2,1,1,4
1515915625541269416,102,1,26.19,2,1,1,4
1515915625541269681,102,1,13.76,2,1,1,4
1515915625541274095,102,1,64.13,2,1,2,5
1515915625541274640,102,1,10.05,2,1,1,4
1515915625541278046,19,3,433.53,4,3,4,11
1515915625541287143,102,1,9.35,2,1,1,4
1515915625541288282,97,1,26.19,2,1,1,4
1515915625541293398,102,1,13.02,2,1,1,4
1515915625541294425,102,1,107.78,2,1,3,6
1515915625541299693,102,1,137.62,2,1,3,6
1515915625541301840,102,3,154.2,2,3,3,8
1515915625541304360,71,1,150.32,3,1,3,7
1515915625541307836,59,2,122.1,3,2,3,8
1515915625541308836,102,1,205.32,2,1,3,6
1515915625541311169,102,1,180.71,2,1,3,6
1515915625541319405,10,1,294.41,4,1,4,9
1515915625541320789,102,2,18.74,2,2,1,5
1515915625541320937,102,1,23.17,2,1,1,4
1515915625541322942,102,1,108.59,2,1,3,6
1515915625541323849,46,4,1586.9099999999999,3,3,4,10
1515915625541326679,102,1,13.52,2,1,1,4
1515915625541329690,100,3,45.24,2,3,2,7
1515915625541330714,97,1,24.6,2,1,1,4
1515915625541332046,102,1,12.22,2,1,1,4
1515915625541335838,102,1,32.22,2,1,1,4
1515915625541337854,102,1,32.22,2,1,1,4
1515915625541339907,102,1,188.41,2,1,3,6
1515915625541351056,101,1,61.29,2,1,2,5
1515915625541357201,102,1,18.25,2,1,1,4
1515915625541362903,101,1,31.27,2,1,1,4
1515915625541363759,102,1,72.38,2,1,2,5
1515915625541365976,102,1,10.9,2,1,1,4
1515915625541368341,88,1,159.68,2,1,3,6
1515915625541370239,59,1,122.97,3,1,3,7
1515915625541372048,102,2,22.22,2,2,1,5
1515915625541372833,101,2,156.6,2,2,3,7
1515915625541381000,102,3,31.29,2,3,1,6
1515915625541381839,102,1,27.62,2,1,1,4
1515915625541385641,102,1,11.81,2,1,1,4
1515915625541389298,97,1,229.38,2,1,3,6
1515915625541391653,88,1,65.73,2,1,2,5
1515915625541392290,102,1,16.98,2,1,1,4
1515915625541393087,71,1,155.1,3,1,3,7
1515915625541393113,102,1,88.33,2,1,2,5
1515915625541394355,102,4,93.32,2,3,3,8
1515915625541394559,102,2,67.3,2,2,2,6
1515915625541398785,101,2,935.23,2,2,4,8
1515915625541399907,102,6,103.53,2,4,3,9
1515915625541400168,91,2,59.04,2,2,2,6
1515915625541400518,102,2,401.68,2,2,4,8
1515915625541402007,101,1,23.22,2,1,1,4
1515915625541406876,45,4,188.32,3,3,3,9
1515915625541408116,102,1,292.83,2,1,4,7
1515915625541410624,102,1,292.83,2,1,4,7
1515915625541410740,16,2,28.96,4,2,1,7
1515915625541414365,101,1,55.87,2,1,2,5
1515915625541421946,102,1,13.65,2,1,1,4
1515915625541424779,102,1,600.6,2,1,4,7
1515915625541425023,102,1,357.46,2,1,4,7
1515915625541428402,100,5,508.35,2,4,4,10
1515915625541429198,96,5,996.85,2,4,4,10
1515915625541431538,98,1,204.6,2,1,3,6
1515915625541431628,101,1,42.68,2,1,2,5
1515915625541432729,81,5,671.97,2,4,4,10
1515915625541433434,102,2,214.32,2,2,3,7
1515915625541438192,102,1,35.05,2,1,2,5
1515915625541439086,102,2,298.1,2,2,4,8
1515915625541443845,102,3,1072.0500000000002,2,3,4,9
1515915625541447216,102,1,82.33,2,1,2,5
1515915625541449489,101,1,64.89,2,1,2,5
1515915625541459454,102,2,101.12,2,2,3,7
1515915625541462065,101,1,204.29,2,1,3,6
1515915625541474004,101,1,164.92,2,1,3,6
1515915625541475912,62,6,741.9000000000001,3,4,4,11
1515915625541481392,101,1,27.62,2,1,1,4
1515915625541484620,101,1,24.92,2,1,1,4
1515915625541487194,101,1,9.84,2,1,1,4
1515915625541491380,101,1,26.98,2,1,1,4
1515915625541492248,101,1,162.51,2,1,3,6
1515915625541492719,101,1,23.81,2,1,1,4
1515915625541495057,101,2,22.54,2,2,1,5
1515915625541496662,101,1,99.25,2,1,3,6
1515915625541498707,101,1,43.11,2,1,2,5
1515915625541499658,101,2,768.94,2,2,4,8
1515915625541506967,98,2,30.049999999999997,2,2,1,5
1515915625541510003,101,1,82.1,2,1,2,5
1515915625541515822,101,1,226.7,2,1,3,6
1515915625541516571,101,10,735.8,2,4,4,10
1515915625541520973,101,1,17.9,2,1,1,4
1515915625541521998,101,2,23.24,2,2,1,5
1515915625541523582,101,1,399.48,2,1,4,7
1515915625541524032,101,1,10.84,2,1,1,4
1515915625541526962,101,1,16.19,2,1,1,4
1515915625541528423,101,1,97.35,2,1,3,6
1515915625541528664,101,1,77.73,2,1,2,5
1515915625541530086,101,1,27.62,2,1,1,4
1515915625541531482,101,1,56.27,2,1,2,5
1515915625541531905,101,6,105.46,2,4,3,9
1515915625541532596,101,1,56.27,2,1,2,5
1515915625541532847,101,3,47.849999999999994,2,3,2,7
1515915625541533744,101,2,104.98,2,2,3,7
1515915625541535479,101,1,10.43,2,1,1,4
1515915625541538863,101,1,32.22,2,1,1,4
1515915625541540729,40,1,210.0,3,1,3,7
1515915625541547862,101,5,645.25,2,4,4,10
1515915625541550440,101,1,104.75,2,1,3,6
1515915625541558236,101,2,264.84000000000003,2,2,3,7
1515915625541561693,101,1,18.87,2,1,1,4
1515915625541561802,101,1,9.68,2,1,1,4
1515915625541562023,101,1,32.22,2,1,1,4
1515915625541562513,101,1,187.29,2,1,3,6
1515915625541563860,101,2,533.5,2,2,4,8
1515915625541575098,101,1,18.3,2,1,1,4
1515915625541575271,101,1,1.57,2,1,1,4
1515915625541575687,13,1,314.97,4,1,4,9
1515915625541576403,94,3,42.87,2,3,2,7
1515915625541577492,101,1,22.22,2,1,1,4
1515915625541577925,101,1,397.48,2,1,4,7
1515915625541578289,85,2,112.38,2,2,3,7
1515915625541586476,101,1,163.7,2,1,3,6
1515915625541591187,101,1,307.76,2,1,4,7
1515915625541593929,79,1,64.48,2,1,2,5
1515915625541595838,101,1,304.41,2,1,4,7
1515915625541598328,101,3,609.0600000000001,2,3,4,9
1515915625541601291,101,1,34.65,2,1,2,5
1515915625541605509,101,3,96.66,2,3,3,8
1515915625541605979,101,1,12.95,2,1,1,4
1515915625541611531,101,2,194.7,2,2,3,7
1515915625541614149,86,8,2084.96,2,4,4,10
1515915625541614762,101,1,3.37,2,1,1,4
1515915625541618353,101,2,6.74,2,2,1,5
1515915625541618409,61,3,1096.23,3,3,4,10
1515915625541618951,101,1,151.29,2,1,3,6
1515915625541619724,49,2,20.32,3,2,1,6
1515915625541621101,101,1,14.08,2,1,1,4
1515915625541625076,101,1,10.71,2,1,1,4
1515915625541629379,101,1,163.52,2,1,3,6
1515915625541630463,101,2,126.66,2,2,3,7
1515915625541632110,101,3,642.24,2,3,4,9
1515915625541632604,101,1,63.33,2,1,2,5
1515915625541633959,97,2,97.25999999999999,2,2,3,7
1515915625541635105,101,1,28.1,2,1,1,4
1515915625541635538,101,2,35.62,2,2,2,6
1515915625541636396,101,1,102.1,2,1,3,6
1515915625541642696,101,3,1345.53,2,3,4,9
1515915625541646109,101,1,169.87,2,1,3,6
1515915625541647796,101,1,26.46,2,1,1,4
1515915625541650540,101,1,1089.62,2,1,4,7
1515915625541651179,101,2,64.76,2,2,2,6
1515915625541655631,101,2,143.5,2,2,3,7
1515915625541657438,101,1,18.41,2,1,1,4
1515915625541660907,101,1,21.43,2,1,1,4
1515915625541663849,101,1,204.29,2,1,3,6
1515915625541667333,101,1,13.81,2,1,1,4
1515915625541670867,101,1,41.32,2,1,2,5
1515915625541671454,98,3,31.44,2,3,1,6
1515915625541671723,95,1,82.97,2,1,2,5
1515915625541676252,101,2,280.72,2,2,3,7
1515915625541678016,101,1,48.43,2,1,2,5
1515915625541682108,98,1,64.48,2,1,2,5
1515915625541688251,101,1,64.48,2,1,2,5
1515915625541689703,97,8,246.48,2,4,3,9
1515915625541694471,101,3,63.46,2,3,2,7
1515915625541699612,101,1,170.78,2,1,3,6
1515915625541701015,101,1,46.98,2,1,2,5
1515915625541707102,101,1,20.0,2,1,1,4
1515915625541709276,101,1,236.0,2,1,3,6
1515915625541709758,101,2,93.62,2,2,3,7
1515915625541715312,84,1,68.37,2,1,2,5
1515915625541722760,101,1,35.24,2,1,2,5
1515915625541728654,101,2,112.54,2,2,3,7
1515915625541735713,101,1,20.56,2,1,1,4
1515915625541735876,101,2,20.06,2,2,1,5
1515915625541742910,10,1,75.29,4,1,2,7
1515915625541743488,99,3,490.56000000000006,2,3,4,9
1515915625541750841,101,1,22.7,2,1,1,4
1515915625541756384,101,1,59.62,2,1,2,5
1515915625541757237,16,1,229.78,4,1,3,8
1515915625541757307,101,2,206.58,2,2,3,7
1515915625541760407,101,1,27.84,2,1,1,4
1515915625541761557,101,1,50.25,2,1,2,5
1515915625541762420,101,1,65.08,2,1,2,5
1515915625541763165,101,1,29.03,2,1,1,4
1515915625541764239,85,2,47.2,2,2,2,6
1515915625541765404,101,1,80.7,2,1,2,5
1515915625541766685,100,1,38.25,2,1,2,5
1515915625541767798,100,1,118.57,2,1,3,6
1515915625541769205,86,3,10.709999999999999,2,3,1,6
1515915625541769677,100,1,15.1,2,1,1,4
1515915625541770124,54,2,24.44,3,2,1,6
1515915625541773440,101,1,292.83,2,1,4,7
1515915625541774269,14,2,196.7,4,2,3,9
1515915625541774442,101,1,23.17,2,1,1,4
1515915625541779938,100,5,301.70000000000005,2,4,4,10
1515915625541780691,100,2,420.38,2,2,4,8
1515915625541781314,58,1,35.05,3,1,2,6
1515915625541784276,101,1,129.84,2,1,3,6
1515915625541788927,101,1,826.86,2,1,4,7
1515915625541789553,101,1,77.56,2,1,2,5
1515915625541793937,101,1,14.43,2,1,1,4
1515915625541794215,8,5,809.4499999999999,4,4,4,12
1515915625541794431,101,3,96.66,2,3,3,8
1515915625541795174,99,1,77.32,2,1,2,5
1515915625541796241,101,1,58.25,2,1,2,5
1515915625541800926,101,4,55.44,2,3,2,7
1515915625541801413,101,1,23.57,2,1,1,4
1515915625541802502,101,1,1.57,2,1,1,4
1515915625541805059,101,1,144.51,2,1,3,6
1515915625541805400,101,1,22.22,2,1,1,4
1515915625541808606,68,1,68.57,3,1,2,6
1515915625541818526,100,3,878.49,2,3,4,9
1515915625541819158,101,1,133.22,2,1,3,6
1515915625541827997,101,1,45.56,2,1,2,5
1515915625541829782,101,2,679.02,2,2,4,8
1515915625541830834,101,1,176.17,2,1,3,6
1515915625541831747,100,1,407.4,2,1,4,7
1515915625541832127,101,1,36.49,2,1,2,5
1515915625541833970,101,1,64.48,2,1,2,5
1515915625541834990,79,1,202.67,2,1,3,6
1515915625541839481,98,2,45.02,2,2,2,6
1515915625541840889,54,1,202.95,3,1,3,7
1515915625541845482,101,1,17.62,2,1,1,4
1515915625541848415,101,2,63.18,2,2,2,6
1515915625541852613,101,2,66.38,2,2,2,6
1515915625541853400,101,1,397.48,2,1,4,7
1515915625541858986,101,1,13.49,2,1,1,4
1515915625541859360,101,4,636.56,2,3,4,9
1515915625541860632,101,1,87.16,2,1,2,5
1515915625541862753,100,3,159.99,2,3,3,8
1515915625541867800,100,1,19.37,2,1,1,4
1515915625541872217,100,1,48.84,2,1,2,5
1515915625541874158,100,1,112.22,2,1,3,6
1515915625541878961,99,2,216.26,2,2,3,7
1515915625541887886,100,1,131.59,2,1,3,6
1515915625541888439,61,1,17.62,3,1,1,5
1515915625541890012,100,1,92.14,2,1,3,6
1515915625541891532,99,1,396.98,2,1,4,7
1515915625541892751,94,1,737.63,2,1,4,7
1515915625541897112,100,1,29.22,2,1,1,4
1515915625541898831,78,10,1445.1,2,4,4,10
1515915625541902410,98,3,314.58,2,3,4,9
1515915625541906307,100,1,60.21,2,1,2,5
1515915625541907029,100,1,14.6,2,1,1,4
1515915625541907966,100,1,200.35,2,1,3,6
1515915625541911598,100,1,155.11,2,1,3,6
1515915625541912691,100,2,416.48,2,2,4,8
1515915625541912940,100,1,13.86,2,1,1,4
1515915625541913979,100,1,29.22,2,1,1,4
1515915625541918892,100,2,122.32,2,2,3,7
1515915625541932094,100,1,13.52,2,1,1,4
1515915625541936244,100,1,60.83,2,1,2,5
1515915625541940708,100,1,86.54,2,1,2,5
1515915625541942016,100,1,21.75,2,1,1,4
1515915625541942632,100,1,16.19,2,1,1,4
1515915625541942695,100,1,600.6,2,1,4,7
1515915625541943262,100,2,585.66,2,2,4,8
1515915625541944179,96,2,3.14,2,2,1,5
1515915625541944525,100,1,127.48,2,1,3,6
1515915625541944950,100,1,8.59,2,1,1,4
1515915625541944981,69,1,29.52,3,1,1,5
1515915625541945254,100,2,44.44,2,2,2,6
1515915625541945712,100,1,33.97,2,1,2,5
1515915625541947961,100,2,585.66,2,2,4,8
1515915625541951614,80,1,32.22,2,1,1,4
1515915625541956845,81,3,337.96000000000004,2,3,4,9
1515915625541963199,100,1,25.84,2,1,1,4
1515915625541967869,94,4,257.92,2,3,3,8
1515915625541971572,96,1,11.11,2,1,1,4
1515915625541974451,100,1,84.95,2,1,2,5
1515915625541977476,100,1,69.38,2,1,2,5
1515915625541981546,100,1,29.22,2,1,1,4
1515915625541982070,25,1,51.11,4,1,2,7
1515915625541983145,100,1,9.95,2,1,1,4
1515915625541987194,37,1,599.6,3,1,4,8
1515915625541992249,82,1,42.14,2,1,2,5
1515915625541993780,100,1,72.38,2,1,2,5
1515915625541994036,100,1,10.43,2,1,1,4
1515915625541995939,100,1,18.89,2,1,1,4
1515915625541997842,100,1,94.11,2,1,3,6
1515915625542002032,100,1,13.03,2,1,1,4
1515915625542006043,98,1,36.52,2,1,2,5
1515915625542010209,26,1,214.1,4,1,3,8
1515915625542011918,100,1,192.86,2,1,3,6
1515915625542012495,100,1,35.25,2,1,2,5
1515915625542016802,100,1,94.11,2,1,3,6
1515915625542019846,100,1,23.17,2,1,1,4
1515915625542020302,100,2,43.5,2,2,2,6
1515915625542022710,100,1,87.9,2,1,2,5
1515915625542025014,100,1,176.17,2,1,3,6
1515915625542027638,50,4,257.92,3,3,3,9
1515915625542029127,100,1,39.67,2,1,2,5
1515915625542036896,100,1,11.43,2,1,1,4
1515915625542038808,100,1,56.16,2,1,2,5
1515915625542039827,100,1,231.24,2,1,3,6
1515915625542043631,100,1,15.43,2,1,1,4
1515915625542045430,100,2,23.04,2,2,1,5
1515915625542047693,100,1,151.75,2,1,3,6
1515915625542058734,100,1,11.9,2,1,1,4
1515915625542060902,100,1,201.33,2,1,3,6
1515915625542063904,56,1,172.86,3,1,3,7
1515915625542068782,100,1,21.75,2,1,1,4
1515915625542074083,64,2,349.70000000000005,3,2,4,9
1515915625542075608,100,2,26.04,2,2,1,5
1515915625542080671,99,1,464.52,2,1,4,7
1515915625542081163,100,1,140.63,2,1,3,6
1515915625542085470,100,1,202.67,2,1,3,6
1515915625542085490,98,2,79.5,2,2,2,6
1515915625542085566,100,1,39.75,2,1,2,5
1515915625542086417,100,3,153.81,2,3,3,8
1515915625542086538,100,1,20.32,2,1,1,4
1515915625542093913,100,1,53.24,2,1,2,5
1515915625542094608,100,1,50.78,2,1,2,5
1515915625542095757,100,4,34.94,2,3,2,7
1515915625542097130,100,1,36.51,2,1,2,5
1515915625542098417,44,1,170.27,3,1,3,7
1515915625542102075,34,8,257.76,4,4,3,11
1515915625542108882,100,2,55.24,2,2,2,6
1515915625542110375,87,1,33.97,2,1,2,5
1515915625542130633,100,1,9.81,2,1,1,4
1515915625542130855,100,1,28.41,2,1,1,4
1515915625542131777,98,1,14.37,2,1,1,4
1515915625542132021,100,1,32.22,2,1,1,4
1515915625542134161,100,2,104.98,2,2,3,7
1515915625542137186,100,2,323.02,2,2,4,8
1515915625542137470,100,1,212.06,2,1,3,6
1515915625542138638,100,1,20.0,2,1,1,4
1515915625542140928,89,2,565.3,2,2,4,8
1515915625542148714,100,3,380.04,2,3,4,9
1515915625542151879,27,1,21.59,4,1,1,6
1515915625542152381,99,1,106.43,2,1,3,6
1515915625542155424,100,1,46.67,2,1,2,5
1515915625542155705,100,1,6.57,2,1,1,4
1515915625542159027,46,2,58.44,3,2,2,7
1515915625542161419,79,5,2271.5699999999997,2,4,4,10
1515915625542161947,1,1,29.22,4,1,1,6
1515915625542162958,79,3,353.25,2,3,4,9
1515915625542164075,19,2,289.02,4,2,4,10
1515915625542167557,100,1,16.27,2,1,1,4
1515915625542168079,100,2,552.4100000000001,2,2,4,8
1515915625542168707,100,1,21.21,2,1,1,4
1515915625542169185,100,1,55.6,2,1,2,5
1515915625542169582,100,1,56.27,2,1,2,5
1515915625542171899,97,4,39.32,2,3,2,7
1515915625542176851,99,3,109.77000000000001,2,3,3,8
1515915625542178275,100,2,67.84,2,2,2,6
1515915625542181181,100,2,754.92,2,2,4,8
1515915625542185638,100,1,97.57,2,1,3,6
1515915625542188219,100,1,23.13,2,1,1,4
1515915625542189771,89,4,1137.6,2,3,4,9
1515915625542193070,100,2,193.2,2,2,3,7
1515915625542199632,100,5,2247.55,2,4,4,10
1515915625542199639,84,7,1085.7,2,4,4,10
1515915625542199931,92,3,218.94,2,3,3,8
1515915625542202242,96,1,10.21,2,1,1,4
1515915625542202339,100,1,32.71,2,1,2,5
1515915625542203305,100,1,284.3,2,1,3,6
1515915625542204087,100,1,16.19,2,1,1,4
1515915625542211197,100,1,124.73,2,1,3,6
1515915625542213993,100,3,153.51,2,3,3,8
1515915625542218802,100,4,168.88,2,3,3,8
1515915625542219768,16,3,372.64,4,3,4,11
1515915625542221477,73,1,98.79,2,1,3,6
1515915625542222392,73,4,1068.19,2,3,4,9
1515915625542225822,86,2,102.66,2,2,3,7
1515915625542227576,100,1,502.43,2,1,4,7
1515915625542238179,99,1,16.19,2,1,1,4
1515915625542239673,67,3,113.25,3,3,3,9
1515915625542239978,99,1,16.19,2,1,1,4
1515915625542240516,50,1,146.4,3,1,3,7
1515915625542242151,99,1,105.87,2,1,3,6
1515915625542246073,99,1,300.17,2,1,4,7
1515915625542251202,99,1,245.29,2,1,3,6
1515915625542255004,99,2,347.34,2,2,4,8
1515915625542260088,36,4,1597.92,3,3,4,10
1515915625542260286,99,1,13.41,2,1,1,4
1515915625542265276,89,5,479.6,2,4,4,10
1515915625542266026,73,2,291.68,2,2,4,8
1515915625542267955,99,1,33.08,2,1,2,5
1515915625542268496,99,1,113.56,2,1,3,6
1515915625542275693,99,1,25.86,2,1,1,4
1515915625542276313,99,1,314.68,2,1,4,7
1515915625542276835,79,1,204.29,2,1,3,6
1515915625542280977,99,1,84.79,2,1,2,5
1515915625542283207,98,2,104.98,2,2,3,7
1515915625542284265,99,1,212.7,2,1,3,6
1515915625542286271,99,1,118.57,2,1,3,6
1515915625542286421,99,1,1.57,2,1,1,4
1515915625542286641,99,1,86.16,2,1,2,5
1515915625542288482,99,1,577.6,2,1,4,7
1515915625542288966,99,1,19.24,2,1,1,4
1515915625542291897,99,3,71.42999999999999,2,3,2,7
1515915625542294620,99,2,260.0,2,2,3,7
1515915625542295273,95,1,43.11,2,1,2,5
1515915625542301252,98,2,66.04,2,2,2,6
1515915625542305368,99,2,330.66,2,2,4,8
1515915625542305724,98,3,778.14,2,3,4,9
1515915625542305862,99,2,43.8,2,2,2,6
1515915625542311382,99,1,26.19,2,1,1,4
1515915625542313016,99,4,172.44,2,3,3,8
1515915625542313057,99,1,16.98,2,1,1,4
1515915625542313453,48,1,10.79,3,1,1,5
1515915625542313469,99,1,19.68,2,1,1,4
1515915625542319142,99,2,52.38,2,2,2,6
1515915625542320561,99,1,18.57,2,1,1,4
1515915625542321271,99,2,64.76,2,2,2,6
1515915625542321631,99,1,32.38,2,1,2,5
1515915625542322007,12,1,97.78,4,1,3,8
1515915625542322770,99,3,30.630000000000003,2,3,1,6
1515915625542323624,99,2,298.1,2,2,4,8
1515915625542325635,99,1,21.43,2,1,1,4
1515915625542327685,99,1,45.24,2,1,2,5
1515915625542331430,99,1,42.71,2,1,2,5
1515915625542333628,99,1,64.48,2,1,2,5
1515915625542334073,96,2,30.0,2,2,1,5
1515915625542338562,99,1,52.9,2,1,2,5
1515915625542339739,99,1,11.75,2,1,1,4
1515915625542340090,99,1,56.27,2,1,2,5
1515915625542340485,99,1,88.37,2,1,2,5
1515915625542344152,99,1,108.65,2,1,3,6
1515915625542351428,93,1,117.87,2,1,3,6
1515915625542353755,43,6,307.26,3,4,4,11
1515915625542357357,99,1,43.13,2,1,2,5
1515915625542367516,99,2,194.7,2,2,3,7
1515915625542370793,99,1,11.75,2,1,1,4
1515915625542374393,99,2,64.44,2,2,2,6
1515915625542379807,99,1,32.22,2,1,1,4
1515915625542380021,84,3,316.68,2,3,4,9
1515915625542381776,99,2,59.04,2,2,2,6
1515915625542382199,99,1,32.22,2,1,1,4
1515915625542388142,99,1,57.13,2,1,2,5
1515915625542389384,99,2,65.62,2,2,2,6
1515915625542396901,93,1,149.32,2,1,3,6
1515915625542398045,98,4,875.92,2,3,4,9
1515915625542398381,99,1,29.52,2,1,1,4
1515915625542402354,99,1,365.38,2,1,4,7
1515915625542403011,99,1,466.52,2,1,4,7
1515915625542408043,99,1,15.24,2,1,1,4
1515915625542411660,99,1,16.98,2,1,1,4
1515915625542412420,99,1,24.76,2,1,1,4
1515915625542415188,99,1,51.35,2,1,2,5
1515915625542415711,99,1,486.81,2,1,4,7
1515915625542416957,99,1,486.81,2,1,4,7
1515915625542425198,99,1,415.54,2,1,4,7
1515915625542431863,99,1,50.05,2,1,2,5
1515915625542433471,7,3,2089.99,4,3,4,11
1515915625542433660,99,1,29.22,2,1,1,4
1515915625542433957,91,1,199.37,2,1,3,6
1515915625542438949,99,1,199.37,2,1,3,6
1515915625542445210,99,1,17.73,2,1,1,4
1515915625542447488,99,9,131.4,2,4,3,9
1515915625542451923,99,1,32.22,2,1,1,4
1515915625542459747,91,1,135.87,2,1,3,6
1515915625542461360,99,1,199.37,2,1,3,6
1515915625542461931,99,1,106.43,2,1,3,6
1515915625542462036,99,1,34.56,2,1,2,5
1515915625542463801,99,1,106.43,2,1,3,6
1515915625542463980,99,1,29.22,2,1,1,4
1515915625542468034,99,5,781.51,2,4,4,10
1515915625542470286,99,2,97.68,2,2,3,7
1515915625542474145,99,2,45.4,2,2,2,6
1515915625542475000,56,1,1.57,3,1,1,5
1515915625542476393,99,2,64.44,2,2,2,6
1515915625542477007,99,1,244.29,2,1,3,6
1515915625542477787,98,2,68.6,2,2,2,6
1515915625542488154,99,2,49.2,2,2,2,6
1515915625542492747,99,2,246.64,2,2,3,7
1515915625542493444,99,1,43.11,2,1,2,5
1515915625542496650,21,1,59.9,4,1,2,7
1515915625542497364,91,2,165.94,2,2,3,7
1515915625542502560,99,2,145.96,2,2,3,7
1515915625542504660,95,5,1937.2,2,4,4,10
1515915625542508664,9,1,17.46,4,1,1,6
1515915625542512718,99,1,43.33,2,1,2,5
1515915625542516354,99,1,77.73,2,1,2,5
1515915625542522586,99,3,502.86,2,3,4,9
1515915625542522746,98,1,466.52,2,1,4,7
1515915625542523675,99,1,24.44,2,1,1,4
1515915625542526010,99,1,35.22,2,1,2,5
1515915625542527377,99,2,64.44,2,2,2,6
1515915625542529321,99,2,209.72,2,2,3,7
1515915625542534854,99,1,17.06,2,1,1,4
1515915625542535600,96,7,1442.64,2,4,4,10
1515915625542537249,98,1,10.48,2,1,1,4
1515915625542537874,99,1,42.57,2,1,2,5
1515915625542543861,88,4,1410.72,2,3,4,9
1515915625542544988,99,1,50.16,2,1,2,5
1515915625542545099,99,1,30.71,2,1,1,4
1515915625542550098,99,1,105.87,2,1,3,6
1515915625542554637,99,2,30.16,2,2,1,5
1515915625542570499,99,1,26.19,2,1,1,4
1515915625542570605,99,1,59.71,2,1,2,5
1515915625542573741,99,4,40.84,2,3,2,7
1515915625542579169,80,1,499.54,2,1,4,7
1515915625542591156,99,1,24.92,2,1,1,4
1515915625542598925,71,2,128.96,3,2,3,8
1515915625542604174,99,1,26.46,2,1,1,4
1515915625542605229,99,1,15.87,2,1,1,4
1515915625542616640,98,4,192.88,2,3,3,8
1515915625542620770,98,1,167.62,2,1,3,6
1515915625542621023,98,2,157.78,2,2,3,7
1515915625542621191,98,1,228.79,2,1,3,6
1515915625542629471,98,1,54.92,2,1,2,5
1515915625542631348,98,1,202.67,2,1,3,6
1515915625542631590,98,1,40.48,2,1,2,5
1515915625542631813,98,1,56.27,2,1,2,5
1515915625542635351,93,1,23.57,2,1,1,4
1515915625542643770,96,1,45.24,2,1,2,5
1515915625542648816,86,2,64.44,2,2,2,6
1515915625542652609,98,1,18.11,2,1,1,4
1515915625542653113,98,1,18.25,2,1,1,4
1515915625542655560,98,1,1.57,2,1,1,4
1515915625542657318,98,1,9.84,2,1,1,4
1515915625542663429,98,1,1209.57,2,1,4,7
1515915625542663478,98,1,105.87,2,1,3,6
1515915625542666554,91,1,133.7,2,1,3,6
1515915625542667352,98,1,43.13,2,1,2,5
1515915625542667466,98,2,674.88,2,2,4,8
1515915625542672790,91,2,298.1,2,2,4,8
1515915625542675218,98,1,79.46,2,1,2,5
1515915625542681946,98,1,38.83,2,1,2,5
1515915625542682234,98,1,292.83,2,1,4,7
1515915625542684933,98,1,38.83,2,1,2,5
1515915625542685460,98,2,30.16,2,2,1,5
1515915625542685947,98,1,14.86,2,1,1,4
1515915625542686504,28,1,22.21,4,1,1,6
1515915625542705253,98,1,17.49,2,1,1,4
1515915625542725443,97,2,21.58,2,2,1,5
1515915625542732276,98,2,79.5,2,2,2,6
1515915625542738345,98,1,19.43,2,1,1,4
1515915625542746309,98,1,116.17,2,1,3,6
1515915625542748060,87,3,417.09000000000003,2,3,4,9
1515915625542753209,98,1,46.03,2,1,2,5
1515915625542754276,98,1,155.11,2,1,3,6
1515915625542756887,98,1,414.13,2,1,4,7
1515915625542759157,95,1,48.73,2,1,2,5
1515915625542763256,70,1,187.78,3,1,3,7
1515915625542765570,98,2,228.26,2,2,3,7
1515915625542775102,98,2,45.08,2,2,2,6
1515915625542778271,98,2,142.22,2,2,3,7
1515915625542778672,98,1,16.43,2,1,1,4
1515915625542779925,98,1,32.22,2,1,1,4
1515915625542781089,97,1,55.87,2,1,2,5
1515915625542782723,98,3,97.14000000000001,2,3,3,8
1515915625542787175,98,2,291.69,2,2,4,8
1515915625542788259,98,2,187.02,2,2,3,7
1515915625542790107,98,1,18.57,2,1,1,4
1515915625542790593,98,1,118.57,2,1,3,6
1515915625542796295,98,1,65.1,2,1,2,5
1515915625542797002,94,2,138.1,2,2,3,7
1515915625542801177,2,6,955.06,4,4,4,12
1515915625542803243,98,1,46.98,2,1,2,5
1515915625542809921,98,1,9.35,2,1,1,4
1515915625542810283,98,1,731.83,2,1,4,7
1515915625542810349,98,1,10.16,2,1,1,4
1515915625542811792,98,1,19.98,2,1,1,4
1515915625542815765,98,1,478.75,2,1,4,7
1515915625542819701,86,1,205.49,2,1,3,6
1515915625542830312,98,2,26.04,2,2,1,5
1515915625542831671,98,1,15.08,2,1,1,4
1515915625542836298,98,1,50.63,2,1,2,5
1515915625542836345,98,3,193.79999999999998,2,3,3,8
1515915625542837393,96,4,301.16,2,3,4,9
1515915625542841430,95,2,300.58,2,2,4,8
1515915625542843843,98,1,23.17,2,1,1,4
1515915625542845015,98,1,125.11,2,1,3,6
1515915625542845663,98,1,26.19,2,1,1,4
1515915625542845772,98,1,13.02,2,1,1,4
1515915625542846073,98,1,34.44,2,1,2,5
1515915625542846786,10,6,175.32,4,4,3,11
1515915625542851792,98,1,64.48,2,1,2,5
1515915625542859257,98,1,11.9,2,1,1,4
1515915625542861903,98,3,248.91,2,3,3,8
1515915625542864032,98,2,211.74,2,2,3,7
1515915625542864111,98,2,34.04,2,2,2,6
1515915625542866245,97,2,405.34,2,2,4,8
1515915625542868028,97,3,31.380000000000003,2,3,1,6
1515915625542874852,96,1,575.73,2,1,4,7
1515915625542876726,97,2,40.0,2,2,2,6
1515915625542881847,98,1,21.21,2,1,1,4
1515915625542882452,98,1,18.57,2,1,1,4
1515915625542884061,93,2,502.09,2,2,4,8
1515915625542886064,46,2,103.33,3,2,3,8
1515915625542887581,71,1,259.94,3,1,3,7
1515915625542887869,12,1,259.94,4,1,3,8
1515915625542891751,94,1,28.1,2,1,1,4
1515915625542894110,98,2,51.66,2,2,2,6
1515915625542896793,98,1,977.76,2,1,4,7
1515915625542896958,98,1,34.44,2,1,2,5
1515915625542898134,88,1,10.16,2,1,1,4
1515915625542898607,90,6,328.68,2,4,4,10
1515915625542902556,98,1,24.6,2,1,1,4
1515915625542903839,98,1,171.41,2,1,3,6
1515915625542904345,98,1,53.9,2,1,2,5
1515915625542904491,98,1,415.54,2,1,4,7
1515915625542907796,89,3,279.06,2,3,3,8
1515915625542922737,98,1,35.71,2,1,2,5
1515915625542923015,98,3,45.24,2,3,2,7
1515915625542924082,98,1,103.24,2,1,3,6
1515915625542925970,81,4,95.24,2,3,3,8
1515915625542927580,98,2,139.42,2,2,3,7
1515915625542929483,98,1,18.7,2,1,1,4
1515915625542931655,98,2,20.64,2,2,1,5
1515915625542934756,98,2,42.42,2,2,2,6
1515915625542936004,98,3,70.56,2,3,2,7
1515915625542938899,98,1,64.48,2,1,2,5
1515915625542943914,98,2,684.26,2,2,4,8
1515915625542950424,98,4,90.22,2,3,2,7
1515915625542952032,98,1,103.68,2,1,3,6
1515915625542955565,97,13,613.0,2,4,4,10
1515915625542961653,98,1,609.6,2,1,4,7
1515915625542963218,97,2,127.96,2,2,3,7
1515915625542964486,74,1,30.17,2,1,1,4
1515915625542965507,97,2,135.42,2,2,3,7
1515915625542970209,98,2,690.31,2,2,4,8
1515915625542975406,98,1,13.22,2,1,1,4
1515915625542978767,98,1,34.13,2,1,2,5
1515915625542980726,93,4,1844.05,2,3,4,9
1515915625542986000,98,1,204.29,2,1,3,6
1515915625542986343,98,1,53.32,2,1,2,5
1515915625542986856,98,2,52.38,2,2,2,6
1515915625542986966,95,5,100.0,2,4,3,9
1515915625543009892,96,2,112.54,2,2,3,7
1515915625543011743,97,1,27.32,2,1,1,4
1515915625543018110,87,1,48.84,2,1,2,5
1515915625543019029,97,1,32.22,2,1,1,4
1515915625543020092,75,4,172.44,2,3,3,8
1515915625543028841,97,3,74.76,2,3,2,7
1515915625543033797,89,1,48.59,2,1,2,5
1515915625543035878,97,1,140.86,2,1,3,6
1515915625543036964,61,1,265.05,3,1,3,7
1515915625543042833,97,2,746.92,2,2,4,8
1515915625543043197,97,5,106.05000000000001,2,4,3,9
1515915625543048091,97,4,810.68,2,3,4,9
1515915625543048309,97,3,41.43,2,3,2,7
1515915625543048573,97,1,13.81,2,1,1,4
1515915625543050853,97,3,167.60999999999999,2,3,3,8
1515915625543051542,97,1,32.38,2,1,2,5
1515915625543051904,97,2,25.02,2,2,1,5
1515915625543054963,97,1,29.22,2,1,1,4
1515915625543055282,97,1,26.98,2,1,1,4
1515915625543055766,97,1,32.67,2,1,2,5
1515915625543060289,97,1,29.22,2,1,1,4
1515915625543062564,89,1,77.73,2,1,2,5
1515915625543068345,97,1,16.98,2,1,1,4
1515915625543069055,26,2,90.48,4,2,2,8
1515915625543074036,97,1,257.87,2,1,3,6
1515915625543080038,97,1,116.0,2,1,3,6
1515915625543081707,97,1,164.33,2,1,3,6
1515915625543087479,97,2,29.72,2,2,1,5
1515915625543088895,97,2,679.02,2,2,4,8
1515915625543091068,97,3,51.66,2,3,2,7
1515915625543091352,97,1,31.11,2,1,1,4
1515915625543102921,79,1,60.06,2,1,2,5
1515915625543105341,95,1,167.62,2,1,3,6
1515915625543106217,97,1,88.33,2,1,2,5
1515915625543113437,97,1,75.97,2,1,2,5
1515915625543114447,97,1,72.16,2,1,2,5
1515915625543117229,95,3,221.43,2,3,3,8
1515915625543122561,49,4,773.9300000000001,3,3,4,10
1515915625543123600,97,1,18.57,2,1,1,4
1515915625543124801,97,1,17.22,2,1,1,4
1515915625543125368,97,1,6.71,2,1,1,4
1515915625543133467,97,1,1300.03,2,1,4,7
1515915625543144930,97,1,23.29,2,1,1,4
1515915625543152453,97,1,277.1,2,1,3,6
1515915625543153192,97,1,9.35,2,1,1,4
1515915625543154917,97,1,73.65,2,1,2,5
1515915625543155592,97,1,33.65,2,1,2,5
1515915625543161112,97,2,44.86,2,2,2,6
1515915625543164060,97,1,9.84,2,1,1,4
1515915625543164383,96,2,730.76,2,2,4,8
1515915625543170637,85,3,96.66,2,3,3,8
1515915625543171942,97,1,28.1,2,1,1,4
1515915625543172661,97,1,31.75,2,1,1,4
1515915625543180048,97,2,88.35,2,2,2,6
1515915625543184832,97,2,64.44,2,2,2,6
1515915625543187508,97,1,376.11,2,1,4,7
1515915625543189523,97,1,11.94,2,1,1,4
1515915625543191183,97,1,71.02,2,1,2,5
1515915625543192869,97,1,12.46,2,1,1,4
1515915625543196867,96,1,53.51,2,1,2,5
1515915625543202072,97,4,960.44,2,3,4,9
1515915625543206575,97,2,300.58,2,2,4,8
1515915625543207964,97,1,49.38,2,1,2,5
1515915625543208224,91,1,126.68,2,1,3,6
1515915625543210071,97,3,63.63,2,3,2,7
1515915625543211313,97,1,34.44,2,1,2,5
1515915625543211395,97,1,466.52,2,1,4,7
1515915625543212702,97,1,80.03,2,1,2,5
1515915625543213327,97,1,123.02,2,1,3,6
1515915625543215172,97,1,461.52,2,1,4,7
1515915625543216911,97,2,211.74,2,2,3,7
1515915625543221133,97,1,323.32,2,1,4,7
1515915625543223256,97,1,98.41,2,1,3,6
1515915625543225160,97,1,53.32,2,1,2,5
1515915625543230896,97,1,26.19,2,1,1,4
1515915625543234227,97,1,91.22,2,1,3,6
1515915625543242141,97,1,28.08,2,1,1,4
1515915625543249967,68,1,167.62,3,1,3,7
1515915625543256390,82,3,105.30000000000001,2,3,3,8
1515915625543256487,95,1,16.51,2,1,1,4
1515915625543257191,97,1,12.25,2,1,1,4
1515915625543258551,94,1,164.33,2,1,3,6
1515915625543259432,97,1,122.86,2,1,3,6
1515915625543264107,97,1,29.68,2,1,1,4
1515915625543269676,97,5,753.25,2,4,4,10
1515915625543273517,97,2,33.96,2,2,2,6
1515915625543273917,94,4,334.68,2,3,4,9
1515915625543274055,78,1,1.57,2,1,1,4
1515915625543275531,97,2,3.14,2,2,1,5
1515915625543277109,74,5,395.95000000000005,2,4,4,10
1515915625543280601,97,2,515.74,2,2,4,8
1515915625543280697,96,1,26.83,2,1,1,4
1515915625543283226,96,1,397.48,2,1,4,7
1515915625543286239,94,1,63.94,2,1,2,5
1515915625543287115,97,1,359.27,2,1,4,7
1515915625543287733,81,5,788.96,2,4,4,10
1515915625543288093,97,4,454.91999999999996,2,3,4,9
1515915625543291276,97,4,1918.04,2,3,4,9
1515915625543296291,97,1,126.68,2,1,3,6
1515915625543296505,97,1,82.97,2,1,2,5
1515915625543297198,97,1,63.94,2,1,2,5
1515915625543297320,97,1,16.19,2,1,1,4
1515915625543300006,97,1,339.51,2,1,4,7
1515915625543300041,97,1,31.75,2,1,1,4
1515915625543302328,97,1,314.68,2,1,4,7
1515915625543304615,97,2,115.24,2,2,3,7
1515915625543307183,97,1,56.62,2,1,2,5
1515915625543310870,97,1,30.54,2,1,1,4
1515915625543320535,97,1,479.51,2,1,4,7
1515915625543328144,97,1,79.21,2,1,2,5
1515915625543329773,97,2,39.36,2,2,2,6
1515915625543331471,69,2,998.0799999999999,3,2,4,9
1515915625543332016,97,1,157.14,2,1,3,6
1515915625543334546,96,3,280.95000000000005,2,3,3,8
1515915625543334879,97,1,102.7,2,1,3,6
1515915625543335424,97,1,164.33,2,1,3,6
1515915625543339082,97,1,20.14,2,1,1,4
1515915625543352563,97,2,58.98,2,2,2,6
1515915625543358128,75,2,740.92,2,2,4,8
1515915625543359567,97,1,34.29,2,1,2,5
1515915625543361946,97,1,26.46,2,1,1,4
1515915625543368557,97,1,59.79,2,1,2,5
1515915625543374235,97,1,314.97,2,1,4,7
1515915625543374452,97,3,773.61,2,3,4,9
1515915625543374496,96,2,129.78,2,2,3,7
1515915625543375313,97,1,64.89,2,1,2,5
1515915625543376449,97,1,242.48,2,1,3,6
1515915625543379283,97,1,643.89,2,1,4,7
1515915625543383945,34,3,1148.42,4,3,4,11
1515915625543392786,96,2,56.82,2,2,2,6
1515915625543393015,95,1,150.79,2,1,3,6
1515915625543394377,96,1,126.68,2,1,3,6
1515915625543394775,96,1,381.46,2,1,4,7
1515915625543396161,96,1,20.0,2,1,1,4
1515915625543400562,96,1,27.78,2,1,1,4
1515915625543404804,96,1,89.02,2,1,2,5
1515915625543405610,96,1,23.14,2,1,1,4
1515915625543405736,82,1,116.83,2,1,3,6
1515915625543406316,94,1,224.76,2,1,3,6
1515915625543409315,96,1,229.78,2,1,3,6
1515915625543412075,63,2,568.92,3,2,4,9
1515915625543416628,93,1,180.79,2,1,3,6
1515915625543424825,96,1,35.08,2,1,2,5
1515915625543425028,96,2,293.84,2,2,4,8
1515915625543427207,96,1,32.22,2,1,1,4
1515915625543433547,96,1,113.81,2,1,3,6
1515915625543438080,96,1,107.11,2,1,3,6
1515915625543438869,96,1,123.79,2,1,3,6
1515915625543441037,84,2,327.04,2,2,4,8
1515915625543442817,96,4,339.56,2,3,4,9
1515915625543443074,96,1,187.29,2,1,3,6
1515915625543445453,96,1,140.86,2,1,3,6
1515915625543447725,96,2,49.46,2,2,2,6
1515915625543448159,93,1,30.81,2,1,1,4
1515915625543450122,96,1,11.65,2,1,1,4
1515915625543465157,96,1,21.75,2,1,1,4
1515915625543477080,96,2,85.96,2,2,2,6
1515915625543484217,96,1,55.6,2,1,2,5
1515915625543484665,96,1,15.08,2,1,1,4
1515915625543484668,96,1,44.76,2,1,2,5
1515915625543485313,94,1,163.52,2,1,3,6
1515915625543487993,20,1,73.81,4,1,2,7
1515915625543493280,77,7,729.4699999999999,2,4,4,10
1515915625543500373,96,1,154.32,2,1,3,6
1515915625543511908,96,2,42.22,2,2,2,6
1515915625543512348,96,2,18.7,2,2,1,5
1515915625543526209,96,1,43.11,2,1,2,5
1515915625543527741,96,2,52.38,2,2,2,6
1515915625543531655,96,1,60.54,2,1,2,5
1515915625543532054,96,4,102.84,2,3,3,8
1515915625543532894,96,1,32.22,2,1,1,4
1515915625543533787,96,1,34.56,2,1,2,5
1515915625543534780,96,3,4.71,2,3,1,6
1515915625543537964,96,1,44.13,2,1,2,5
1515915625543538627,91,1,486.81,2,1,4,7
1515915625543543630,96,1,64.48,2,1,2,5
1515915625543545653,96,1,102.7,2,1,3,6
1515915625543547075,29,2,32.08,4,2,1,7
1515915625543549460,96,1,125.4,2,1,3,6
1515915625543549993,96,1,51.11,2,1,2,5
1515915625543551594,96,2,43.5,2,2,2,6
1515915625543555181,96,1,43.11,2,1,2,5
1515915625543556049,96,1,10.4,2,1,1,4
1515915625543565724,96,1,185.08,2,1,3,6
1515915625543570445,96,1,8.24,2,1,1,4
1515915625543574388,96,2,613.62,2,2,4,8
1515915625543578339,94,14,204.47,2,4,3,9
1515915625543578678,96,1,79.87,2,1,2,5
1515915625543585529,88,3,146.52,2,3,3,8
1515915625543593197,96,1,18.1,2,1,1,4
1515915625543593755,96,2,72.7,2,2,2,6
1515915625543599234,21,2,21.68,4,2,1,7
1515915625543601103,94,1,215.4,2,1,3,6
1515915625543624785,96,2,31.74,2,2,1,5
1515915625543628909,95,3,609.87,2,3,4,9
1515915625543639379,96,2,374.58,2,2,4,8
1515915625543639507,94,2,114.8,2,2,3,7
1515915625543640476,91,1,236.0,2,1,3,6
1515915625543647013,96,2,165.94,2,2,3,7
1515915625543654945,96,1,397.48,2,1,4,7
1515915625543655006,96,1,72.79,2,1,2,5
1515915625543658523,88,6,2499.12,2,4,4,10
1515915625543660173,94,1,86.16,2,1,2,5
1515915625543661218,96,1,53.51,2,1,2,5
1515915625543663898,95,1,30.08,2,1,1,4
1515915625543671092,96,1,399.48,2,1,4,7
1515915625543678617,96,1,62.1,2,1,2,5
1515915625543679016,96,2,124.2,2,2,3,7
1515915625543690635,96,1,226.84,2,1,3,6
1515915625543690840,96,1,122.86,2,1,3,6
1515915625543691143,96,1,226.84,2,1,3,6
1515915625543691392,96,2,126.66,2,2,3,7
1515915625543691468,37,5,1340.8500000000001,3,4,4,11
1515915625543697837,96,2,115.24,2,2,3,7
1515915625543703413,96,1,18.41,2,1,1,4
1515915625543712277,96,1,1.57,2,1,1,4
1515915625543717595,96,1,10.13,2,1,1,4
1515915625543720901,81,1,24.86,2,1,1,4
1515915625543724406,96,1,26.83,2,1,1,4
1515915625543727791,96,1,13.86,2,1,1,4
1515915625543740711,96,1,10.08,2,1,1,4
1515915625543742681,96,1,18.73,2,1,1,4
1515915625543744330,96,1,46.67,2,1,2,5
1515915625543751091,96,2,408.58,2,2,4,8
1515915625543754345,96,1,501.54,2,1,4,7
1515915625543755580,96,2,88.35,2,2,2,6
1515915625543756948,96,1,253.97,2,1,3,6
1515915625543757415,96,1,15.4,2,1,1,4
1515915625543758228,45,1,609.6,3,1,4,8
1515915625543759446,96,8,1151.76,2,4,4,10
1515915625543764315,96,1,13.22,2,1,1,4
1515915625543764331,78,3,91.94999999999999,2,3,3,8
1515915625543767693,96,1,210.19,2,1,3,6
1515915625543768944,86,1,96.37,2,1,3,6
1515915625543774967,96,1,55.16,2,1,2,5
1515915625543779623,96,4,290.02,2,3,4,9
1515915625543780370,96,1,24.76,2,1,1,4
1515915625543782131,96,1,116.83,2,1,3,6
1515915625543789263,96,1,24.44,2,1,1,4
1515915625543793355,96,2,177.78,2,2,3,7
1515915625543796044,96,1,10.43,2,1,1,4
1515915625543801351,90,9,209.81,2,4,3,9
1515915625543806239,96,1,123.54,2,1,3,6
1515915625543811499,96,3,4.71,2,3,1,6
1515915625543827231,96,1,314.68,2,1,4,7
1515915625543828869,91,9,283.32,2,4,3,9
1515915625543834121,84,2,59.2,2,2,2,6
1515915625543835280,96,1,56.51,2,1,2,5
1515915625543845378,96,3,595.86,2,3,4,9
1515915625543845696,96,2,60.519999999999996,2,2,2,6
1515915625543849241,96,1,13.65,2,1,1,4
1515915625543858563,95,1,201.33,2,1,3,6
1515915625543860091,95,1,268.17,2,1,3,6
1515915625543869323,67,1,92.14,3,1,3,7
1515915625543873006,95,8,1277.1599999999999,2,4,4,10
1515915625543876087,88,1,32.54,2,1,2,5
1515915625543877862,95,1,32.22,2,1,1,4
1515915625543887165,90,2,34.98,2,2,2,6
1515915625543889904,95,2,44.44,2,2,2,6
1515915625543891949,95,3,1399.56,2,3,4,9
1515915625543894256,95,3,37.370000000000005,2,3,2,7
1515915625543898952,84,1,51.43,2,1,2,5
1515915625543903423,95,8,439.12,2,4,4,10
1515915625543906268,95,1,14.56,2,1,1,4
1515915625543914487,95,2,194.7,2,2,3,7
1515915625543920877,95,2,3.14,2,2,1,5
1515915625543924533,95,1,13.86,2,1,1,4
1515915625543928409,95,1,28.57,2,1,1,4
1515915625543930132,95,1,15.08,2,1,1,4
1515915625543930655,95,1,22.86,2,1,1,4
1515915625543930939,95,2,147.62,2,2,3,7
1515915625543931356,35,2,347.34,4,2,4,10
1515915625543937697,95,1,55.16,2,1,2,5
1515915625543937969,95,1,188.41,2,1,3,6
1515915625543944828,92,4,174.6,2,3,3,8
1515915625543946529,95,1,83.02,2,1,2,5
1515915625543946620,95,1,17.78,2,1,1,4
1515915625543947008,95,1,1.57,2,1,1,4
1515915625543947817,94,1,57.62,2,1,2,5
1515915625543950053,95,2,30.2,2,2,1,5
1515915625543961624,95,2,588.82,2,2,4,8
1515915625543962555,95,1,55.08,2,1,2,5
1515915625543978677,95,1,15.08,2,1,1,4
1515915625543980257,95,1,14.08,2,1,1,4
1515915625543981649,62,1,126.68,3,1,3,7
1515915625543982363,95,1,96.86,2,1,3,6
1515915625544021043,95,5,735.72,2,4,4,10
1515915625544023165,95,4,272.2,2,3,3,8
1515915625544026250,95,3,34.95,2,3,2,7
1515915625544042281,95,1,32.22,2,1,1,4
1515915625544043615,95,3,598.11,2,3,4,9
1515915625544047933,95,2,634.82,2,2,4,8
1515915625544053623,95,4,147.16,2,3,3,8
1515915625544058240,95,1,10.43,2,1,1,4
1515915625544059594,95,1,2.86,2,1,1,4
1515915625544068978,95,1,1.57,2,1,1,4
1515915625544128730,95,1,10.17,2,1,1,4
1515915625544134832,95,2,58.44,2,2,2,6
1515915625544137246,72,1,9.35,3,1,1,5
1515915625544155257,95,1,36.51,2,1,2,5
1515915625544173034,95,1,15.08,2,1,1,4
1515915625544174838,94,2,284.1,2,2,3,7
1515915625544176479,94,1,40.41,2,1,2,5
1515915625544179066,95,1,52.49,2,1,2,5
1515915625544190252,95,1,126.68,2,1,3,6
1515915625544194320,95,1,205.08,2,1,3,6
1515915625544205303,95,3,35.94,2,3,2,7
1515915625544206050,95,2,108.03999999999999,2,2,3,7
1515915625544209508,94,2,227.66,2,2,3,7
1515915625544217462,88,1,31.35,2,1,1,4
1515915625544231289,95,1,20.95,2,1,1,4
1515915625544235126,95,1,55.6,2,1,2,5
1515915625544244279,95,1,113.38,2,1,3,6
1515915625544246071,95,1,26.46,2,1,1,4
1515915625544303558,22,4,326.79,4,3,4,11
1515915625544382467,95,1,90.73,2,1,3,6
1515915625544392962,95,1,53.51,2,1,2,5
1515915625544403202,95,1,53.51,2,1,2,5
1515915625544411338,41,2,42.86,3,2,2,7
1515915625544412907,95,1,32.22,2,1,1,4
1515915625544418569,95,1,466.52,2,1,4,7
1515915625544498578,94,1,13.52,2,1,1,4
1515915625544502208,95,2,64.44,2,2,2,6
1515915625544516885,95,1,349.92,2,1,4,7
1515915625544556885,95,1,15.08,2,1,1,4
1515915625544598428,95,1,155.1,2,1,3,6
1515915625544641161,95,2,56.38,2,2,2,6
1515915625544641212,95,2,47.14,2,2,2,6
1515915625544644901,95,1,17.22,2,1,1,4
1515915625544681182,79,2,21.74,2,2,1,5
1515915625544723385,95,1,162.49,2,1,3,6
1515915625544756323,94,1,26.27,2,1,1,4
1515915625544772529,95,1,22.22,2,1,1,4
1515915625544785542,91,2,64.76,2,2,2,6
1515915625544805474,75,2,379.79999999999995,2,2,4,8
1515915625544818153,95,1,206.19,2,1,3,6
1515915625544820154,95,1,221.1,2,1,3,6
1515915625544842256,95,1,201.33,2,1,3,6
1515915625544856596,95,1,15.48,2,1,1,4
1515915625544861516,95,1,1.57,2,1,1,4
1515915625544866773,95,1,148.37,2,1,3,6
1515915625544872902,94,2,165.94,2,2,3,7
1515915625544924299,95,1,90.38,2,1,2,5
1515915625544934266,95,2,32.38,2,2,2,6
1515915625544941973,95,1,229.38,2,1,3,6
1515915625544950704,95,2,458.76,2,2,4,8
1515915625544953122,75,1,16.41,2,1,1,4
1515915625544969466,95,1,40.19,2,1,2,5
1515915625544973780,63,1,158.76,3,1,3,7
1515915625545000726,40,1,10.16,3,1,1,5
1515915625545011553,95,1,89.4,2,1,2,5
1515915625545017959,95,1,201.33,2,1,3,6
1515915625545023081,95,1,81.27,2,1,2,5
1515915625545023487,95,1,274.4,2,1,3,6
1515915625545026913,90,4,148.0,2,3,3,8
1515915625545032263,95,1,46.03,2,1,2,5
1515915625545033553,95,2,289.02,2,2,4,8
1515915625545047515,95,1,398.7,2,1,4,7
1515915625545054462,92,2,288.2,2,2,4,8
1515915625545054914,94,1,631.62,2,1,4,7
1515915625545057343,94,2,27.04,2,2,1,5
1515915625545058080,94,4,657.32,2,3,4,9
1515915625545061838,94,1,11.27,2,1,1,4
1515915625545069654,94,1,5.71,2,1,1,4
1515915625545072255,94,1,15.08,2,1,1,4
1515915625545073458,94,1,9.35,2,1,1,4
1515915625545084287,94,2,97.18,2,2,3,7
1515915625545084428,83,2,845.99,2,2,4,8
1515915625545085276,11,3,155.82,4,3,3,10
1515915625545089704,94,1,115.71,2,1,3,6
1515915625545091748,94,1,134.13,2,1,3,6
1515915625545092822,94,1,56.67,2,1,2,5
1515915625545096067,94,3,1144.3799999999999,2,3,4,9
1515915625545097742,94,1,111.84,2,1,3,6
1515915625545106500,94,1,49.57,2,1,2,5
1515915625545106750,94,2,253.36,2,2,3,7
1515915625545113037,94,1,64.48,2,1,2,5
1515915625545125262,94,1,10.32,2,1,1,4
1515915625545133063,94,1,284.3,2,1,3,6
1515915625545136155,94,1,98.21,2,1,3,6
1515915625545141871,94,1,26.46,2,1,1,4
1515915625545144551,94,2,150.16,2,2,3,7
1515915625545146900,94,1,15.03,2,1,1,4
1515915625545148391,94,1,503.32,2,1,4,7
1515915625545149746,94,1,108.13,2,1,3,6
1515915625545152035,94,4,92.68,2,3,3,8
1515915625545152476,94,1,140.86,2,1,3,6
1515915625545152805,17,1,136.05,4,1,3,8
1515915625545153338,94,1,155.1,2,1,3,6
1515915625545154233,94,1,105.87,2,1,3,6
1515915625545155980,91,2,185.72,2,2,3,7
1515915625545160504,94,1,1.57,2,1,1,4
1515915625545162501,94,3,78.57000000000001,2,3,2,7
1515915625545162824,94,2,64.44,2,2,2,6
1515915625545162855,94,2,595.88,2,2,4,8
1515915625545169622,68,1,170.0,3,1,3,7
1515915625545170362,94,1,268.17,2,1,3,6
1515915625545171469,94,1,34.06,2,1,2,5
1515915625545171484,94,1,53.06,2,1,2,5
1515915625545178654,94,1,210.9,2,1,3,6
1515915625545179212,94,1,18.1,2,1,1,4
1515915625545180692,94,1,41.57,2,1,2,5
1515915625545188480,94,2,24.5,2,2,1,5
1515915625545190053,90,2,33.8,2,2,2,6
1515915625545192796,94,1,82.97,2,1,2,5
1515915625545193886,94,1,201.33,2,1,3,6
1515915625545194618,94,1,26.46,2,1,1,4
1515915625545199172,94,4,812.08,2,3,4,9
1515915625545208740,94,1,133.03,2,1,3,6
1515915625545208765,94,1,479.51,2,1,4,7
1515915625545216322,94,1,28.81,2,1,1,4
1515915625545217922,94,1,204.29,2,1,3,6
1515915625545221704,94,1,30.24,2,1,1,4
1515915625545232040,94,1,64.32,2,1,2,5
1515915625545246680,94,1,32.38,2,1,2,5
1515915625545248347,94,1,14.27,2,1,1,4
1515915625545248894,94,1,92.14,2,1,3,6
1515915625545287046,94,1,10.35,2,1,1,4
1515915625545287460,94,2,319.36,2,2,4,8
1515915625545298752,94,3,91.28999999999999,2,3,3,8
1515915625545300768,94,2,128.96,2,2,3,7
1515915625545318267,89,1,161.3,2,1,3,6
1515915625545321307,94,1,12.54,2,1,1,4
1515915625545328725,26,1,64.48,4,1,2,7
1515915625545333292,45,2,12.0,3,2,1,6
1515915625545338099,36,1,116.98,3,1,3,7
1515915625545411582,88,1,80.06,2,1,2,5
1515915625545427479,93,4,88.88,2,3,2,7
1515915625545427631,94,1,41.59,2,1,2,5
1515915625545428136,92,1,204.29,2,1,3,6
1515915625545435052,86,1,154.32,2,1,3,6
1515915625545440557,94,1,112.11,2,1,3,6
1515915625545452056,94,4,67.92,2,3,2,7
1515915625545452198,94,2,166.98,2,2,3,7
1515915625545453181,94,1,25.08,2,1,1,4
1515915625545456841,94,1,205.25,2,1,3,6
1515915625545461854,94,1,164.33,2,1,3,6
1515915625545464949,94,1,88.25,2,1,2,5
1515915625545470332,94,2,33.96,2,2,2,6
1515915625545471556,94,1,365.38,2,1,4,7
1515915625545471734,91,5,86.76,2,4,2,8
1515915625545481588,94,2,230.0,2,2,3,7
1515915625545482796,94,8,227.28,2,4,3,9
1515915625545484582,94,1,486.81,2,1,4,7
1515915625545486211,93,3,1192.44,2,3,4,9
1515915625545491009,63,3,103.32,3,3,3,9
1515915625545502484,82,1,19.1,2,1,1,4
1515915625545513162,94,2,39.72,2,2,2,6
1515915625545513638,92,2,21.34,2,2,1,5
1515915625545517522,94,1,32.83,2,1,2,5
1515915625545523665,94,2,5.72,2,2,1,5
1515915625545525650,94,6,651.9000000000001,2,4,4,10
1515915625545529231,94,1,95.52,2,1,3,6
1515915625545535277,94,2,585.66,2,2,4,8
1515915625545537547,94,2,97.68,2,2,3,7
1515915625545547306,43,1,78.89,3,1,2,6
1515915625545549706,94,1,26.46,2,1,1,4
1515915625545561218,88,1,23.57,2,1,1,4
1515915625545563369,94,1,113.38,2,1,3,6
1515915625545564134,93,2,460.7,2,2,4,8
1515915625545566672,94,1,104.6,2,1,3,6
1515915625545567763,94,1,13.81,2,1,1,4
1515915625545577019,90,7,70.7,2,4,2,8
1515915625545580371,18,1,51.92,4,1,2,7
1515915625545594728,94,1,164.33,2,1,3,6
1515915625545598998,94,2,112.54,2,2,3,7
1515915625545606872,90,1,100.63,2,1,3,6
1515915625545610874,94,6,1284.6,2,4,4,10
1515915625545611361,94,5,360.95,2,4,4,10
1515915625545611951,77,1,479.52,2,1,4,7
1515915625545612578,94,2,28.16,2,2,1,5
1515915625545616611,93,1,146.92,2,1,3,6
1515915625545619931,93,1,122.97,2,1,3,6
1515915625545624848,93,1,55.35,2,1,2,5
1515915625545633655,93,1,265.05,2,1,3,6
1515915625545634146,93,1,33.97,2,1,2,5
1515915625545634265,93,1,15.68,2,1,1,4
1515915625545637057,93,1,51.75,2,1,2,5
1515915625545641984,35,2,80.82,4,2,2,8
1515915625545642711,93,1,352.68,2,1,4,7
1515915625545642806,93,2,44.44,2,2,2,6
1515915625545646680,90,6,220.62,2,4,3,9
1515915625545654059,93,2,67.94,2,2,2,6
1515915625545657291,43,1,26.98,3,1,1,5
1515915625545662123,93,1,21.43,2,1,1,4
1515915625545663872,93,1,268.17,2,1,3,6
1515915625545666021,92,4,1031.48,2,3,4,9
1515915625545670048,23,1,294.41,4,1,4,9
1515915625545670547,72,1,35.68,3,1,2,6
1515915625545676441,93,1,23.33,2,1,1,4
1515915625545684062,92,1,163.52,2,1,3,6
1515915625545688681,90,1,32.22,2,1,1,4
1515915625545690981,93,1,29.22,2,1,1,4
1515915625545693815,93,1,26.46,2,1,1,4
1515915625545706780,93,1,4.63,2,1,1,4
1515915625545716155,93,1,64.48,2,1,2,5
1515915625545717265,93,1,63.33,2,1,2,5
1515915625545721984,61,1,117.75,3,1,3,7
1515915625545725676,9,2,608.82,4,2,4,10
1515915625545725944,14,1,44.92,4,1,2,7
1515915625545726823,93,1,26.57,2,1,1,4
1515915625545729797,93,2,76.38,2,2,2,6
1515915625545736209,93,1,20.29,2,1,1,4
1515915625545738670,93,1,17.56,2,1,1,4
1515915625545740909,93,1,32.22,2,1,1,4
1515915625545743161,93,1,61.16,2,1,2,5
1515915625545744036,93,1,609.6,2,1,4,7
1515915625545744672,62,3,165.48,3,3,3,9
1515915625545744706,93,1,29.22,2,1,1,4
1515915625545749331,93,1,359.27,2,1,4,7
1515915625545759575,93,2,526.66,2,2,4,8
1515915625545761936,93,1,144.51,2,1,3,6
1515915625545765901,93,1,120.27,2,1,3,6
1515915625545769174,93,2,92.8,2,2,3,7
1515915625545773640,93,2,408.58,2,2,4,8
1515915625545780381,93,1,231.24,2,1,3,6
1515915625545780416,93,3,332.43,2,3,4,9
1515915625545785551,93,2,54.28,2,2,2,6
1515915625545790549,93,1,35.08,2,1,2,5
1515915625545790569,93,2,440.70000000000005,2,2,4,8
1515915625545797179,51,1,292.83,3,1,4,8
1515915625545801542,90,1,117.75,2,1,3,6
1515915625545804065,92,2,138.16,2,2,3,7
1515915625545807147,93,1,57.62,2,1,2,5
1515915625545809987,93,2,37.14,2,2,2,6
1515915625545813084,89,2,55.24,2,2,2,6
1515915625545814363,93,2,473.94,2,2,4,8
1515915625545818527,90,1,20.83,2,1,1,4
1515915625545828306,92,2,62.22,2,2,2,6
1515915625545831450,93,1,292.83,2,1,4,7
1515915625545854129,93,1,36.35,2,1,2,5
1515915625545854447,93,1,55.87,2,1,2,5
1515915625545855186,93,1,255.16,2,1,3,6
1515915625545860599,93,1,149.32,2,1,3,6
1515915625545864834,91,2,147.62,2,2,3,7
1515915625545870847,93,1,23.33,2,1,1,4
1515915625545876065,93,1,26.46,2,1,1,4
1515915625545883293,52,4,98.22999999999999,3,3,3,9
1515915625545884563,91,3,193.44,2,3,3,8
1515915625545891801,92,1,163.52,2,1,3,6
1515915625545896879,93,1,39.75,2,1,2,5
1515915625545901879,92,3,139.2,2,3,3,8
1515915625545904058,93,1,1.57,2,1,1,4
1515915625545905895,93,1,214.1,2,1,3,6
1515915625545905944,92,1,157.14,2,1,3,6
1515915625545914093,93,1,322.57,2,1,4,7
1515915625545914713,92,5,59.900000000000006,2,4,2,8
1515915625545916198,93,2,284.8,2,2,3,7
1515915625545916741,92,1,292.83,2,1,4,7
1515915625545918080,71,5,1282.3,3,4,4,11
1515915625545919941,93,1,63.35,2,1,2,5
1515915625545920560,91,3,100.94999999999999,2,3,3,8
1515915625545922166,93,3,248.91,2,3,3,8
1515915625545925137,93,1,284.3,2,1,3,6
1515915625545941811,93,2,3.14,2,2,1,5
1515915625545944214,93,1,16.05,2,1,1,4
1515915625545946966,39,5,146.67,3,4,3,10
1515915625545955582,45,1,25.4,3,1,1,5
1515915625545962311,93,3,823.1999999999999,2,3,4,9
1515915625545966353,81,2,480.22,2,2,4,8
1515915625545969152,92,1,172.86,2,1,3,6
1515915625545980897,92,1,39.51,2,1,2,5
1515915625545989067,79,1,226.84,2,1,3,6
1515915625545996108,91,5,1180.4,2,4,4,10
1515915625546008869,42,1,121.87,3,1,3,7
1515915625546010141,67,5,1222.67,3,4,4,11
1515915625546017209,92,1,113.38,2,1,3,6
1515915625546017428,92,1,8.22,2,1,1,4
1515915625546019989,91,2,52.92,2,2,2,6
1515915625546022779,92,1,415.54,2,1,4,7
1515915625546024013,92,3,379.34000000000003,2,3,4,9
1515915625546026559,92,3,90.48,2,3,2,7
1515915625546039853,92,1,161.11,2,1,3,6
1515915625546040544,92,1,314.68,2,1,4,7
1515915625546044173,83,8,151.52,2,4,3,9
1515915625546048080,92,1,307.43,2,1,4,7
1515915625546050245,92,1,6.67,2,1,1,4
1515915625546051532,92,1,403.46,2,1,4,7
1515915625546052123,92,1,71.78,2,1,2,5
1515915625546054142,92,1,10.13,2,1,1,4
1515915625546056654,92,2,37.14,2,2,2,6
1515915625546057880,92,1,55.6,2,1,2,5
1515915625546059137,92,3,104.97999999999999,2,3,3,8
1515915625546062014,92,1,32.22,2,1,1,4
1515915625546067610,92,1,31.41,2,1,1,4
1515915625546069799,92,1,15.35,2,1,1,4
1515915625546072886,92,1,15.68,2,1,1,4
1515915625546073591,92,2,18.74,2,2,1,5
1515915625546076028,92,1,42.57,2,1,2,5
1515915625546077880,92,1,397.48,2,1,4,7
1515915625546077946,92,1,20.19,2,1,1,4
1515915625546080045,18,2,96.54,4,2,3,9
1515915625546081481,92,1,30.51,2,1,1,4
1515915625546087492,83,2,806.92,2,2,4,8
1515915625546087637,92,1,13.57,2,1,1,4
1515915625546089265,92,1,203.02,2,1,3,6
1515915625546090470,92,1,266.75,2,1,3,6
1515915625546094659,92,1,79.21,2,1,2,5
1515915625546101004,92,1,26.57,2,1,1,4
1515915625546102834,6,11,1180.6299999999999,4,4,4,12
1515915625546103649,92,1,26.57,2,1,1,4
1515915625546106255,28,1,122.57,4,1,3,8
1515915625546108916,92,1,17.62,2,1,1,4
1515915625546112896,92,1,176.17,2,1,3,6
1515915625546118142,11,3,134.76,4,3,3,10
1515915625546121541,91,1,48.84,2,1,2,5
1515915625546121879,92,1,373.46,2,1,4,7
1515915625546125751,76,3,681.9000000000001,2,3,4,9
1515915625546130346,92,1,71.75,2,1,2,5
1515915625546136197,92,1,32.86,2,1,2,5
1515915625546136380,87,2,56.44,2,2,2,6
1515915625546137343,92,1,18.41,2,1,1,4
1515915625546138803,92,3,550.47,2,3,4,9
1515915625546143393,92,1,449.51,2,1,4,7
1515915625546145305,91,3,96.66,2,3,3,8
1515915625546147499,92,1,71.29,2,1,2,5
1515915625546147523,92,2,142.58,2,2,3,7
1515915625546148045,92,1,33.86,2,1,2,5
1515915625546150450,89,3,166.2,2,3,3,8
1515915625546153433,92,2,64.44,2,2,2,6
1515915625546163545,92,1,187.78,2,1,3,6
1515915625546164148,92,1,369.35,2,1,4,7
1515915625546166377,92,2,155.56,2,2,3,7
1515915625546172096,92,2,132.58,2,2,3,7
1515915625546178911,14,3,93.81,4,3,3,10
1515915625546185435,92,1,125.08,2,1,3,6
1515915625546185836,91,1,373.46,2,1,4,7
1515915625546188246,92,1,125.08,2,1,3,6
1515915625546188912,92,1,125.08,2,1,3,6
1515915625546189490,92,1,44.05,2,1,2,5
1515915625546189858,92,1,13.29,2,1,1,4
1515915625546190226,92,2,519.88,2,2,4,8
1515915625546190873,92,1,13.52,2,1,1,4
1515915625546193502,92,1,21.21,2,1,1,4
1515915625546195178,92,1,39.05,2,1,2,5
1515915625546196301,92,1,82.63,2,1,2,5
1515915625546198691,91,3,66.47,2,3,2,7
1515915625546203462,92,2,174.05,2,2,3,7
1515915625546204363,92,1,82.97,2,1,2,5
1515915625546208652,84,3,70.47,2,3,2,7
1515915625546211704,68,1,126.68,3,1,3,7
1515915625546213174,88,1,22.02,2,1,1,4
1515915625546217118,92,3,45.24,2,3,2,7
1515915625546219633,92,1,10.63,2,1,1,4
1515915625546225055,92,1,577.6,2,1,4,7
1515915625546238996,89,3,642.3,2,3,4,9
1515915625546239353,92,1,414.13,2,1,4,7
1515915625546241705,92,3,112.77000000000001,2,3,3,8
1515915625546244202,92,1,22.22,2,1,1,4
1515915625546244681,23,8,215.56,4,4,3,11
1515915625546246091,92,1,281.06,2,1,3,6
1515915625546246474,92,2,30.2,2,2,1,5
1515915625546248301,85,2,156.6,2,2,3,7
1515915625546253646,70,2,102.8,3,2,3,8
1515915625546257925,92,1,117.75,2,1,3,6
1515915625546265662,92,1,10.1,2,1,1,4
1515915625546266814,92,7,422.81,2,4,4,10
1515915625546266866,92,1,33.02,2,1,2,5
1515915625546267336,92,2,1145.14,2,2,4,8
1515915625546268858,92,1,61.27,2,1,2,5
1515915625546276924,92,1,189.84,2,1,3,6
1515915625546282532,92,1,349.46,2,1,4,7
1515915625546298024,68,1,26.98,3,1,1,5
1515915625546298507,92,1,26.98,2,1,1,4
1515915625546312171,92,2,253.36,2,2,3,7
1515915625546312337,20,1,163.52,4,1,3,8
1515915625546313959,92,1,64.48,2,1,2,5
1515915625546314183,92,1,236.0,2,1,3,6
1515915625546315140,92,1,23.48,2,1,1,4
1515915625546320211,92,1,429.51,2,1,4,7
1515915625546324647,91,2,155.46,2,2,3,7
1515915625546331674,91,1,51.9,2,1,2,5
1515915625546339238,91,1,479.52,2,1,4,7
1515915625546344809,91,1,292.83,2,1,4,7
1515915625546345483,91,2,232.98,2,2,3,7
1515915625546347561,91,1,29.89,2,1,1,4
1515915625546354191,91,1,113.81,2,1,3,6
1515915625546359455,40,6,210.60000000000002,3,4,3,10
1515915625546361049,91,2,107.02,2,2,3,7
1515915625546362008,91,1,36.67,2,1,2,5
1515915625546362198,91,2,1079.14,2,2,4,8
1515915625546362220,91,1,21.43,2,1,1,4
1515915625546363223,91,1,20.73,2,1,1,4
1515915625546366700,91,6,3177.36,2,4,4,10
1515915625546370876,91,1,144.49,2,1,3,6
1515915625546371256,91,1,72.38,2,1,2,5
1515915625546377030,91,1,77.73,2,1,2,5
1515915625546377195,91,2,408.58,2,2,4,8
1515915625546385587,49,3,630.03,3,3,4,10
1515915625546388704,46,6,118.68,3,4,3,10
1515915625546389979,91,3,30.150000000000002,2,3,1,6
1515915625546390512,91,1,737.63,2,1,4,7
1515915625546395129,91,2,233.66,2,2,3,7
1515915625546395482,91,1,55.87,2,1,2,5
1515915625546396752,91,3,162.51,2,3,3,8
1515915625546398259,31,1,15.68,4,1,1,6
1515915625546402630,91,2,63.14,2,2,2,6
1515915625546406657,91,1,21.02,2,1,1,4
1515915625546409349,91,2,52.92,2,2,2,6
1515915625546412134,29,2,30.16,4,2,1,7
1515915625546414062,91,1,399.46,2,1,4,7
1515915625546415394,91,1,183.49,2,1,3,6
1515915625546415587,52,4,48.88,3,3,2,8
1515915625546417154,91,1,136.92,2,1,3,6
1515915625546418437,82,3,1096.1399999999999,2,3,4,9
1515915625546418789,91,1,26.63,2,1,1,4
1515915625546420155,91,1,51.97,2,1,2,5
1515915625546424662,91,1,35.87,2,1,2,5
1515915625546424755,91,1,72.16,2,1,2,5
1515915625546425729,90,3,205.71999999999997,2,3,3,8
1515915625546428610,91,1,16.59,2,1,1,4
1515915625546432558,91,1,205.35,2,1,3,6
1515915625546432966,91,7,1430.03,2,4,4,10
1515915625546442569,54,3,30.48,3,3,1,7
1515915625546442690,91,1,28.97,2,1,1,4
1515915625546443264,91,2,142.1,2,2,3,7
1515915625546444056,49,6,1263.37,3,4,4,11
1515915625546445549,91,1,33.97,2,1,2,5
1515915625546445954,91,1,34.65,2,1,2,5
1515915625546446928,91,1,71.05,2,1,2,5
1515915625546448269,91,2,37.14,2,2,2,6
1515915625546449245,91,2,35.46,2,2,2,6
1515915625546449426,91,1,77.78,2,1,2,5
1515915625546449889,91,1,51.43,2,1,2,5
1515915625546451190,90,1,26.19,2,1,1,4
1515915625546455645,91,1,71.05,2,1,2,5
1515915625546458717,91,1,2.86,2,1,1,4
1515915625546459056,91,6,2883.08,2,4,4,10
1515915625546461842,91,1,57.84,2,1,2,5
1515915625546473552,89,1,34.79,2,1,2,5
1515915625546478403,91,1,12.27,2,1,1,4
1515915625546497096,91,2,264.86,2,2,3,7
1515915625546501199,91,1,2.86,2,1,1,4
1515915625546506011,91,1,479.51,2,1,4,7
1515915625546508508,91,1,444.51,2,1,4,7
1515915625546510765,91,1,72.16,2,1,2,5
1515915625546511124,91,1,524.56,2,1,4,7
1515915625546513253,90,3,241.44,2,3,3,8
1515915625546518172,91,1,13.16,2,1,1,4
1515915625546519453,69,2,31.8,3,2,1,6
1515915625546531340,91,1,23.76,2,1,1,4
1515915625546537136,91,2,39.04,2,2,2,6
1515915625546540613,91,1,26.98,2,1,1,4
1515915625546542350,91,2,101.26,2,2,3,7
1515915625546542693,91,1,37.0,2,1,2,5
1515915625546546574,91,1,35.08,2,1,2,5
1515915625546549140,44,1,397.48,3,1,4,8
1515915625546552275,59,1,30.89,3,1,1,5
1515915625546553622,91,2,515.74,2,2,4,8
1515915625546560098,91,1,249.02,2,1,3,6
1515915625546566776,91,1,189.84,2,1,3,6
1515915625546570620,91,1,18.41,2,1,1,4
1515915625546571626,5,2,102.66,4,2,3,9
1515915625546571872,91,1,223.33,2,1,3,6
1515915625546572017,91,1,223.33,2,1,3,6
1515915625546574184,91,1,9.81,2,1,1,4
1515915625546577281,91,1,21.75,2,1,1,4
1515915625546578907,91,3,105.75,2,3,3,8
1515915625546578912,91,3,612.87,2,3,4,9
1515915625546582001,91,1,22.06,2,1,1,4
1515915625546582542,91,1,14.95,2,1,1,4
1515915625546585562,91,3,157.62,2,3,3,8
1515915625546585887,81,1,1.57,2,1,1,4
1515915625546586697,87,1,65.32,2,1,2,5
1515915625546597557,88,1,114.6,2,1,3,6
1515915625546598881,88,1,144.51,2,1,3,6
1515915625546604591,91,1,26.46,2,1,1,4
1515915625546604679,91,2,41.11,2,2,2,6
1515915625546606818,91,1,11.65,2,1,1,4
1515915625546607232,91,1,43.33,2,1,2,5
1515915625546607683,91,3,904.17,2,3,4,9
1515915625546612341,49,1,64.48,3,1,2,6
1515915625546614827,89,2,740.92,2,2,4,8
1515915625546615316,91,2,355.74,2,2,4,8
1515915625546619734,90,1,73.32,2,1,2,5
1515915625546621269,91,1,31.87,2,1,1,4
1515915625546628287,91,1,16.83,2,1,1,4
1515915625546629772,89,1,130.16,2,1,3,6
1515915625546630581,91,1,50.79,2,1,2,5
1515915625546632342,91,2,33.96,2,2,2,6
1515915625546635140,91,1,16.35,2,1,1,4
1515915625546644473,91,2,30.16,2,2,1,5
1515915625546645519,91,1,23.81,2,1,1,4
1515915625546646443,91,1,11.13,2,1,1,4
1515915625546648313,91,1,109.62,2,1,3,6
1515915625546651006,91,1,51.63,2,1,2,5
1515915625546651603,91,1,214.1,2,1,3,6
1515915625546652859,90,3,452.37,2,3,4,9
1515915625546653129,71,1,65.08,3,1,2,6
1515915625546655049,91,2,30.16,2,2,1,5
1515915625546658687,36,3,721.03,3,3,4,10
1515915625546661549,91,1,147.21,2,1,3,6
1515915625546663778,51,2,30.16,3,2,1,6
1515915625546665664,91,4,110.48,2,3,3,8
1515915625546673665,91,1,34.3,2,1,2,5
1515915625546674153,91,1,11.11,2,1,1,4
1515915625546676068,91,1,11.11,2,1,1,4
1515915625546678091,91,4,120.4,2,3,3,8
1515915625546678216,91,1,83.97,2,1,2,5
1515915625546678830,90,1,37.46,2,1,2,5
1515915625546679026,91,1,230.35,2,1,3,6
1515915625546690675,91,2,318.2,2,2,4,8
1515915625546692454,91,1,33.08,2,1,2,5
1515915625546692767,91,1,68.06,2,1,2,5
1515915625546702147,90,1,136.92,2,1,3,6
1515915625546703055,90,1,46.35,2,1,2,5
1515915625546705976,90,1,43.03,2,1,2,5
1515915625546712721,90,1,58.25,2,1,2,5
1515915625546717912,90,1,21.84,2,1,1,4
1515915625546722312,90,3,120.57,2,3,3,8
1515915625546724564,90,2,76.2,2,2,2,6
1515915625546726586,90,1,249.03,2,1,3,6
1515915625546727510,59,2,385.72,3,2,4,9
1515915625546730323,90,1,441.49,2,1,4,7
1515915625546737223,90,2,135.58,2,2,3,7
1515915625546737842,90,1,40.9,2,1,2,5
1515915625546738184,90,2,32.38,2,2,2,6
1515915625546738240,90,1,57.13,2,1,2,5
1515915625546738649,79,1,63.33,2,1,2,5
1515915625546740110,90,1,38.1,2,1,2,5
1515915625546744820,90,1,201.33,2,1,3,6
1515915625546747830,90,1,13.65,2,1,1,4
1515915625546751545,90,3,321.99,2,3,4,9
1515915625546757095,90,1,15.9,2,1,1,4
1515915625546757435,90,2,30.16,2,2,1,5
1515915625546758139,90,2,23.62,2,2,1,5
1515915625546758469,90,1,10.24,2,1,1,4
1515915625546758736,90,1,56.62,2,1,2,5
1515915625546761480,21,1,150.65,4,1,3,8
1515915625546763561,90,1,32.22,2,1,1,4
1515915625546767497,90,4,477.74,2,3,4,9
1515915625546771833,90,1,1.57,2,1,1,4
1515915625546772557,36,1,53.17,3,1,2,6
1515915625546773039,90,1,30.38,2,1,1,4
1515915625546773326,90,1,8.7,2,1,1,4
1515915625546773409,75,11,1133.45,2,4,4,10
1515915625546774231,90,2,40.26,2,2,2,6
1515915625546775460,90,1,111.92,2,1,3,6
1515915625546781407,90,1,21.43,2,1,1,4
1515915625546789525,90,1,20.48,2,1,1,4
1515915625546790440,90,1,86.51,2,1,2,5
1515915625546797733,90,1,13.65,2,1,1,4
1515915625546797956,90,2,27.62,2,2,1,5
1515915625546798062,14,2,172.96,4,2,3,9
1515915625546799213,90,1,43.11,2,1,2,5
1515915625546807222,90,1,155.11,2,1,3,6
1515915625546815576,88,1,23.76,2,1,1,4
1515915625546816423,90,1,164.33,2,1,3,6
1515915625546817285,90,1,87.16,2,1,2,5
1515915625546818123,90,1,55.87,2,1,2,5
1515915625546821257,90,1,11.98,2,1,1,4
1515915625546821749,89,1,14.08,2,1,1,4
1515915625546823154,59,1,20.79,3,1,1,5
1515915625546831925,90,1,21.43,2,1,1,4
1515915625546832094,90,1,204.29,2,1,3,6
1515915625546839415,90,2,298.1,2,2,4,8
1515915625546839726,90,2,30.2,2,2,1,5
1515915625546841242,90,2,460.28,2,2,4,8
1515915625546842015,88,2,48.26,2,2,2,6
1515915625546843030,90,1,203.02,2,1,3,6
1515915625546846115,90,1,204.29,2,1,3,6
1515915625546846815,90,1,376.11,2,1,4,7
1515915625546851968,90,1,29.68,2,1,1,4
1515915625546852662,90,3,263.53999999999996,2,3,3,8
1515915625546858164,83,1,20.63,2,1,1,4
1515915625546865307,90,6,930.5999999999999,2,4,4,10
1515915625546865915,90,2,35.24,2,2,2,6
1515915625546866674,79,1,31.11,2,1,1,4
1515915625546867498,90,1,24.6,2,1,1,4
1515915625546870618,89,1,136.05,2,1,3,6
1515915625546873383,90,1,16.98,2,1,1,4
1515915625546876924,90,3,183.87,2,3,3,8
1515915625546877231,90,4,457.07,2,3,4,9
1515915625546881155,90,2,194.7,2,2,3,7
1515915625546888328,90,2,112.76,2,2,3,7
1515915625546889269,90,1,214.1,2,1,3,6
1515915625546889873,90,1,10.05,2,1,1,4
1515915625546890571,45,1,27.84,3,1,1,5
1515915625546894966,90,2,252.2,2,2,3,7
1515915625546899376,90,2,32.66,2,2,2,6
1515915625546913396,90,1,349.46,2,1,4,7
1515915625546913559,90,2,49.4,2,2,2,6
1515915625546915252,90,4,110.6,2,3,3,8
1515915625546915994,90,3,1732.8000000000002,2,3,4,9
1515915625546916827,90,1,21.43,2,1,1,4
1515915625546921223,90,1,482.52,2,1,4,7
1515915625546922297,90,2,64.76,2,2,2,6
1515915625546923390,90,2,3.14,2,2,1,5
1515915625546923765,89,1,197.46,2,1,3,6
1515915625546927258,89,5,63.76,2,4,2,8
1515915625546928260,90,1,228.05,2,1,3,6
1515915625546948123,89,1,265.13,2,1,3,6
1515915625546948776,90,1,82.06,2,1,2,5
1515915625546951428,90,1,1.57,2,1,1,4
1515915625546951695,29,1,32.81,4,1,2,7
1515915625546952004,90,1,371.46,2,1,4,7
1515915625546958288,90,3,433.53,2,3,4,9
1515915625546962138,90,1,123.44,2,1,3,6
1515915625546963279,42,1,176.17,3,1,3,7
1515915625546973045,90,1,31.11,2,1,1,4
1515915625546974993,90,1,577.6,2,1,4,7
1515915625546983234,89,3,14.370000000000001,2,3,1,6
1515915625546985627,90,2,19.9,2,2,1,5
1515915625546991473,82,3,181.9,2,3,3,8
1515915625546997813,78,2,32.1,2,2,1,5
1515915625547000506,90,3,75.99,2,3,2,7
1515915625547001964,90,1,18.3,2,1,1,4
1515915625547005828,90,1,67.97,2,1,2,5
1515915625547006265,90,5,339.85,2,4,4,10
1515915625547007430,90,2,64.44,2,2,2,6
1515915625547009235,72,2,125.42,3,2,3,8
1515915625547014610,90,1,42.98,2,1,2,5
1515915625547015376,90,2,28.58,2,2,1,5
1515915625547019711,90,4,99.68,2,3,3,8
1515915625547022394,90,5,182.54999999999998,2,4,3,9
1515915625547031463,90,2,192.74,2,2,3,7
1515915625547035837,90,1,42.7,2,1,2,5
1515915625547043293,90,1,113.17,2,1,3,6
1515915625547045485,77,3,70.44,2,3,2,7
1515915625547047461,35,3,1058.04,4,3,4,11
1515915625547048146,90,4,1200.68,2,3,4,9
1515915625547053471,90,1,70.32,2,1,2,5
1515915625547060932,43,2,75.94,3,2,2,7
1515915625547077578,85,1,10.1,2,1,1,4
1515915625547078557,90,1,123.79,2,1,3,6
1515915625547091692,90,1,42.95,2,1,2,5
1515915625547097950,90,1,80.06,2,1,2,5
1515915625547103641,87,2,953.3299999999999,2,2,4,8
1515915625547107024,90,1,87.7,2,1,2,5
1515915625547110189,90,1,97.41,2,1,3,6
1515915625547120376,90,1,25.73,2,1,1,4
1515915625547165133,89,3,612.87,2,3,4,9
1515915625547183767,89,2,3.14,2,2,1,5
1515915625547183880,89,2,15.46,2,2,1,5
1515915625547192084,89,1,32.86,2,1,2,5
1515915625547193105,89,3,53.19,2,3,2,7
1515915625547197685,89,1,373.02,2,1,4,7
1515915625547199238,89,2,90.8,2,2,3,7
1515915625547201326,89,2,1079.14,2,2,4,8
1515915625547203523,89,2,30.2,2,2,1,5
1515915625547204362,89,1,154.32,2,1,3,6
1515915625547212139,87,4,1456.6100000000001,2,3,4,9
1515915625547216037,89,3,252.81,2,3,3,8
1515915625547219568,89,1,9.35,2,1,1,4
1515915625547228222,89,2,112.54,2,2,3,7
1515915625547228257,88,3,1798.8000000000002,2,3,4,9
1515915625547229434,89,1,672.63,2,1,4,7
1515915625547234261,89,2,193.72,2,2,3,7
1515915625547238730,89,1,220.68,2,1,3,6
1515915625547240612,38,16,8639.69,3,4,4,11
1515915625547253784,89,1,31.32,2,1,1,4
1515915625547272408,89,1,11.62,2,1,1,4
1515915625547273937,89,2,108.26,2,2,3,7
1515915625547275865,77,1,23.81,2,1,1,4
1515915625547277344,89,3,43.86,2,3,2,7
1515915625547282237,89,1,599.6,2,1,4,7
1515915625547286828,86,2,27.46,2,2,1,5
1515915625547287104,89,2,140.32,2,2,3,7
1515915625547291163,89,3,510.0,2,3,4,9
1515915625547294439,89,1,17.78,2,1,1,4
1515915625547302044,89,4,50.32,2,3,2,7
1515915625547302689,89,2,102.7,2,2,3,7
1515915625547304529,89,1,62.37,2,1,2,5
1515915625547304801,89,1,82.86,2,1,2,5
1515915625547314413,82,4,128.88,2,3,3,8
1515915625547322627,89,1,229.38,2,1,3,6
1515915625547327252,89,1,163.52,2,1,3,6
1515915625547327649,89,5,1747.3,2,4,4,10
1515915625547327954,89,1,172.89,2,1,3,6
1515915625547328965,48,2,43.89,3,2,2,7
1515915625547333716,84,3,101.27000000000001,2,3,3,8
1515915625547333763,89,3,629.0999999999999,2,3,4,9
1515915625547337353,89,3,116.49,2,3,3,8
1515915625547337920,89,2,46.96,2,2,2,6
1515915625547338334,89,1,204.29,2,1,3,6
1515915625547342871,89,2,104.1,2,2,3,7
1515915625547348448,89,1,87.54,2,1,2,5
1515915625547350976,89,1,5.0,2,1,1,4
1515915625547356093,89,1,72.19,2,1,2,5
1515915625547357756,89,1,70.6,2,1,2,5
1515915625547358727,89,1,15.92,2,1,1,4
1515915625547360275,89,1,409.49,2,1,4,7
1515915625547364720,35,4,516.2,4,3,4,11
1515915625547371751,88,1,259.38,2,1,3,6
1515915625547371989,89,2,88.35,2,2,2,6
1515915625547373125,89,1,173.67,2,1,3,6
1515915625547373903,31,1,62.03,4,1,2,7
1515915625547379145,89,1,486.81,2,1,4,7
1515915625547382321,89,4,253.32,2,3,3,8
1515915625547382493,89,1,38.49,2,1,2,5
1515915625547382940,89,1,201.33,2,1,3,6
1515915625547383638,89,1,486.81,2,1,4,7
1515915625547385020,89,1,14.86,2,1,1,4
1515915625547388689,89,1,26.46,2,1,1,4
1515915625547390642,89,1,53.33,2,1,2,5
1515915625547391365,89,1,26.19,2,1,1,4
1515915625547393638,89,1,1.57,2,1,1,4
1515915625547400398,89,1,257.87,2,1,3,6
1515915625547403779,88,4,846.36,2,3,4,9
1515915625547411239,89,1,17.62,2,1,1,4
1515915625547414716,89,1,15.24,2,1,1,4
1515915625547419957,80,4,310.92,2,3,4,9
1515915625547420179,88,1,15.24,2,1,1,4
1515915625547420900,89,1,9.35,2,1,1,4
1515915625547430968,89,1,18.89,2,1,1,4
1515915625547434749,89,2,68.26,2,2,2,6
1515915625547450416,89,1,25.71,2,1,1,4
1515915625547462853,89,1,103.83,2,1,3,6
1515915625547465048,87,2,64.44,2,2,2,6
1515915625547470336,89,1,9.95,2,1,1,4
1515915625547473750,84,2,287.18,2,2,3,7
1515915625547482360,89,1,12.7,2,1,1,4
1515915625547485715,89,1,20.48,2,1,1,4
1515915625547493831,84,8,700.24,2,4,4,10
1515915625547506891,89,3,43.8,2,3,2,7
1515915625547509095,87,1,453.98,2,1,4,7
1515915625547521420,89,1,14.08,2,1,1,4
1515915625547524677,84,2,64.44,2,2,2,6
1515915625547525950,89,1,127.08,2,1,3,6
1515915625547531095,89,1,61.16,2,1,2,5
1515915625547531981,89,1,43.57,2,1,2,5
1515915625547534801,89,1,141.73,2,1,3,6
1515915625547536808,89,1,59.52,2,1,2,5
1515915625547543651,41,1,43.19,3,1,2,6
1515915625547548806,88,1,131.25,2,1,3,6
1515915625547564947,89,1,649.57,2,1,4,7
1515915625547565506,89,2,18.66,2,2,1,5
1515915625547566599,89,1,1.57,2,1,1,4
1515915625547566641,89,1,130.0,2,1,3,6
1515915625547571099,87,1,435.7,2,1,4,7
1515915625547572557,89,2,31.74,2,2,1,5
1515915625547583764,86,2,66.38,2,2,2,6
1515915625547588607,89,1,61.16,2,1,2,5
1515915625547592950,89,2,325.02,2,2,4,8
1515915625547598898,89,1,9.35,2,1,1,4
1515915625547607593,89,1,55.87,2,1,2,5
1515915625547609014,89,2,64.44,2,2,2,6
1515915625547612623,89,2,141.2,2,2,3,7
1515915625547616308,88,1,229.38,2,1,3,6
1515915625547622661,88,1,28.24,2,1,1,4
1515915625547624659,76,1,204.29,2,1,3,6
1515915625547632621,88,3,63.81,2,3,2,7
1515915625547723500,88,1,74.94,2,1,2,5
1515915625547727994,88,1,190.32,2,1,3,6
1515915625547744323,88,1,18.84,2,1,1,4
1515915625547745285,81,2,135.18,2,2,3,7
1515915625547745516,88,5,69.3,2,4,2,8
1515915625547754152,88,1,50.11,2,1,2,5
1515915625547756472,65,1,19.46,3,1,1,5
1515915625547758374,88,1,32.97,2,1,2,5
1515915625547760075,88,1,32.22,2,1,1,4
1515915625547760600,88,1,16.29,2,1,1,4
1515915625547763817,88,5,130.95000000000002,2,4,3,9
1515915625547764385,88,2,86.22,2,2,2,6
1515915625547766669,88,2,28.16,2,2,1,5
1515915625547771814,2,3,82.86,4,3,2,9
1515915625547773774,84,14,1905.05,2,4,4,10
1515915625547777015,88,1,25.33,2,1,1,4
1515915625547780179,76,4,494.71999999999997,2,3,4,9
1515915625547780970,88,1,22.49,2,1,1,4
1515915625547784747,88,2,53.96,2,2,2,6
1515915625547785828,88,1,58.78,2,1,2,5
1515915625547786891,88,1,203.29,2,1,3,6
1515915625547788760,88,1,119.37,2,1,3,6
1515915625547796263,88,1,54.29,2,1,2,5
1515915625547796794,88,2,420.38,2,2,4,8
1515915625547797540,12,1,6.0,4,1,1,6
1515915625547799040,48,1,357.35,3,1,4,8
1515915625547804850,88,1,125.03,2,1,3,6
1515915625547811338,88,1,18.25,2,1,1,4
1515915625547812621,88,2,22.26,2,2,1,5
1515915625547812769,67,3,1399.56,3,3,4,10
1515915625547821076,88,2,60.48,2,2,2,6
1515915625547821253,88,1,15.1,2,1,1,4
1515915625547833371,88,1,35.41,2,1,2,5
1515915625547836397,88,1,82.97,2,1,2,5
1515915625547837949,80,3,1369.53,2,3,4,9
1515915625547846521,88,1,95.08,2,1,3,6
1515915625547850691,88,1,1.57,2,1,1,4
1515915625547853983,88,1,22.22,2,1,1,4
1515915625547855324,88,5,150.7,2,4,3,9
1515915625547866212,88,2,27.46,2,2,1,5
1515915625547869540,88,1,142.05,2,1,3,6
1515915625547871350,80,1,18.19,2,1,1,4
1515915625547872338,88,1,23.7,2,1,1,4
1515915625547884379,88,2,104.76,2,2,3,7
1515915625547887162,88,1,26.19,2,1,1,4
1515915625547899479,88,4,128.88,2,3,3,8
1515915625547901674,88,1,201.33,2,1,3,6
1515915625547908010,88,2,72.6,2,2,2,6
1515915625547913666,70,8,156.3,3,4,3,10
1515915625547919316,88,1,236.0,2,1,3,6
1515915625547921333,84,3,280.53000000000003,2,3,3,8
1515915625547923159,88,1,24.76,2,1,1,4
1515915625547927043,84,1,87.16,2,1,2,5
1515915625547929789,88,1,397.48,2,1,4,7
1515915625547931996,70,4,106.52,3,3,3,9
1515915625547934203,88,1,12.65,2,1,1,4
1515915625547941787,88,1,376.11,2,1,4,7
1515915625547955131,85,6,667.41,2,4,4,10
1515915625547973880,35,1,284.3,4,1,3,8
1515915625547977499,74,2,682.89,2,2,4,8
1515915625547982484,88,1,396.83,2,1,4,7
1515915625547996441,88,1,23.57,2,1,1,4
1515915625547999241,88,2,112.54,2,2,3,7
1515915625548028418,88,1,16.19,2,1,1,4
1515915625548031047,88,1,793.49,2,1,4,7
1515915625548058694,88,1,65.97,2,1,2,5
1515915625548063505,88,1,5.16,2,1,1,4
1515915625548071399,74,4,680.0,2,3,4,9
1515915625548074095,88,1,57.62,2,1,2,5
1515915625548079434,72,1,35.08,3,1,2,6
1515915625548087567,88,3,656.9399999999999,2,3,4,9
1515915625548097556,79,3,82.86,2,3,2,7
1515915625548111050,49,2,45.4,3,2,2,7
1515915625548115361,83,1,190.73,2,1,3,6
1515915625548121674,84,1,12.25,2,1,1,4
1515915625548124511,88,2,46.04,2,2,2,6
1515915625548129731,88,1,55.35,2,1,2,5
1515915625548132777,82,1,32.76,2,1,2,5
1515915625548140453,86,1,70.6,2,1,2,5
1515915625548142597,88,1,136.05,2,1,3,6
1515915625548143528,88,1,481.98,2,1,4,7
1515915625548147104,81,1,55.65,2,1,2,5
1515915625548150606,88,2,328.66,2,2,4,8
1515915625548151439,88,1,4.86,2,1,1,4
1515915625548157959,88,1,41.75,2,1,2,5
1515915625548158726,88,1,69.71,2,1,2,5
1515915625548159689,88,3,221.43,2,3,3,8
1515915625548160267,88,2,46.5,2,2,2,6
1515915625548160425,57,1,60.32,3,1,2,6
1515915625548163399,88,1,15.08,2,1,1,4
1515915625548170405,88,1,28.1,2,1,1,4
1515915625548170952,88,1,15.87,2,1,1,4
1515915625548172524,88,2,111.52,2,2,3,7
1515915625548182904,88,1,97.35,2,1,3,6
1515915625548184216,76,3,254.85000000000002,2,3,3,8
1515915625548184452,88,1,13.65,2,1,1,4
1515915625548185447,71,2,68.66,3,2,2,7
1515915625548187472,88,1,40.0,2,1,2,5
1515915625548188013,88,1,29.22,2,1,1,4
1515915625548191641,88,1,42.7,2,1,2,5
1515915625548192066,88,1,21.43,2,1,1,4
1515915625548194051,36,1,173.86,3,1,3,7
1515915625548194561,49,1,259.38,3,1,3,7
1515915625548195017,87,2,62.22,2,2,2,6
1515915625548211998,88,2,31.74,2,2,1,5
1515915625548212306,88,1,292.83,2,1,4,7
1515915625548212591,88,2,52.38,2,2,2,6
1515915625548222387,88,1,149.21,2,1,3,6
1515915625548223061,88,1,247.4,2,1,3,6
1515915625548228755,88,1,86.37,2,1,2,5
1515915625548230440,86,6,1332.36,2,4,4,10
1515915625548238640,88,1,20.71,2,1,1,4
1515915625548239315,88,1,107.33,2,1,3,6
1515915625548240049,87,3,680.52,2,3,4,9
1515915625548271835,87,1,26.98,2,1,1,4
1515915625548272391,81,1,18.7,2,1,1,4
1515915625548279765,30,2,54.8,4,2,2,8
1515915625548288555,87,1,164.33,2,1,3,6
1515915625548289935,87,1,11.86,2,1,1,4
1515915625548302451,87,1,204.29,2,1,3,6
1515915625548303379,87,1,55.87,2,1,2,5
1515915625548309274,87,1,28.73,2,1,1,4
1515915625548321203,87,1,207.78,2,1,3,6
1515915625548331187,87,1,397.48,2,1,4,7
1515915625548332710,87,1,51.33,2,1,2,5
1515915625548338663,87,2,147.62,2,2,3,7
1515915625548346126,33,1,17.1,4,1,1,6
1515915625548353904,87,1,85.08,2,1,2,5
1515915625548356145,87,1,61.27,2,1,2,5
1515915625548357361,86,1,31.11,2,1,1,4
1515915625548357380,87,1,10.83,2,1,1,4
1515915625548361500,87,2,254.16,2,2,3,7
1515915625548406435,87,1,78.3,2,1,2,5
1515915625548417838,87,2,1002.0799999999999,2,2,4,8
1515915625548419361,84,2,174.32,2,2,3,7
1515915625548454370,26,1,143.81,4,1,3,8
1515915625548457668,87,1,240.11,2,1,3,6
1515915625548461437,83,4,3837.52,2,3,4,9
1515915625548476024,87,1,73.81,2,1,2,5
1515915625548478176,87,1,16.65,2,1,1,4
1515915625548485084,87,2,42.65,2,2,2,6
1515915625548485331,87,1,81.14,2,1,2,5
1515915625548488473,71,1,105.87,3,1,3,7
1515915625548492444,84,2,115.72,2,2,3,7
1515915625548500941,87,1,82.97,2,1,2,5
1515915625548505793,87,1,171.9,2,1,3,6
1515915625548507477,87,1,14.6,2,1,1,4
1515915625548515482,87,2,58.42,2,2,2,6
1515915625548516147,87,1,176.17,2,1,3,6
1515915625548518410,87,2,81.9,2,2,2,6
1515915625548520907,87,1,22.56,2,1,1,4
1515915625548521260,80,1,204.6,2,1,3,6
1515915625548524878,87,1,29.22,2,1,1,4
1515915625548530962,87,4,99.04,2,3,3,8
1515915625548532048,87,1,40.54,2,1,2,5
1515915625548537108,82,2,109.9,2,2,3,7
1515915625548537219,87,1,103.83,2,1,3,6
1515915625548541095,87,1,19.6,2,1,1,4
1515915625548541492,87,1,46.98,2,1,2,5
1515915625548541907,57,3,60.42,3,3,2,8
1515915625548542847,87,3,578.58,2,3,4,9
1515915625548543101,80,3,380.04,2,3,4,9
1515915625548551507,87,1,90.48,2,1,2,5
1515915625548560537,87,2,206.48,2,2,3,7
1515915625548564650,87,2,245.72,2,2,3,7
1515915625548565164,87,1,118.57,2,1,3,6
1515915625548571061,87,1,9.35,2,1,1,4
1515915625548571676,87,2,78.92,2,2,2,6
1515915625548578346,87,1,214.1,2,1,3,6
1515915625548583493,87,1,65.71,2,1,2,5
1515915625548585678,86,3,94.44,2,3,3,8
1515915625548592121,87,1,135.24,2,1,3,6
1515915625548592669,87,1,12.43,2,1,1,4
1515915625548595569,87,1,30.16,2,1,1,4
1515915625548611004,87,1,11.86,2,1,1,4
1515915625548614251,87,1,29.57,2,1,1,4
1515915625548630220,87,1,15.24,2,1,1,4
1515915625548645630,87,1,22.92,2,1,1,4
1515915625548651383,87,4,138.48,2,3,3,8
1515915625548655749,87,1,29.22,2,1,1,4
1515915625548656746,87,1,10.48,2,1,1,4
1515915625548657075,40,2,102.66,3,2,3,8
1515915625548660836,87,1,371.46,2,1,4,7
1515915625548662455,87,1,10.92,2,1,1,4
1515915625548664376,65,1,274.4,3,1,3,7
1515915625548684761,86,1,292.83,2,1,4,7
1515915625548685980,27,2,68.26,4,2,2,8
1515915625548686643,86,1,66.03,2,1,2,5
1515915625548700790,87,1,29.21,2,1,1,4
1515915625548706493,87,2,253.36,2,2,3,7
1515915625548718206,4,2,115.58,4,2,3,9
1515915625548718580,87,3,204.99,2,3,3,8
1515915625548730646,87,1,251.92,2,1,3,6
1515915625548745647,86,4,1525.84,2,3,4,9
1515915625548747928,87,1,138.43,2,1,3,6
1515915625548751179,87,2,253.36,2,2,3,7
1515915625548755466,87,1,539.57,2,1,4,7
1515915625548755527,86,11,2306.7,2,4,4,10
1515915625548758735,87,2,26.8,2,2,1,5
1515915625548763864,87,1,126.68,2,1,3,6
1515915625548771236,87,1,10.95,2,1,1,4
1515915625548779697,87,1,64.44,2,1,2,5
1515915625548781998,86,1,229.52,2,1,3,6
1515915625548802154,86,1,52.49,2,1,2,5
1515915625548806072,86,2,160.7,2,2,3,7
1515915625548807024,86,1,23.48,2,1,1,4
1515915625548807067,86,1,52.49,2,1,2,5
1515915625548815945,86,2,132.06,2,2,3,7
1515915625548816475,86,1,122.86,2,1,3,6
1515915625548823851,86,3,380.04,2,3,4,9
1515915625548827719,86,2,83.12,2,2,2,6
1515915625548830860,86,1,34.44,2,1,2,5
1515915625548832809,86,1,32.22,2,1,1,4
1515915625548841177,86,1,116.05,2,1,3,6
1515915625548844145,86,1,20.73,2,1,1,4
1515915625548848714,86,1,376.11,2,1,4,7
1515915625548852582,86,1,205.49,2,1,3,6
1515915625548855034,86,1,21.9,2,1,1,4
1515915625548855645,86,1,62.7,2,1,2,5
1515915625548855876,62,2,125.4,3,2,3,8
1515915625548866715,86,4,212.44,2,3,3,8
1515915625548868986,86,1,32.81,2,1,2,5
1515915625548869308,86,1,36.79,2,1,2,5
1515915625548870416,86,1,15.46,2,1,1,4
1515915625548870789,86,1,26.46,2,1,1,4
1515915625548875887,86,2,808.98,2,2,4,8
1515915625548880597,86,1,43.79,2,1,2,5
1515915625548887676,86,1,68.46,2,1,2,5
1515915625548895013,86,4,54.08,2,3,2,7
1515915625548896844,86,2,131.5,2,2,3,7
1515915625548900981,86,1,231.24,2,1,3,6
1515915625548904613,86,2,577.8,2,2,4,8
1515915625548913379,86,1,43.11,2,1,2,5
1515915625548917191,86,1,20.95,2,1,1,4
1515915625548919634,86,1,24.41,2,1,1,4
1515915625548926400,86,1,23.33,2,1,1,4
1515915625548926896,86,1,141.75,2,1,3,6
1515915625548932564,86,1,32.86,2,1,2,5
1515915625548939863,86,3,230.25,2,3,3,8
1515915625548943273,86,1,18.78,2,1,1,4
1515915625548950387,86,1,11.43,2,1,1,4
1515915625548959094,86,3,380.04,2,3,4,9
1515915625548960413,86,1,418.48,2,1,4,7
1515915625548960511,66,1,42.71,3,1,2,6
1515915625548965879,85,2,36.2,2,2,2,6
1515915625548970553,86,1,1.57,2,1,1,4
1515915625548973176,86,2,753.95,2,2,4,8
1515915625548974841,85,2,933.04,2,2,4,8
1515915625548975480,84,2,933.04,2,2,4,8
1515915625548979668,86,1,10.08,2,1,1,4
1515915625548992479,59,1,14.86,3,1,1,5
1515915625548995173,86,1,14.02,2,1,1,4
1515915625548999578,86,1,52.9,2,1,2,5
1515915625549001595,86,1,10.52,2,1,1,4
1515915625549010194,86,3,450.87,2,3,4,9
1515915625549010869,85,1,349.92,2,1,4,7
1515915625549014235,48,2,794.96,3,2,4,9
1515915625549032799,86,1,600.6,2,1,4,7
1515915625549033156,86,1,20.19,2,1,1,4
1515915625549034607,86,1,106.52,2,1,3,6
1515915625549034828,84,1,56.03,2,1,2,5
1515915625549035351,86,1,26.46,2,1,1,4
1515915625549040520,86,1,36.73,2,1,2,5
1515915625549045077,86,1,43.17,2,1,2,5
1515915625549047645,86,2,45.08,2,2,2,6
1515915625549053335,86,1,486.81,2,1,4,7
1515915625549068588,86,1,92.05,2,1,3,6
1515915625549069103,86,1,249.02,2,1,3,6
1515915625549091127,85,3,1048.3799999999999,2,3,4,9
1515915625549093136,28,2,39.36,4,2,2,8
1515915625549093896,86,1,397.48,2,1,4,7
1515915625549100889,86,2,83.84,2,2,2,6
1515915625549108390,84,3,213.81,2,3,3,8
1515915625549111224,86,2,27.72,2,2,1,5
1515915625549113811,86,1,33.19,2,1,2,5
1515915625549160615,76,2,831.08,2,2,4,8
1515915625549161924,86,1,19.52,2,1,1,4
1515915625549181534,86,2,16.0,2,2,1,5
1515915625549200426,86,2,32.1,2,2,1,5
1515915625549204783,86,2,302.64,2,2,4,8
1515915625549207394,86,1,35.25,2,1,2,5
1515915625549209667,86,2,112.54,2,2,3,7
1515915625549210997,86,1,42.57,2,1,2,5
1515915625549213152,86,1,249.02,2,1,3,6
1515915625549214231,86,1,34.44,2,1,2,5
1515915625549215849,86,6,188.88,2,4,3,9
1515915625549215913,82,1,1.57,2,1,1,4
1515915625549226355,85,3,202.86,2,3,3,8
1515915625549226507,86,2,33.75,2,2,2,6
1515915625549228432,86,1,18.89,2,1,1,4
1515915625549232061,86,2,190.42,2,2,3,7
1515915625549268249,86,1,482.52,2,1,4,7
1515915625549311640,85,1,32.86,2,1,2,5
1515915625549528965,85,1,34.44,2,1,2,5
1515915625549537187,85,1,17.9,2,1,1,4
1515915625549592119,85,1,56.14,2,1,2,5
1515915625549676018,85,2,399.4,2,2,4,8
1515915625549839163,85,1,259.38,2,1,3,6
1515915625549873537,85,1,15.9,2,1,1,4
1515915625549875589,85,1,29.84,2,1,1,4
1515915625549925755,85,1,16.19,2,1,1,4
1515915625549944591,37,1,154.32,3,1,3,7
1515915625549953221,85,2,64.44,2,2,2,6
1515915625549953862,85,1,13.97,2,1,1,4
1515915625549957829,85,1,21.27,2,1,1,4
1515915625549967348,85,1,16.19,2,1,1,4
1515915625549987614,85,1,40.48,2,1,2,5
1515915625550016333,85,1,52.49,2,1,2,5
1515915625550021319,85,1,398.7,2,1,4,7
1515915625550039142,84,20,4971.52,2,4,4,10
1515915625550039182,84,5,1244.3500000000001,2,4,4,10
1515915625550079840,85,1,42.81,2,1,2,5
1515915625550116052,85,2,42.42,2,2,2,6
1515915625550127221,85,2,23.24,2,2,1,5
1515915625550139259,85,1,26.19,2,1,1,4
1515915625550142890,85,1,32.86,2,1,2,5
1515915625550154938,85,1,119.7,2,1,3,6
1515915625550204522,85,1,34.6,2,1,2,5
1515915625550256409,85,1,46.11,2,1,2,5
1515915625550287294,61,3,380.04,3,3,4,10
1515915625550324398,85,1,30.83,2,1,1,4
1515915625550360932,40,1,672.63,3,1,4,8
1515915625550386945,79,2,55.68,2,2,2,6
1515915625550396664,28,1,1.57,4,1,1,6
1515915625550398155,85,1,9.35,2,1,1,4
1515915625550420887,85,2,453.68,2,2,4,8
1515915625550425186,85,1,9.35,2,1,1,4
1515915625550438749,85,1,22.87,2,1,1,4
1515915625550452532,84,1,257.87,2,1,3,6
1515915625550498804,85,1,22.22,2,1,1,4
1515915625550508890,79,3,62.37,2,3,2,7
1515915625550514104,85,1,15.3,2,1,1,4
1515915625550527542,79,3,323.85,2,3,4,9
1515915625550530118,85,2,32.16,2,2,1,5
1515915625550551270,79,3,81.96000000000001,2,3,2,7
1515915625550553408,85,2,13.34,2,2,1,5
1515915625550556447,84,4,453.52,2,3,4,9
1515915625550557063,85,3,823.1999999999999,2,3,4,9
1515915625550637506,36,4,274.28,3,3,3,9
1515915625550643937,85,1,72.38,2,1,2,5
1515915625550647957,84,11,709.2800000000001,2,4,4,10
1515915625550662767,85,1,397.48,2,1,4,7
1515915625550689746,85,2,64.44,2,2,2,6
1515915625550690090,85,1,349.46,2,1,4,7
1515915625550736473,85,2,52.38,2,2,2,6
1515915625550738682,85,2,630.86,2,2,4,8
1515915625550742029,85,1,22.22,2,1,1,4
1515915625550766260,83,2,86.22,2,2,2,6
1515915625550839588,71,2,260.0,3,2,3,8
1515915625550859896,59,6,162.84,3,4,3,10
1515915625550860808,85,2,406.04,2,2,4,8
1515915625550924847,23,3,306.42,4,3,4,11
1515915625550942798,85,1,399.48,2,1,4,7
1515915625550943440,85,1,71.59,2,1,2,5
1515915625550952747,85,1,12.14,2,1,1,4
1515915625550994704,12,1,13.97,4,1,1,6
1515915625550999684,85,1,371.46,2,1,4,7
1515915625551019542,85,2,64.44,2,2,2,6
1515915625551065451,84,2,27.14,2,2,1,5
1515915625551109814,63,2,632.86,3,2,4,9
1515915625551176112,85,2,110.48,2,2,3,7
1515915625551214051,84,1,672.63,2,1,4,7
1515915625551338231,84,1,19.37,2,1,1,4
1515915625551356686,13,2,322.66999999999996,4,2,4,10
1515915625551439523,54,2,401.39,3,2,4,9
1515915625551462615,84,1,10.76,2,1,1,4
1515915625551464930,82,2,344.4,2,2,4,8
1515915625551482807,84,1,486.81,2,1,4,7
1515915625551484827,84,1,206.19,2,1,3,6
1515915625551507542,84,1,14.78,2,1,1,4
1515915625551522512,84,2,18.7,2,2,1,5
1515915625551563276,84,1,9.84,2,1,1,4
1515915625551572225,84,1,456.51,2,1,4,7
1515915625551603642,77,1,26.98,2,1,1,4
1515915625551611786,84,1,32.22,2,1,1,4
1515915625551641463,84,4,295.32,2,3,4,9
1515915625551680253,58,3,78.57000000000001,3,3,2,8
1515915625551680598,83,2,78.74,2,2,2,6
1515915625551698538,46,1,249.38,3,1,3,7
1515915625551700018,84,1,19.68,2,1,1,4
1515915625551714694,73,2,325.72,2,2,4,8
1515915625551718981,84,3,117.63,2,3,3,8
1515915625551726302,84,3,78.51,2,3,2,7
1515915625551733676,84,1,12.84,2,1,1,4
1515915625551742633,84,2,42.92,2,2,2,6
1515915625551743540,71,1,631.62,3,1,4,8
1515915625551756512,84,1,11.3,2,1,1,4
1515915625551772939,84,1,10.29,2,1,1,4
1515915625551790396,84,1,11.57,2,1,1,4
1515915625551807632,84,1,34.44,2,1,2,5
1515915625551812668,84,3,2017.8899999999999,2,3,4,9
1515915625551815498,84,1,23.3,2,1,1,4
1515915625551817610,67,1,370.46,3,1,4,8
1515915625551829265,84,1,13.57,2,1,1,4
1515915625551829525,84,1,14.44,2,1,1,4
1515915625551830147,84,1,25.57,2,1,1,4
1515915625551830957,84,1,13.57,2,1,1,4
1515915625551835289,84,2,94.28,2,2,3,7
1515915625551850064,84,2,80.94999999999999,2,2,2,6
1515915625551856232,84,1,466.52,2,1,4,7
1515915625551858120,84,1,72.38,2,1,2,5
1515915625551903260,84,1,65.71,2,1,2,5
1515915625551918723,84,1,2886.71,2,1,4,7
1515915625551934177,84,1,25.08,2,1,1,4
1515915625551941960,84,1,20.48,2,1,1,4
1515915625551957359,84,2,64.76,2,2,2,6
1515915625551962081,75,1,75.71,2,1,2,5
1515915625551969556,81,2,559.44,2,2,4,8
1515915625551992227,84,1,15.17,2,1,1,4
1515915625552031530,84,1,65.71,2,1,2,5
1515915625552058382,84,1,122.86,2,1,3,6
1515915625552059438,84,2,30.16,2,2,1,5
1515915625552063753,84,1,13.4,2,1,1,4
1515915625552098414,84,1,7.0,2,1,1,4
1515915625552098737,84,1,105.19,2,1,3,6
1515915625552118259,84,1,15.67,2,1,1,4
1515915625552338485,84,1,27.14,2,1,1,4
1515915625552342133,84,1,30.83,2,1,1,4
1515915625552349657,84,1,145.41,2,1,3,6
1515915625552455624,84,1,13.86,2,1,1,4
1515915625552567927,84,1,84.89,2,1,2,5
1515915625552657735,84,1,1.57,2,1,1,4
1515915625552769491,84,2,12.200000000000001,2,2,1,5
1515915625552895737,55,2,27.3,3,2,1,6
1515915625552920732,84,3,447.15000000000003,2,3,4,9
1515915625552970907,84,1,444.51,2,1,4,7
1515915625553080357,84,1,204.6,2,1,3,6
1515915625553091203,83,1,466.52,2,1,4,7
1515915625553121702,84,4,310.92,2,3,4,9
1515915625553122133,84,1,20.02,2,1,1,4
1515915625553136525,84,1,639.9,2,1,4,7
1515915625553137642,84,3,804.51,2,3,4,9
1515915625553150540,84,1,56.9,2,1,2,5
1515915625553173699,84,1,30.0,2,1,1,4
1515915625553179255,69,1,26.46,3,1,1,5
1515915625553182688,84,1,10.13,2,1,1,4
1515915625553186590,84,6,130.23,2,4,3,9
1515915625553190251,74,1,292.83,2,1,4,7
1515915625553222350,84,1,29.22,2,1,1,4
1515915625553227232,84,2,65.62,2,2,2,6
1515915625553265869,84,1,104.13,2,1,3,6
1515915625553326955,84,2,27.72,2,2,1,5
1515915625553337700,73,1,19.52,2,1,1,4
1515915625553349195,84,2,204.22,2,2,3,7
1515915625553362295,84,1,158.41,2,1,3,6
1515915625553383101,84,2,115.2,2,2,3,7
1515915625553392646,83,2,50.16,2,2,2,6
1515915625553394208,84,1,128.79,2,1,3,6
1515915625553469608,84,1,16.98,2,1,1,4
1515915625553484237,53,1,187.78,3,1,3,7
1515915625553495656,84,3,852.9000000000001,2,3,4,9
1515915625553505542,84,1,224.76,2,1,3,6
1515915625553567707,11,2,22.86,4,2,1,7
1515915625553577137,65,2,97.42,3,2,3,8
1515915625553616138,84,1,354.6,2,1,4,7
1515915625553658501,84,1,24.6,2,1,1,4
1515915625553673184,83,1,32.22,2,1,1,4
1515915625553731137,84,1,48.7,2,1,2,5
1515915625553766622,43,1,292.83,3,1,4,8
1515915625553783408,84,1,257.87,2,1,3,6
1515915625553807389,84,1,17.75,2,1,1,4
1515915625553835540,84,1,115.4,2,1,3,6
1515915625553855386,83,3,34.95,2,3,2,7
1515915625553878562,83,1,78.46,2,1,2,5
1515915625553879241,67,3,102.39000000000001,3,3,3,9
1515915625553942243,49,3,73.80000000000001,3,3,2,8
1515915625553959708,84,1,257.87,2,1,3,6
1515915625553966848,84,2,47.5,2,2,2,6
1515915625553986194,84,1,33.65,2,1,2,5
1515915625554016420,84,1,163.52,2,1,3,6
1515915625554045252,84,3,194.67000000000002,2,3,3,8
1515915625554101430,84,1,55.6,2,1,2,5
1515915625554101502,74,1,257.87,2,1,3,6
1515915625554139688,84,1,256.67,2,1,3,6
1515915625554164225,84,2,565.3,2,2,4,8
1515915625554226372,80,1,149.7,2,1,3,6
1515915625554227765,84,1,201.33,2,1,3,6
1515915625554231327,84,1,201.33,2,1,3,6
1515915625554357898,83,1,15.1,2,1,1,4
1515915625554437050,83,1,61.16,2,1,2,5
1515915625554452428,83,1,75.29,2,1,2,5
1515915625554466123,83,4,44.769999999999996,2,3,2,7
1515915625554518932,83,1,26.19,2,1,1,4
1515915625554560969,83,2,255.56,2,2,3,7
1515915625554653631,83,1,106.0,2,1,3,6
1515915625554668443,83,2,568.6,2,2,4,8
1515915625554715190,83,2,136.92,2,2,3,7
1515915625554733924,83,1,17.46,2,1,1,4
1515915625554752007,26,1,183.6,4,1,3,8
1515915625554754016,83,1,229.38,2,1,3,6
1515915625554765762,83,2,165.78,2,2,3,7
1515915625554814426,83,1,405.49,2,1,4,7
1515915625554824161,83,3,871.89,2,3,4,9
1515915625554848424,83,2,85.96,2,2,2,6
1515915625554884610,83,1,34.44,2,1,2,5
1515915625554887861,83,1,255.03,2,1,3,6
1515915625554898370,83,2,853.72,2,2,4,8
1515915625554929932,83,1,29.7,2,1,1,4
1515915625554959327,73,1,600.6,2,1,4,7
1515915625554982705,83,1,27.32,2,1,1,4
1515915625555081013,83,1,32.22,2,1,1,4
1515915625555109010,80,2,194.92,2,2,3,7
1515915625555110544,83,1,62.02,2,1,2,5
1515915625555118917,83,1,28.86,2,1,1,4
1515915625555130269,83,1,21.75,2,1,1,4
1515915625555138798,83,2,34.98,2,2,2,6
1515915625555139561,83,2,547.24,2,2,4,8
1515915625555186940,83,1,201.33,2,1,3,6
1515915625555187382,83,2,90.0,2,2,2,6
1515915625555208494,70,1,256.81,3,1,3,7
1515915625555240703,83,1,115.4,2,1,3,6
1515915625555242314,83,1,13.17,2,1,1,4
1515915625555256569,83,3,215.25,2,3,3,8
1515915625555262740,83,1,164.33,2,1,3,6
1515915625555309224,83,1,15.1,2,1,1,4
1515915625555317426,83,2,58.44,2,2,2,6
1515915625555320338,83,2,230.8,2,2,3,7
1515915625555369956,83,1,128.05,2,1,3,6
1515915625555371844,83,1,13.86,2,1,1,4
1515915625555388405,83,5,46.75,2,4,2,8
1515915625555395883,82,1,43.11,2,1,2,5
1515915625555452686,83,9,262.98,2,4,3,9
1515915625555484400,83,1,21.43,2,1,1,4
1515915625555499793,83,1,66.6,2,1,2,5
1515915625555513412,18,2,1915.66,4,2,4,10
1515915625555517363,82,1,43.11,2,1,2,5
1515915625555522198,83,2,341.96,2,2,4,8
1515915625555522233,83,1,25.71,2,1,1,4
1515915625555548801,83,1,55.87,2,1,2,5
1515915625555557664,83,1,26.19,2,1,1,4
1515915625555569113,83,1,30.38,2,1,1,4
1515915625555578161,45,1,298.76,3,1,4,8
1515915625555582601,83,2,29.72,2,2,1,5
1515915625555583891,83,3,31.89,2,3,1,6
1515915625555586832,83,1,8.79,2,1,1,4
1515915625555621300,83,1,64.48,2,1,2,5
1515915625555628997,82,1,124.08,2,1,3,6
1515915625555632867,54,2,230.8,3,2,3,8
1515915625555639793,77,2,410.5,2,2,4,8
1515915625555663032,82,3,140.94,2,3,3,8
1515915625555676587,83,1,10.4,2,1,1,4
1515915625555683305,82,3,195.24,2,3,3,8
1515915625555684357,76,4,116.88,2,3,3,8
1515915625555685672,83,1,82.97,2,1,2,5
1515915625555706437,83,1,16.19,2,1,1,4
1515915625555747511,83,1,20.0,2,1,1,4
1515915625555748059,83,1,14.19,2,1,1,4
1515915625555750200,83,1,34.44,2,1,2,5
1515915625555781532,83,1,415.54,2,1,4,7
1515915625555786988,76,2,289.02,2,2,4,8
1515915625555812991,62,1,151.14,3,1,3,7
1515915625555868569,83,4,153.89999999999998,2,3,3,8
1515915625555872571,83,1,115.0,2,1,3,6
1515915625555872974,83,10,1359.3,2,4,4,10
1515915625555877864,83,1,34.44,2,1,2,5
1515915625555883777,83,1,37.46,2,1,2,5
1515915625555885859,83,1,63.33,2,1,2,5
1515915625555886275,83,1,13.65,2,1,1,4
1515915625555886488,83,1,49.52,2,1,2,5
1515915625555889348,74,1,97.41,2,1,3,6
1515915625555891385,83,1,15.44,2,1,1,4
1515915625555891523,83,1,21.43,2,1,1,4
1515915625555895887,41,1,22.29,3,1,1,5
1515915625555896573,83,3,70.47,2,3,2,7
1515915625555900978,83,1,21.43,2,1,1,4
1515915625555904395,83,1,32.38,2,1,2,5
1515915625555905226,83,1,85.71,2,1,2,5
1515915625555910127,80,1,631.62,2,1,4,7
1515915625555915576,82,3,248.13,2,3,3,8
1515915625555915596,82,1,13.86,2,1,1,4
1515915625555927435,79,1,169.87,2,1,3,6
1515915625555929516,83,2,58.44,2,2,2,6
1515915625555932695,83,1,257.87,2,1,3,6
1515915625555935192,83,2,60.76,2,2,2,6
1515915625555939162,83,2,86.22,2,2,2,6
1515915625555950909,83,1,80.35,2,1,2,5
1515915625555953498,83,1,572.57,2,1,4,7
1515915625555953528,83,1,64.48,2,1,2,5
1515915625555959360,83,1,176.17,2,1,3,6
1515915625555961035,83,1,11.11,2,1,1,4
1515915625555964809,83,1,300.17,2,1,4,7
1515915625555972985,83,1,33.97,2,1,2,5
1515915625555987172,83,2,45.400000000000006,2,2,2,6
1515915625555990659,83,1,52.44,2,1,2,5
1515915625555992977,78,1,449.51,2,1,4,7
1515915625555997352,83,1,43.13,2,1,2,5
1515915625555999955,58,2,192.64,3,2,3,8
1515915625556002299,82,4,6.28,2,3,1,6
1515915625556010587,83,1,113.56,2,1,3,6
1515915625556016364,83,1,141.83,2,1,3,6
1515915625556016612,77,1,133.87,2,1,3,6
1515915625556017569,77,1,240.11,2,1,3,6
1515915625556018084,83,2,104.98,2,2,3,7
1515915625556018123,82,1,27.62,2,1,1,4
1515915625556020342,83,2,155.46,2,2,3,7
1515915625556021154,83,3,10.68,2,3,1,6
1515915625556023442,83,1,49.73,2,1,2,5
1515915625556031889,83,4,79.12,2,3,2,7
1515915625556032186,83,1,43.11,2,1,2,5
1515915625556037933,83,8,155.44,2,4,3,9
1515915625556046507,83,1,23.48,2,1,1,4
1515915625556048455,81,4,40.84,2,3,2,7
1515915625556052264,83,1,24.95,2,1,1,4
1515915625556055880,77,3,37.62,2,3,2,7
1515915625556061040,83,3,32.04,2,3,1,6
1515915625556075964,83,1,153.83,2,1,3,6
1515915625556080786,19,1,55.87,4,1,2,7
1515915625556085007,82,1,142.63,2,1,3,6
1515915625556087775,82,1,65.08,2,1,2,5
1515915625556088692,82,1,52.54,2,1,2,5
1515915625556144462,82,1,395.27,2,1,4,7
1515915625556168729,82,1,259.38,2,1,3,6
1515915625556169297,82,1,257.87,2,1,3,6
1515915625556170073,77,12,517.3199999999999,2,4,4,10
1515915625556176069,82,1,79.37,2,1,2,5
1515915625556179364,14,1,25.08,4,1,1,6
1515915625556183961,42,4,1830.04,3,3,4,10
1515915625556185171,82,1,24.76,2,1,1,4
1515915625556185983,52,7,1450.89,3,4,4,11
1515915625556186474,82,1,3.56,2,1,1,4
1515915625556189823,82,1,1.57,2,1,1,4
1515915625556193595,82,3,167.60999999999999,2,3,3,8
1515915625556193708,82,1,88.84,2,1,2,5
1515915625556195632,82,1,13.48,2,1,1,4
1515915625556196675,66,2,375.56,3,2,4,9
1515915625556203612,28,1,13.81,4,1,1,6
1515915625556205341,82,6,83.34,2,4,2,8
1515915625556209308,49,2,428.2,3,2,4,9
1515915625556209331,82,2,41.11,2,2,2,6
1515915625556209823,52,1,23.97,3,1,1,5
1515915625556215659,82,1,22.4,2,1,1,4
1515915625556215861,82,4,48.2,2,3,2,7
1515915625556222777,61,3,654.72,3,3,4,10
1515915625556223717,82,1,209.7,2,1,3,6
1515915625556229490,82,4,269.2,2,3,3,8
1515915625556229778,82,3,88.56,2,3,2,7
1515915625556231952,82,1,87.16,2,1,2,5
1515915625556232157,82,1,27.73,2,1,1,4
1515915625556248746,82,1,13.81,2,1,1,4
1515915625556255182,82,1,16.98,2,1,1,4
1515915625556255951,28,4,37.48,4,3,2,9
1515915625556257659,82,1,16.19,2,1,1,4
1515915625556268663,80,1,99.92,2,1,3,6
1515915625556275395,77,2,58.42,2,2,2,6
1515915625556280964,82,1,52.44,2,1,2,5
1515915625556282373,82,1,15.08,2,1,1,4
1515915625556282845,82,1,13.65,2,1,1,4
1515915625556299051,82,1,35.57,2,1,2,5
1515915625556315550,82,2,3.14,2,2,1,5
1515915625556318113,82,1,22.41,2,1,1,4
1515915625556318125,82,1,16.35,2,1,1,4
1515915625556322379,82,1,482.76,2,1,4,7
1515915625556324082,82,1,87.63,2,1,2,5
1515915625556324969,39,4,506.72,3,3,4,10
1515915625556326479,82,1,60.32,2,1,2,5
1515915625556328012,82,1,52.49,2,1,2,5
1515915625556328820,82,1,45.84,2,1,2,5
1515915625556329962,82,1,39.75,2,1,2,5
1515915625556330060,82,4,128.88,2,3,3,8
1515915625556330249,82,1,67.62,2,1,2,5
1515915625556331837,82,5,808.5999999999999,2,4,4,10
1515915625556333157,82,1,292.83,2,1,4,7
1515915625556333778,77,3,148.56,2,3,3,8
1515915625556335852,82,4,205.32,2,3,3,8
1515915625556338020,82,1,314.68,2,1,4,7
1515915625556341208,82,1,64.48,2,1,2,5
1515915625556341541,82,1,446.51,2,1,4,7
1515915625556343688,82,1,204.79,2,1,3,6
1515915625556343700,62,2,63.72,3,2,2,7
1515915625556344717,80,2,94.82,2,2,3,7
1515915625556348330,82,1,15.08,2,1,1,4
1515915625556348943,71,1,205.25,3,1,3,7
1515915625556349183,82,1,397.48,2,1,4,7
1515915625556351296,74,2,1219.2,2,2,4,8
1515915625556351629,81,2,94.7,2,2,3,7
1515915625556374800,82,1,183.71,2,1,3,6
1515915625556374846,81,1,136.92,2,1,3,6
1515915625556375653,82,1,63.98,2,1,2,5
1515915625556377422,82,4,264.78,2,3,3,8
1515915625556378659,82,1,122.97,2,1,3,6
1515915625556380382,82,1,254.38,2,1,3,6
1515915625556382435,82,1,448.51,2,1,4,7
1515915625556388010,82,2,52.92,2,2,2,6
1515915625556388577,82,1,154.06,2,1,3,6
1515915625556404568,82,2,471.73,2,2,4,8
1515915625556410368,70,1,501.54,3,1,4,8
1515915625556413357,82,1,32.81,2,1,2,5
1515915625556414411,82,2,196.82,2,2,3,7
1515915625556419695,82,4,508.32,2,3,4,9
1515915625556420232,82,2,20.86,2,2,1,5
1515915625556421281,82,1,64.14,2,1,2,5
1515915625556431120,82,1,577.6,2,1,4,7
1515915625556432434,19,12,2299.72,4,4,4,12
1515915625556432726,82,1,15.87,2,1,1,4
1515915625556434208,80,15,1307.3999999999999,2,4,4,10
1515915625556435280,81,1,17.44,2,1,1,4
1515915625556436530,81,4,39.24,2,3,2,7
1515915625556439824,46,2,227.62,3,2,3,8
1515915625556444067,82,3,1411.56,2,3,4,9
1515915625556446013,82,1,103.83,2,1,3,6
1515915625556446519,82,1,18.73,2,1,1,4
1515915625556448161,82,2,26.04,2,2,1,5
1515915625556448378,82,1,176.17,2,1,3,6
1515915625556448446,82,3,517.14,2,3,4,9
1515915625556456689,82,2,19.42,2,2,1,5
1515915625556457315,82,1,14.08,2,1,1,4
1515915625556462610,82,1,30.79,2,1,1,4
1515915625556472226,82,1,29.22,2,1,1,4
1515915625556473156,14,1,539.57,4,1,4,9
1515915625556480058,81,2,53.14,2,2,2,6
1515915625556484297,81,2,138.7,2,2,3,7
1515915625556487233,82,1,29.22,2,1,1,4
1515915625556491596,71,4,1666.96,3,3,4,10
1515915625556495546,82,1,67.97,2,1,2,5
1515915625556496023,81,2,273.84,2,2,3,7
1515915625556497617,45,1,397.48,3,1,4,8
1515915625556499884,82,1,415.54,2,1,4,7
1515915625556501193,82,1,30.1,2,1,1,4
1515915625556501696,82,1,11.62,2,1,1,4
1515915625556504412,82,1,229.38,2,1,3,6
1515915625556508370,82,2,164.66,2,2,3,7
1515915625556515627,82,9,986.06,2,4,4,10
1515915625556517073,82,1,3.56,2,1,1,4
1515915625556519864,35,2,67.35,4,2,2,8
1515915625556523476,82,2,111.74,2,2,3,7
1515915625556523703,82,1,12.22,2,1,1,4
1515915625556525551,81,1,75.67,2,1,2,5
1515915625556525568,82,5,378.35,2,4,4,10
1515915625556539314,82,1,146.92,2,1,3,6
1515915625556573728,81,1,374.38,2,1,4,7
1515915625556577890,81,3,39.06,2,3,2,7
1515915625556609140,81,1,33.08,2,1,2,5
1515915625556616417,81,1,32.13,2,1,1,4
1515915625556644377,20,1,11.9,4,1,1,6
1515915625556646464,81,1,268.06,2,1,3,6
1515915625556658524,81,1,297.41,2,1,4,7
1515915625556661373,81,1,13.89,2,1,1,4
1515915625556662949,81,1,33.73,2,1,2,5
1515915625556672155,72,1,192.51,3,1,3,7
1515915625556677807,35,2,1178.2,4,2,4,10
1515915625556680201,81,1,257.87,2,1,3,6
1515915625556681258,81,1,26.19,2,1,1,4
1515915625556682996,73,3,380.04,2,3,4,9
1515915625556685217,81,1,11.11,2,1,1,4
1515915625556686094,81,1,381.46,2,1,4,7
1515915625556693374,81,1,10.05,2,1,1,4
1515915625556694895,81,1,13.02,2,1,1,4
1515915625556695991,81,1,53.17,2,1,2,5
1515915625556696292,81,1,9.84,2,1,1,4
1515915625556700597,81,2,762.92,2,2,4,8
1515915625556700825,81,1,33.19,2,1,2,5
1515915625556704471,81,1,30.79,2,1,1,4
1515915625556705039,81,1,10.48,2,1,1,4
1515915625556706383,81,1,32.86,2,1,2,5
1515915625556713837,81,2,53.2,2,2,2,6
1515915625556713961,41,2,150.58,3,2,3,8
1515915625556714457,81,4,534.6,2,3,4,9
1515915625556724669,81,1,17.78,2,1,1,4
1515915625556727332,81,5,319.9,2,4,4,10
1515915625556735799,67,5,127.2,3,4,3,10
1515915625556737514,37,4,1522.1399999999999,3,3,4,10
1515915625556742108,81,2,3.14,2,2,1,5
1515915625556748344,81,1,43.33,2,1,2,5
1515915625556753596,81,1,958.57,2,1,4,7
1515915625556754905,81,1,11.43,2,1,1,4
1515915625556757524,81,1,226.84,2,1,3,6
1515915625556758129,80,1,1.57,2,1,1,4
1515915625556759282,81,1,13.02,2,1,1,4
1515915625556762013,81,1,8.59,2,1,1,4
1515915625556772309,81,5,84.35000000000001,2,4,2,8
1515915625556776239,81,1,222.06,2,1,3,6
1515915625556776858,81,2,59.04,2,2,2,6
1515915625556782903,40,1,43.11,3,1,2,6
1515915625556787547,81,1,29.52,2,1,1,4
1515915625556788281,67,3,1056.35,3,3,4,10
1515915625556789258,81,2,240.98,2,2,3,7
1515915625556790300,66,2,47.56,3,2,2,7
1515915625556792239,81,1,32.22,2,1,1,4
1515915625556792807,81,1,154.32,2,1,3,6
1515915625556800404,81,1,28.1,2,1,1,4
1515915625556806283,77,1,52.05,2,1,2,5
1515915625556807680,39,2,50.8,3,2,2,7
1515915625556811090,46,2,85.96,3,2,2,7
1515915625556813461,81,1,193.25,2,1,3,6
1515915625556867743,81,1,53.17,2,1,2,5
1515915625556884475,81,1,23.76,2,1,1,4
1515915625556888545,81,7,1187.04,2,4,4,10
1515915625556893794,81,1,176.17,2,1,3,6
1515915625556894473,81,1,61.27,2,1,2,5
1515915625556896864,81,1,223.33,2,1,3,6
1515915625556898808,80,2,1034.6,2,2,4,8
1515915625556906035,81,1,9.35,2,1,1,4
1515915625556907564,81,1,1.57,2,1,1,4
1515915625556913916,81,2,41.12,2,2,2,6
1515915625556919325,81,1,13.81,2,1,1,4
1515915625556926737,81,3,150.24,2,3,3,8
1515915625556929678,81,2,86.22,2,2,2,6
1515915625556935527,77,2,19.62,2,2,1,5
1515915625556936169,81,2,58.74,2,2,2,6
1515915625556937463,81,1,11.11,2,1,1,4
1515915625556938072,77,2,105.39,2,2,3,7
1515915625556941447,81,1,25.7,2,1,1,4
1515915625556946130,81,1,10.05,2,1,1,4
1515915625556949473,39,3,1716.77,3,3,4,10
1515915625556961567,81,2,402.66,2,2,4,8
1515915625556964826,81,1,65.4,2,1,2,5
1515915625556975470,81,1,62.54,2,1,2,5
1515915625556992608,81,1,154.32,2,1,3,6
1515915625557004575,73,3,73.80000000000001,2,3,2,7
1515915625557009657,81,5,101.6,2,4,3,9
1515915625557301069,81,3,78.57000000000001,2,3,2,7
1515915625557465952,81,1,397.48,2,1,4,7
1515915625557643553,80,1,373.46,2,1,4,7
1515915625557732417,15,1,26.51,4,1,1,6
1515915625557742681,59,1,397.48,3,1,4,8
1515915625557764579,81,1,26.98,2,1,1,4
1515915625557838840,81,2,106.34,2,2,3,7
1515915625557843216,80,1,94.06,2,1,3,6
1515915625557988449,81,1,14.19,2,1,1,4
1515915625558001412,76,3,1208.44,2,3,4,9
1515915625558020503,78,3,137.94,2,3,3,8
1515915625558083958,77,1,23.49,2,1,1,4
1515915625558123248,79,2,746.92,2,2,4,8
1515915625558150781,81,1,163.52,2,1,3,6
1515915625558176610,81,1,32.22,2,1,1,4
1515915625558201377,46,3,515.7,3,3,4,10
1515915625558214114,81,1,10.95,2,1,1,4
1515915625558300614,81,1,31.11,2,1,1,4
1515915625558328047,81,1,68.57,2,1,2,5
1515915625558358513,81,1,62.54,2,1,2,5
1515915625558391379,81,1,62.54,2,1,2,5
1515915625558535624,81,1,87.16,2,1,2,5
1515915625558866795,81,1,115.71,2,1,3,6
1515915625558987169,81,1,240.98,2,1,3,6
1515915625559011046,19,1,176.14,4,1,3,8
1515915625559078768,80,1,61.27,2,1,2,5
1515915625559244313,80,3,491.17,2,3,4,9
1515915625559258934,80,1,205.49,2,1,3,6
1515915625559512307,80,1,32.86,2,1,2,5
1515915625559633091,80,1,49.41,2,1,2,5
1515915625559698334,46,1,15.4,3,1,1,5
1515915625559739096,80,1,31.11,2,1,1,4
1515915625559741933,80,1,204.79,2,1,3,6
1515915625559751547,80,1,73.81,2,1,2,5
1515915625559879105,76,3,844.73,2,3,4,9
1515915625559927740,74,1,220.95,2,1,3,6
1515915625560024542,80,1,38.83,2,1,2,5
1515915625560042733,80,1,69.3,2,1,2,5
1515915625560044049,80,2,33.96,2,2,2,6
1515915625560044643,80,2,106.34,2,2,3,7
1515915625560052565,80,1,429.51,2,1,4,7
1515915625560062116,80,1,35.87,2,1,2,5
1515915625560071738,80,1,399.48,2,1,4,7
1515915625560072586,80,1,21.43,2,1,1,4
1515915625560075757,80,8,1638.32,2,4,4,10
1515915625560076119,77,6,157.14000000000001,2,4,3,9
1515915625560078022,71,1,11.9,3,1,1,5
1515915625560078343,80,1,119.37,2,1,3,6
1515915625560082438,80,2,16.0,2,2,1,5
1515915625560091005,80,1,16.59,2,1,1,4
1515915625560091667,80,2,73.58,2,2,2,6
1515915625560093205,78,2,95.88,2,2,3,7
1515915625560093877,80,1,100.75,2,1,3,6
1515915625560094359,80,2,423.18,2,2,4,8
1515915625560094440,80,2,42.7,2,2,2,6
1515915625560102905,80,1,1.57,2,1,1,4
1515915625560105759,80,4,881.8299999999999,2,3,4,9
1515915625560110141,80,1,16.98,2,1,1,4
1515915625560115462,70,1,16.33,3,1,1,5
1515915625560118700,79,1,86.48,2,1,2,5
1515915625560120216,80,1,92.65,2,1,3,6
1515915625560151080,80,1,62.71,2,1,2,5
1515915625560199572,39,2,458.76,3,2,4,9
1515915625560247311,9,5,256.65,4,4,3,11
1515915625560356433,80,1,115.71,2,1,3,6
1515915625560377178,80,1,29.52,2,1,1,4
1515915625560386987,80,1,290.63,2,1,4,7
1515915625560393468,79,1,277.1,2,1,3,6
1515915625560458197,80,1,33.24,2,1,2,5
1515915625560548496,80,1,32.22,2,1,1,4
1515915625560585571,80,1,52.92,2,1,2,5
1515915625560598159,80,3,1120.3799999999999,2,3,4,9
1515915625560609677,80,1,128.06,2,1,3,6
1515915625560768985,80,2,3.14,2,2,1,5
1515915625560838657,80,2,33.96,2,2,2,6
1515915625560913361,80,5,130.95000000000002,2,4,3,9
1515915625560968100,80,1,24.13,2,1,1,4
1515915625561099435,74,1,33.65,2,1,2,5
1515915625561152808,80,1,471.52,2,1,4,7
1515915625561163017,80,2,753.95,2,2,4,8
1515915625561173350,80,1,82.97,2,1,2,5
1515915625561207087,80,1,29.68,2,1,1,4
1515915625561207204,80,1,29.68,2,1,1,4
1515915625561210112,80,1,86.37,2,1,2,5
1515915625561212790,73,1,44.92,2,1,2,5
1515915625561213898,80,1,36.79,2,1,2,5
1515915625561216097,80,2,86.22,2,2,2,6
1515915625561218334,80,2,831.08,2,2,4,8
1515915625561224173,80,1,38.83,2,1,2,5
1515915625561224261,80,1,304.41,2,1,4,7
1515915625561230652,80,1,21.43,2,1,1,4
1515915625561231508,80,2,88.58,2,2,2,6
1515915625561232701,61,1,19.68,3,1,1,5
1515915625561235820,80,2,423.18,2,2,4,8
1515915625561236898,80,1,370.46,2,1,4,7
1515915625561239660,64,3,99.57,3,3,3,9
1515915625561240803,80,1,19.68,2,1,1,4
1515915625561241536,80,1,177.95,2,1,3,6
1515915625561242758,80,1,22.0,2,1,1,4
1515915625561248828,80,2,18.7,2,2,1,5
1515915625561249998,79,9,179.41,2,4,3,9
1515915625561251988,79,1,22.7,2,1,1,4
1515915625561253365,80,1,50.08,2,1,2,5
1515915625561259494,80,2,587.24,2,2,4,8
1515915625561266623,80,1,377.46,2,1,4,7
1515915625561271896,80,2,119.96,2,2,3,7
1515915625561275109,80,1,46.98,2,1,2,5
1515915625561275678,80,2,899.02,2,2,4,8
1515915625561292624,80,1,58.49,2,1,2,5
1515915625561302347,80,1,24.92,2,1,1,4
1515915625561317292,75,1,292.83,2,1,4,7
1515915625561317821,77,4,121.32,2,3,3,8
1515915625561335653,80,1,146.4,2,1,3,6
1515915625561341949,79,3,102.49000000000001,2,3,3,8
1515915625561343167,80,1,17.27,2,1,1,4
1515915625561345606,74,3,853.3799999999999,2,3,4,9
1515915625561350471,68,1,68.05,3,1,2,6
1515915625561353143,79,1,10.43,2,1,1,4
1515915625561354232,80,1,486.81,2,1,4,7
1515915625561356559,80,2,33.96,2,2,2,6
1515915625561358910,39,3,1382.55,3,3,4,10
1515915625561365205,80,1,445.14,2,1,4,7
1515915625561375080,79,1,197.78,2,1,3,6
1515915625561389940,79,1,29.21,2,1,1,4
1515915625561390869,79,1,1.57,2,1,1,4
1515915625561397249,79,1,40.95,2,1,2,5
1515915625561402696,45,1,126.68,3,1,3,7
1515915625561475112,79,1,196.43,2,1,3,6
1515915625561476327,79,1,61.27,2,1,2,5
1515915625561478285,79,1,23.81,2,1,1,4
1515915625561483035,45,2,307.66,3,2,4,9
1515915625561492708,67,1,259.38,3,1,3,7
1515915625561499628,79,1,9.81,2,1,1,4
1515915625561500144,79,2,101.62,2,2,3,7
1515915625561504450,79,3,451.95000000000005,2,3,4,9
1515915625561506747,79,1,466.52,2,1,4,7
1515915625561508364,79,3,1288.53,2,3,4,9
1515915625561515066,79,3,688.14,2,3,4,9
1515915625561517840,60,3,380.04,3,3,4,10
1515915625561519470,79,3,129.32999999999998,2,3,3,8
1515915625561520434,77,1,60.21,2,1,2,5
1515915625561520504,79,1,60.21,2,1,2,5
1515915625561522029,79,2,42.86,2,2,2,6
1515915625561523137,77,1,274.4,2,1,3,6
1515915625561525368,79,1,113.38,2,1,3,6
1515915625561526633,79,1,27.62,2,1,1,4
1515915625561528793,79,3,43.95,2,3,2,7
1515915625561531399,79,1,26.46,2,1,1,4
1515915625561531620,79,1,30.16,2,1,1,4
1515915625561539738,77,1,32.22,2,1,1,4
1515915625561541959,79,2,52.38,2,2,2,6
1515915625561544565,79,1,9.81,2,1,1,4
1515915625561547383,79,1,59.79,2,1,2,5
1515915625561555898,79,1,25.08,2,1,1,4
1515915625561558308,79,1,449.51,2,1,4,7
1515915625561562368,79,2,458.76,2,2,4,8
1515915625561564192,79,2,797.4,2,2,4,8
1515915625561567254,79,1,61.29,2,1,2,5
1515915625561569406,79,2,138.16,2,2,3,7
1515915625561572934,40,1,9.35,3,1,1,5
1515915625561577135,79,1,30.38,2,1,1,4
1515915625561577493,79,1,12.83,2,1,1,4
1515915625561578250,67,1,161.3,3,1,3,7
1515915625561580027,79,6,96.7,2,4,3,9
1515915625561581574,73,14,857.9200000000001,2,4,4,10
1515915625561585990,79,1,50.08,2,1,2,5
1515915625561588009,79,2,20.48,2,2,1,5
1515915625561590908,78,1,18.25,2,1,1,4
1515915625561602389,79,1,397.48,2,1,4,7
1515915625561612292,79,2,46.98,2,2,2,6
1515915625561613053,79,1,117.75,2,1,3,6
1515915625561616137,79,1,13.86,2,1,1,4
1515915625561616565,79,1,117.75,2,1,3,6
1515915625561620864,79,1,126.68,2,1,3,6
1515915625561630000,79,1,17.19,2,1,1,4
1515915625561632502,55,3,165.48,3,3,3,9
1515915625561634842,53,6,406.68,3,4,4,11
1515915625561636397,79,1,21.27,2,1,1,4
1515915625561636792,79,1,12.38,2,1,1,4
1515915625561640036,79,1,97.35,2,1,3,6
1515915625561640131,79,1,9.35,2,1,1,4
1515915625561641926,79,8,107.44999999999999,2,4,3,9
1515915625561643664,70,2,518.6800000000001,3,2,4,9
1515915625561645652,78,6,932.98,2,4,4,10
1515915625561660078,79,1,192.86,2,1,3,6
1515915625561676020,70,5,2862.8500000000004,3,4,4,11
1515915625561677593,78,2,67.94,2,2,2,6
1515915625561684844,79,1,96.67,2,1,3,6
1515915625561685155,79,1,43.11,2,1,2,5
1515915625561690543,79,2,453.68,2,2,4,8
1515915625561692690,79,2,486.22,2,2,4,8
1515915625561694278,79,1,294.41,2,1,4,7
1515915625561694949,79,1,9.35,2,1,1,4
1515915625561704160,79,1,32.22,2,1,1,4
1515915625561705934,79,1,192.86,2,1,3,6
1515915625561713976,79,2,15.78,2,2,1,5
1515915625561716811,78,3,982.29,2,3,4,9
1515915625561720561,79,1,373.46,2,1,4,7
1515915625561720676,79,1,118.57,2,1,3,6
1515915625561721161,79,3,131.60999999999999,2,3,3,8
1515915625561727059,79,4,386.68,2,3,4,9
1515915625561730667,79,1,84.89,2,1,2,5
1515915625561739319,79,1,292.83,2,1,4,7
1515915625561743092,79,2,83.18,2,2,2,6
1515915625561743784,79,8,125.35000000000001,2,4,3,9
1515915625561746084,79,1,32.22,2,1,1,4
1515915625561747690,37,4,403.0,3,3,4,10
1515915625561749349,79,1,164.92,2,1,3,6
1515915625561752084,79,1,53.9,2,1,2,5
1515915625561768143,79,2,112.54,2,2,3,7
1515915625561770546,75,1,86.16,2,1,2,5
1515915625561771971,79,2,52.38,2,2,2,6
1515915625561778946,30,2,3.14,4,2,1,7
1515915625561783495,25,4,303.08000000000004,4,3,4,11
1515915625561792844,44,4,508.32,3,3,4,10
1515915625561795598,79,2,423.58,2,2,4,8
1515915625561798824,79,1,199.37,2,1,3,6
1515915625561799751,79,1,476.03,2,1,4,7
1515915625561800864,75,1,55.6,2,1,2,5
1515915625561806256,66,1,32.22,3,1,1,5
1515915625561807438,79,1,37.78,2,1,2,5
1515915625561810827,79,1,35.1,2,1,2,5
1515915625561817002,78,1,92.86,2,1,3,6
1515915625561819055,76,1,294.41,2,1,4,7
1515915625561836706,74,1,25.4,2,1,1,4
1515915625561887985,78,1,26.98,2,1,1,4
1515915625561896718,78,2,35.24,2,2,2,6
1515915625561943638,78,1,16.78,2,1,1,4
1515915625561964265,73,3,492.99,2,3,4,9
1515915625561967727,78,1,107.33,2,1,3,6
1515915625561971183,78,1,29.22,2,1,1,4
1515915625561976441,78,1,10.24,2,1,1,4
1515915625561976977,78,1,10.24,2,1,1,4
1515915625561979719,78,1,117.75,2,1,3,6
1515915625561982217,21,1,131.59,4,1,3,8
1515915625561984479,28,4,380.5,4,3,4,11
1515915625561990804,76,4,665.64,2,3,4,9
1515915625561991415,78,1,14.6,2,1,1,4
1515915625561991943,67,2,314.28,3,2,4,9
1515915625561995171,78,2,47.62,2,2,2,6
1515915625561997690,75,1,197.46,2,1,3,6
1515915625561999052,78,10,177.4,2,4,3,9
1515915625561999844,75,8,110.54,2,4,3,9
1515915625562006173,78,1,22.56,2,1,1,4
1515915625562008376,78,1,13.48,2,1,1,4
1515915625562013974,78,1,40.79,2,1,2,5
1515915625562022757,78,1,107.79,2,1,3,6
1515915625562026690,13,1,11.11,4,1,1,6
1515915625562026900,78,1,127.08,2,1,3,6
1515915625562032754,78,1,32.22,2,1,1,4
1515915625562036067,78,3,441.33000000000004,2,3,4,9
1515915625562041888,73,2,201.5,2,2,3,7
1515915625562042784,78,2,1096.41,2,2,4,8
1515915625562043199,75,2,3.14,2,2,1,5
1515915625562045330,78,1,397.48,2,1,4,7
1515915625562047500,78,1,29.22,2,1,1,4
1515915625562050889,77,1,52.49,2,1,2,5
1515915625562051508,78,1,32.22,2,1,1,4
1515915625562053884,68,9,950.04,3,4,4,11
1515915625562058519,76,2,30.16,2,2,1,5
1515915625562059136,78,1,126.68,2,1,3,6
1515915625562059642,78,2,22.86,2,2,1,5
1515915625562061428,78,1,257.87,2,1,3,6
1515915625562062243,11,1,259.38,4,1,3,8
1515915625562062615,49,3,616.47,3,3,4,10
1515915625562062621,78,2,28.04,2,2,1,5
1515915625562065226,78,5,84.9,2,4,2,8
1515915625562065923,78,1,43.11,2,1,2,5
1515915625562072830,78,3,55.230000000000004,2,3,2,7
1515915625562074242,69,1,85.48,3,1,2,6
1515915625562076930,78,1,32.22,2,1,1,4
1515915625562078613,78,1,19.97,2,1,1,4
1515915625562080368,78,1,64.48,2,1,2,5
1515915625562083733,78,2,94.26,2,2,3,7
1515915625562084042,78,1,15.08,2,1,1,4
1515915625562088771,78,2,9.14,2,2,1,5
1515915625562097095,77,1,61.16,2,1,2,5
1515915625562102517,78,5,435.79999999999995,2,4,4,10
1515915625562107511,78,2,174.32,2,2,3,7
1515915625562110869,70,1,126.68,3,1,3,7
1515915625562110905,78,2,20.96,2,2,1,5
1515915625562112304,78,1,77.73,2,1,2,5
1515915625562116062,78,8,235.42,2,4,3,9
1515915625562119031,78,2,18.7,2,2,1,5
1515915625562123323,78,1,83.97,2,1,2,5
1515915625562125994,78,2,105.88,2,2,3,7
1515915625562128385,78,1,33.33,2,1,2,5
1515915625562138621,78,1,33.65,2,1,2,5
1515915625562139890,77,1,12.38,2,1,1,4
1515915625562141469,62,1,66.92,3,1,2,6
1515915625562152330,78,2,21.26,2,2,1,5
1515915625562155715,75,2,85.96,2,2,2,6
1515915625562156100,78,1,466.52,2,1,4,7
1515915625562158581,78,3,50.67,2,3,2,7
1515915625562161376,78,1,74.46,2,1,2,5
1515915625562161623,78,1,9.35,2,1,1,4
1515915625562163238,78,7,472.57000000000005,2,4,4,10
1515915625562177732,78,1,10.43,2,1,1,4
1515915625562181790,78,2,22.22,2,2,1,5
1515915625562188271,78,4,50.16,2,3,2,7
1515915625562190148,78,6,136.20000000000002,2,4,3,9
1515915625562197028,78,1,24.95,2,1,1,4
1515915625562200564,78,3,153.99,2,3,3,8
1515915625562201431,78,1,51.33,2,1,2,5
1515915625562202966,78,1,51.33,2,1,2,5
1515915625562205678,68,2,166.66,3,2,3,8
1515915625562209661,78,1,59.62,2,1,2,5
1515915625562213622,71,1,16.11,3,1,1,5
1515915625562214178,78,1,48.73,2,1,2,5
1515915625562214213,78,1,93.43,2,1,3,6
1515915625562219794,78,3,167.60999999999999,2,3,3,8
1515915625562220277,78,1,21.21,2,1,1,4
1515915625562224710,78,1,11.43,2,1,1,4
1515915625562229356,78,2,3.14,2,2,1,5
1515915625562232898,70,8,2079.52,3,4,4,11
1515915625562233197,78,4,184.12,2,3,3,8
1515915625562236874,65,1,199.7,3,1,3,7
1515915625562242140,78,1,14.6,2,1,1,4
1515915625562244353,77,8,857.28,2,4,4,10
1515915625562248450,78,1,399.48,2,1,4,7
1515915625562248991,78,1,33.97,2,1,2,5
1515915625562257546,78,1,26.46,2,1,1,4
1515915625562257609,78,3,1399.56,2,3,4,9
1515915625562261092,66,1,165.33,3,1,3,7
1515915625562263991,78,1,83.97,2,1,2,5
1515915625562267920,78,2,128.96,2,2,3,7
1515915625562272232,78,1,215.24,2,1,3,6
1515915625562274282,78,1,34.08,2,1,2,5
1515915625562275703,78,1,337.44,2,1,4,7
1515915625562275936,26,2,112.7,4,2,3,9
1515915625562280123,78,4,206.72,2,3,3,8
1515915625562281446,78,1,24.63,2,1,1,4
1515915625562282144,77,2,214.32,2,2,3,7
1515915625562282746,78,5,199.02,2,4,3,9
1515915625562285434,78,1,64.97,2,1,2,5
1515915625562287130,78,2,52.38,2,2,2,6
1515915625562287835,78,1,29.52,2,1,1,4
1515915625562288461,78,2,889.02,2,2,4,8
1515915625562289354,78,1,26.19,2,1,1,4
1515915625562291995,78,1,23.02,2,1,1,4
1515915625562292460,78,1,204.79,2,1,3,6
1515915625562300575,78,1,32.22,2,1,1,4
1515915625562300823,78,1,123.35,2,1,3,6
1515915625562302270,78,3,492.99,2,3,4,9
1515915625562303558,78,2,37.46,2,2,2,6
1515915625562312838,77,1,577.6,2,1,4,7
1515915625562313006,77,2,56.2,2,2,2,6
1515915625562313139,77,3,166.95,2,3,3,8
1515915625562317086,77,2,59.62,2,2,2,6
1515915625562318165,77,3,878.49,2,3,4,9
1515915625562318522,77,1,184.29,2,1,3,6
1515915625562327103,77,1,26.98,2,1,1,4
1515915625562329673,77,2,144.76,2,2,3,7
1515915625562331043,74,1,13.02,2,1,1,4
1515915625562332637,77,1,1.57,2,1,1,4
1515915625562333169,74,1,577.6,2,1,4,7
1515915625562335350,57,1,32.86,3,1,2,6
1515915625562356655,77,4,75.72,2,3,2,7
1515915625562358184,77,1,16.41,2,1,1,4
1515915625562361394,77,1,61.43,2,1,2,5
1515915625562366133,77,1,19.98,2,1,1,4
1515915625562389146,77,2,81.8,2,2,2,6
1515915625562451165,77,1,370.46,2,1,4,7
1515915625562454243,77,1,40.22,2,1,2,5
1515915625562454774,77,2,135.02,2,2,3,7
1515915625562454839,77,2,798.96,2,2,4,8
1515915625562456011,77,1,22.14,2,1,1,4
1515915625562458673,77,1,226.84,2,1,3,6
1515915625562459569,77,1,24.35,2,1,1,4
1515915625562463931,77,1,34.29,2,1,2,5
1515915625562465474,77,1,23.05,2,1,1,4
1515915625562468515,74,1,184.94,2,1,3,6
1515915625562471865,77,1,122.86,2,1,3,6
1515915625562471977,77,2,47.14,2,2,2,6
1515915625562475305,77,2,128.96,2,2,3,7
1515915625562475509,75,6,646.28,2,4,4,10
1515915625562477110,77,2,52.38,2,2,2,6
1515915625562479740,77,2,43.62,2,2,2,6
1515915625562480920,77,1,61.27,2,1,2,5
1515915625562481304,77,1,27.32,2,1,1,4
1515915625562483247,70,2,74.28,3,2,2,7
1515915625562483497,77,1,486.81,2,1,4,7
1515915625562485626,77,1,15.08,2,1,1,4
1515915625562497383,77,1,38.25,2,1,2,5
1515915625562503177,77,1,41.32,2,1,2,5
1515915625562512111,14,1,656.63,4,1,4,9
1515915625562521859,77,1,257.87,2,1,3,6
1515915625562529855,70,2,376.82,3,2,4,9
1515915625562550807,76,4,6.28,2,3,1,6
1515915625562552268,77,1,51.33,2,1,2,5
1515915625562554758,77,1,60.83,2,1,2,5
1515915625562564438,7,6,829.4399999999999,4,4,4,12
1515915625562566377,77,1,284.3,2,1,3,6
1515915625562566469,77,3,84.49000000000001,2,3,2,7
1515915625562573625,77,1,9.35,2,1,1,4
1515915625562575155,77,1,13.65,2,1,1,4
1515915625562576871,77,5,215.55,2,4,3,9
1515915625562577333,77,2,969.3299999999999,2,2,4,8
1515915625562577923,77,4,771.26,2,3,4,9
1515915625562580378,77,1,26.46,2,1,1,4
1515915625562646063,76,1,26.19,2,1,1,4
1515915625562655005,70,1,107.16,3,1,3,7
1515915625562661708,77,1,77.73,2,1,2,5
1515915625562672973,77,1,202.67,2,1,3,6
1515915625562674220,77,1,26.9,2,1,1,4
1515915625562683133,77,1,1.57,2,1,1,4
1515915625562694885,77,2,254.16,2,2,3,7
1515915625562699858,77,1,32.22,2,1,1,4
1515915625562710336,77,1,187.19,2,1,3,6
1515915625562710762,77,2,53.34,2,2,2,6
1515915625562715905,77,3,96.66,2,3,3,8
1515915625562716492,77,1,30.1,2,1,1,4
1515915625562736240,4,2,98.76,4,2,3,9
1515915625562744269,77,1,77.73,2,1,2,5
1515915625562751274,77,1,10.9,2,1,1,4
1515915625562769778,77,1,30.38,2,1,1,4
1515915625562773416,77,3,1471.6200000000001,2,3,4,9
1515915625562779271,77,1,83.81,2,1,2,5
1515915625562792882,75,1,349.92,2,1,4,7
1515915625562794555,63,1,158.76,3,1,3,7
1515915625562804221,77,1,397.48,2,1,4,7
1515915625562806264,77,2,73.58,2,2,2,6
1515915625562811697,77,1,153.17,2,1,3,6
1515915625562842603,25,1,9.37,4,1,1,6
1515915625562850162,77,2,935.3199999999999,2,2,4,8
1515915625562861653,77,3,69.66,2,3,2,7
1515915625562868324,77,1,63.3,2,1,2,5
1515915625562868845,77,1,349.46,2,1,4,7
1515915625562872557,77,1,294.41,2,1,4,7
1515915625562872689,77,1,42.06,2,1,2,5
1515915625562876152,77,1,17.97,2,1,1,4
1515915625562885575,77,1,223.17,2,1,3,6
1515915625562889215,77,1,38.25,2,1,2,5
1515915625562890164,76,1,155.1,2,1,3,6
1515915625562897128,77,1,30.16,2,1,1,4
1515915625562928452,77,1,14.92,2,1,1,4
1515915625562938842,77,1,12.54,2,1,1,4
1515915625562951696,77,1,146.65,2,1,3,6
1515915625562953754,77,1,64.65,2,1,2,5
1515915625562961698,77,2,42.3,2,2,2,6
1515915625562962574,77,3,70.39,2,3,2,7
1515915625562980225,77,1,26.46,2,1,1,4
1515915625563013554,73,4,295.24,2,3,4,9
1515915625563019634,77,1,100.75,2,1,3,6
1515915625563035874,77,2,46.64,2,2,2,6
1515915625563039579,77,1,9.35,2,1,1,4
1515915625563048522,77,2,272.1,2,2,3,7
1515915625563056651,77,1,55.6,2,1,2,5
1515915625563058590,77,1,26.19,2,1,1,4
1515915625563062510,58,3,140.01,3,3,3,9
1515915625563063254,76,3,116.49,2,3,3,8
1515915625563064454,77,1,126.68,2,1,3,6
1515915625563067647,77,1,11.98,2,1,1,4
1515915625563070477,12,2,187.26,4,2,3,9
1515915625563072419,77,1,126.68,2,1,3,6
1515915625563075150,77,1,38.83,2,1,2,5
1515915625563076230,77,1,21.51,2,1,1,4
1515915625563077116,77,1,257.87,2,1,3,6
1515915625563077854,77,2,79.36,2,2,2,6
1515915625563081120,77,1,64.62,2,1,2,5
1515915625563083055,77,1,574.59,2,1,4,7
1515915625563089446,31,1,449.51,4,1,4,9
1515915625563089764,77,1,609.6,2,1,4,7
1515915625563091094,77,1,490.54,2,1,4,7
1515915625563097456,77,3,233.19,2,3,3,8
1515915625563104513,77,1,14.78,2,1,1,4
1515915625563105393,76,1,397.48,2,1,4,7
1515915625563106185,77,1,10.48,2,1,1,4
1515915625563107248,76,1,64.48,2,1,2,5
1515915625563110058,77,1,22.08,2,1,1,4
1515915625563110089,77,1,397.48,2,1,4,7
1515915625563121465,77,1,43.87,2,1,2,5
1515915625563128402,77,1,26.46,2,1,1,4
1515915625563129996,76,1,128.17,2,1,3,6
1515915625563130335,77,1,57.62,2,1,2,5
1515915625563131889,77,2,47.62,2,2,2,6
1515915625563134921,77,1,13.33,2,1,1,4
1515915625563137148,77,1,126.68,2,1,3,6
1515915625563141037,77,1,17.29,2,1,1,4
1515915625563141625,77,3,625.74,2,3,4,9
1515915625563144678,77,1,24.98,2,1,1,4
1515915625563149738,77,1,80.03,2,1,2,5
1515915625563153321,76,2,379.68,2,2,4,8
1515915625563155808,72,4,536.92,3,3,4,10
1515915625563157326,77,2,405.34,2,2,4,8
1515915625563185552,77,1,43.11,2,1,2,5
1515915625563185637,48,2,3.14,3,2,1,6
1515915625563185805,73,4,1209.9299999999998,2,3,4,9
1515915625563189477,75,1,284.46,2,1,3,6
1515915625563198110,77,1,292.83,2,1,4,7
1515915625563198904,77,1,42.38,2,1,2,5
1515915625563202056,77,1,21.11,2,1,1,4
1515915625563205927,77,2,44.44,2,2,2,6
1515915625563211899,74,2,41.5,2,2,2,6
1515915625563212217,8,1,249.17,4,1,3,8
1515915625563224799,76,1,77.73,2,1,2,5
1515915625563227126,76,1,202.67,2,1,3,6
1515915625563227961,76,1,32.86,2,1,2,5
1515915625563227972,76,2,344.33,2,2,4,8
1515915625563229941,76,1,69.17,2,1,2,5
1515915625563231717,76,2,34.28,2,2,2,6
1515915625563231938,76,1,17.14,2,1,1,4
1515915625563233967,76,1,11.27,2,1,1,4
1515915625563238294,76,1,14.27,2,1,1,4
1515915625563238395,75,2,69.84,2,2,2,6
1515915625563275923,76,1,46.98,2,1,2,5
1515915625563292084,76,1,625.14,2,1,4,7
1515915625563304945,76,1,90.4,2,1,2,5
1515915625563305553,76,7,1584.56,2,4,4,10
1515915625563320834,76,1,259.94,2,1,3,6
1515915625563321499,76,1,17.02,2,1,1,4
1515915625563323601,76,1,22.22,2,1,1,4
1515915625563325623,74,5,322.40000000000003,2,4,4,10
1515915625563326139,73,4,104.76,2,3,3,8
1515915625563326356,76,5,73.94999999999999,2,4,2,8
1515915625563329493,76,1,35.08,2,1,2,5
1515915625563330181,19,3,314.58,4,3,4,11
1515915625563334304,38,2,831.08,3,2,4,9
1515915625563338362,76,1,203.02,2,1,3,6
1515915625563339212,76,2,45.4,2,2,2,6
1515915625563339700,76,5,775.5,2,4,4,10
1515915625563341082,76,1,206.29,2,1,3,6
1515915625563350208,76,1,127.08,2,1,3,6
1515915625563354176,76,1,26.83,2,1,1,4
1515915625563355817,68,2,20.32,3,2,1,6
1515915625563358103,76,1,10.16,2,1,1,4
1515915625563358502,76,2,245.72,2,2,3,7
1515915625563361927,76,1,31.27,2,1,1,4
1515915625563365343,76,1,155.1,2,1,3,6
1515915625563371308,76,1,20.79,2,1,1,4
1515915625563372284,76,1,1.57,2,1,1,4
1515915625563372748,76,1,26.98,2,1,1,4
1515915625563372910,76,1,284.32,2,1,3,6
1515915625563375744,76,1,373.46,2,1,4,7
1515915625563378807,76,2,310.2,2,2,4,8
1515915625563379919,74,1,456.51,2,1,4,7
1515915625563383525,76,2,34.28,2,2,2,6
1515915625563386543,76,1,22.22,2,1,1,4
1515915625563386551,76,1,25.83,2,1,1,4
1515915625563386892,76,1,40.25,2,1,2,5
1515915625563388452,76,2,10.92,2,2,1,5
1515915625563394461,76,1,1.57,2,1,1,4
1515915625563396983,76,1,587.6,2,1,4,7
1515915625563397283,76,5,262.45,2,4,3,9
1515915625563399115,76,4,1604.9,2,3,4,9
1515915625563399730,76,1,63.98,2,1,2,5
1515915625563401030,76,1,123.65,2,1,3,6
1515915625563403986,76,1,25.29,2,1,1,4
1515915625563410032,69,3,340.14,3,3,4,10
1515915625563414815,76,1,16.51,2,1,1,4
1515915625563415677,52,1,118.57,3,1,3,7
1515915625563418007,35,1,32.94,4,1,2,7
1515915625563421642,63,5,80.95,3,4,2,9
1515915625563423433,76,2,434.77,2,2,4,8
1515915625563423830,64,4,64.76,3,3,2,8
1515915625563427079,76,2,31.72,2,2,1,5
1515915625563427615,76,1,415.54,2,1,4,7
1515915625563435056,43,2,30.8,3,2,1,6
1515915625563443650,76,2,35.72,2,2,2,6
1515915625563454674,76,1,73.81,2,1,2,5
1515915625563455225,66,1,211.59,3,1,3,7
1515915625563460081,45,2,658.86,3,2,4,9
1515915625563461233,76,1,83.19,2,1,2,5
1515915625563463204,76,1,28.25,2,1,1,4
1515915625563463914,76,1,199.97,2,1,3,6
1515915625563467081,76,1,29.68,2,1,1,4
1515915625563467996,76,1,10.59,2,1,1,4
1515915625563468076,76,1,214.1,2,1,3,6
1515915625563468719,76,1,1.57,2,1,1,4
1515915625563469028,76,1,82.97,2,1,2,5
1515915625563469575,76,1,26.19,2,1,1,4
1515915625563469870,76,1,1.57,2,1,1,4
1515915625563471037,76,1,211.59,2,1,3,6
1515915625563472817,70,4,60.84,3,3,2,8
1515915625563476252,76,1,27.62,2,1,1,4
1515915625563482384,76,1,22.49,2,1,1,4
1515915625563482657,76,4,73.2,2,3,2,7
1515915625563483423,74,4,89.82000000000001,2,3,2,7
1515915625563483605,76,1,42.98,2,1,2,5
1515915625563487319,76,1,100.38,2,1,3,6
1515915625563491992,76,1,397.48,2,1,4,7
1515915625563525555,7,3,266.68,4,3,3,10
1515915625563526591,76,1,62.52,2,1,2,5
1515915625563529334,76,1,28.1,2,1,1,4
1515915625563530011,62,1,202.67,3,1,3,7
1515915625563532240,76,1,204.79,2,1,3,6
1515915625563534816,76,1,31.62,2,1,1,4
1515915625563536646,5,1,44.92,4,1,2,7
1515915625563538846,76,1,65.08,2,1,2,5
1515915625563541781,76,2,568.64,2,2,4,8
1515915625563545553,76,1,55.29,2,1,2,5
1515915625563546836,76,1,371.46,2,1,4,7
1515915625563548150,73,3,1192.44,2,3,4,9
1515915625563551797,76,1,45.56,2,1,2,5
1515915625563554024,76,1,15.3,2,1,1,4
1515915625563560375,76,1,17.6,2,1,1,4
1515915625563565008,76,1,60.57,2,1,2,5
1515915625563566767,76,2,585.66,2,2,4,8
1515915625563569569,76,1,19.97,2,1,1,4
1515915625563572139,75,1,166.02,2,1,3,6
1515915625563575285,76,2,29.72,2,2,1,5
1515915625563575556,76,2,30.16,2,2,1,5
1515915625563577716,76,1,48.73,2,1,2,5
1515915625563580494,76,1,152.7,2,1,3,6
1515915625563583177,76,3,1108.4099999999999,2,3,4,9
1515915625563589184,76,1,446.51,2,1,4,7
1515915625563590769,76,1,21.21,2,1,1,4
1515915625563592299,75,3,477.29999999999995,2,3,4,9
1515915625563610867,35,2,52.38,4,2,2,8
1515915625563617848,4,2,813.02,4,2,4,10
1515915625563621633,66,3,451.79,3,3,4,10
1515915625563626164,76,1,42.7,2,1,2,5
1515915625563626532,20,1,69.54,4,1,2,7
1515915625563629951,76,2,798.96,2,2,4,8
1515915625563630302,76,1,397.48,2,1,4,7
1515915625563631342,35,3,846.9,4,3,4,11
1515915625563633752,76,1,26.19,2,1,1,4
1515915625563634400,75,3,15.66,2,3,1,6
1515915625563634780,76,3,660.9000000000001,2,3,4,9
1515915625563643305,76,1,499.54,2,1,4,7
1515915625563643799,76,1,479.51,2,1,4,7
1515915625563646263,76,2,21.68,2,2,1,5
1515915625563646852,76,1,370.46,2,1,4,7
1515915625563647840,66,2,44.66,3,2,2,7
1515915625563651193,76,1,269.4,2,1,3,6
1515915625563654603,69,1,499.54,3,1,4,8
1515915625563655211,72,2,990.08,3,2,4,9
1515915625563655654,76,3,248.67000000000002,2,3,3,8
1515915625563659431,76,1,84.89,2,1,2,5
1515915625563662396,36,2,96.54,3,2,3,8
1515915625563665234,76,1,609.6,2,1,4,7
1515915625563665437,76,1,177.95,2,1,3,6
1515915625563665772,76,1,57.33,2,1,2,5
1515915625563665864,61,4,437.89,3,3,4,10
1515915625563666320,76,1,72.98,2,1,2,5
1515915625563671418,65,1,466.52,3,1,4,8
1515915625563684591,76,1,80.37,2,1,2,5
1515915625563689773,38,1,11.63,3,1,1,5
1515915625563691566,75,3,578.58,2,3,4,9
1515915625563697535,75,1,115.71,2,1,3,6
1515915625563705802,75,1,409.49,2,1,4,7
1515915625563706108,74,1,501.54,2,1,4,7
1515915625563713726,75,1,155.11,2,1,3,6
1515915625563718408,75,4,84.94,2,3,2,7
1515915625563718996,75,1,20.71,2,1,1,4
1515915625563720364,75,1,202.67,2,1,3,6
1515915625563721753,74,7,83.99000000000001,2,4,2,8
1515915625563731921,75,1,53.95,2,1,2,5
1515915625563735084,75,1,31.59,2,1,1,4
1515915625563735934,75,1,140.63,2,1,3,6
1515915625563743109,75,1,959.83,2,1,4,7
1515915625563749889,75,1,34.62,2,1,2,5
1515915625563751887,43,1,187.78,3,1,3,7
1515915625563753262,75,1,17.3,2,1,1,4
1515915625563760656,75,1,547.97,2,1,4,7
1515915625563760660,75,1,13.48,2,1,1,4
1515915625563761929,75,1,16.19,2,1,1,4
1515915625563762458,75,1,26.9,2,1,1,4
1515915625563767515,75,1,284.46,2,1,3,6
1515915625563767910,75,1,229.38,2,1,3,6
1515915625563770228,75,1,75.71,2,1,2,5
1515915625563771569,75,1,118.57,2,1,3,6
1515915625563772966,75,1,30.0,2,1,1,4
1515915625563775408,75,1,249.38,2,1,3,6
1515915625563775816,75,1,75.71,2,1,2,5
1515915625563777169,75,10,1186.47,2,4,4,10
1515915625563780224,75,1,4.63,2,1,1,4
1515915625563780975,75,1,14.6,2,1,1,4
1515915625563782005,75,2,328.66,2,2,4,8
1515915625563791639,75,3,36.089999999999996,2,3,2,7
1515915625563799000,75,1,370.46,2,1,4,7
1515915625563803899,68,2,67.94,3,2,2,7
1515915625563808617,75,4,87.78,2,3,2,7
1515915625563809993,75,1,201.33,2,1,3,6
1515915625563811773,75,2,64.44,2,2,2,6
1515915625563812423,75,2,28.16,2,2,1,5
1515915625563812937,46,2,93.34,3,2,3,8
1515915625563813190,75,1,83.17,2,1,2,5
1515915625563818061,74,4,1030.8,2,3,4,9
1515915625563818387,75,2,148.88,2,2,3,7
1515915625563818544,75,1,13.86,2,1,1,4
1515915625563820432,75,1,415.54,2,1,4,7
1515915625563825998,75,1,15.92,2,1,1,4
1515915625563826349,75,2,240.96,2,2,3,7
1515915625563826438,74,3,406.23,2,3,4,9
1515915625563832039,63,3,40.230000000000004,3,3,2,8
1515915625563841470,69,4,1849.07,3,3,4,10
1515915625563843644,75,2,552.21,2,2,4,8
1515915625563847047,75,1,202.67,2,1,3,6
1515915625563849132,75,1,539.57,2,1,4,7
1515915625563849831,75,1,46.98,2,1,2,5
1515915625563852462,75,2,39.36,2,2,2,6
1515915625563854080,27,2,585.66,4,2,4,10
1515915625563854909,75,2,112.54,2,2,3,7
1515915625563855495,75,4,189.84,2,3,3,8
1515915625563856420,68,2,115.24,3,2,3,8
1515915625563857697,75,1,31.29,2,1,1,4
1515915625563878993,75,2,215.52,2,2,3,7
1515915625563882532,75,1,471.52,2,1,4,7
1515915625563885299,75,1,19.97,2,1,1,4
1515915625563887440,75,1,19.97,2,1,1,4
1515915625563889124,3,1,136.63,4,1,3,8
1515915625563890551,36,1,642.62,3,1,4,8
1515915625563902657,75,3,163.64,2,3,3,8
1515915625563902747,75,2,41.58,2,2,2,6
1515915625563902975,75,1,107.76,2,1,3,6
1515915625563910476,75,2,65.72,2,2,2,6
1515915625563916305,75,1,2.86,2,1,1,4
1515915625563918614,75,1,176.17,2,1,3,6
1515915625563924315,75,1,21.27,2,1,1,4
1515915625563925355,74,4,87.78,2,3,2,7
1515915625563926475,75,1,281.06,2,1,3,6
1515915625563927453,74,1,18.94,2,1,1,4
1515915625563928729,75,3,57.150000000000006,2,3,2,7
1515915625563930750,75,1,229.68,2,1,3,6
1515915625563932557,68,2,180.34,3,2,3,8
1515915625563932830,75,1,14.52,2,1,1,4
1515915625563935663,75,1,99.92,2,1,3,6
1515915625563936030,75,1,16.98,2,1,1,4
1515915625563938958,75,2,301.58,2,2,4,8
1515915625563941491,75,2,191.9,2,2,3,7
1515915625563961486,75,2,85.56,2,2,2,6
1515915625563963501,75,2,68.88,2,2,2,6
1515915625563963998,69,1,16.19,3,1,1,5
1515915625563965228,75,1,9.35,2,1,1,4
1515915625563967292,74,1,51.43,2,1,2,5
1515915625563967556,75,1,46.92,2,1,2,5
1515915625563967753,75,4,664.08,2,3,4,9
1515915625563977430,75,1,61.0,2,1,2,5
1515915625563981057,75,1,34.29,2,1,2,5
1515915625563981944,71,2,23.3,3,2,1,6
1515915625563984237,75,1,28.41,2,1,1,4
1515915625563987645,75,1,20.73,2,1,1,4
1515915625563990455,75,1,569.59,2,1,4,7
1515915625563990712,75,2,39.65,2,2,2,6
1515915625563990792,72,1,105.87,3,1,3,7
1515915625563996266,75,1,80.03,2,1,2,5
1515915625563998504,39,1,189.79,3,1,3,7
1515915625563998610,75,1,32.7,2,1,2,5
1515915625563999149,75,1,26.17,2,1,1,4
1515915625564004952,75,1,34.33,2,1,2,5
1515915625564006300,73,7,353.45,2,4,4,10
1515915625564017653,75,1,39.06,2,1,2,5
1515915625564019559,75,1,32.22,2,1,1,4
1515915625564021625,75,1,148.71,2,1,3,6
1515915625564023118,75,1,3.21,2,1,1,4
1515915625564027755,75,1,10.97,2,1,1,4
1515915625564028233,75,1,11.9,2,1,1,4
1515915625564031505,75,1,32.22,2,1,1,4
1515915625564032928,75,1,53.17,2,1,2,5
1515915625564034287,75,1,397.48,2,1,4,7
1515915625564036775,70,2,106.34,3,2,3,8
1515915625564037429,75,2,65.72,2,2,2,6
1515915625564040807,53,1,373.46,3,1,4,8
1515915625564042915,74,3,96.66,2,3,3,8
1515915625564064962,25,1,140.86,4,1,3,8
1515915625564066432,75,1,32.86,2,1,2,5
1515915625564067947,75,1,33.97,2,1,2,5
1515915625564069584,43,1,373.46,3,1,4,8
1515915625564069846,75,1,230.35,2,1,3,6
1515915625564073043,75,1,72.59,2,1,2,5
1515915625564074954,71,2,35.8,3,2,2,7
1515915625564075604,75,1,72.59,2,1,2,5
1515915625564077165,75,1,237.38,2,1,3,6
1515915625564078517,75,1,298.76,2,1,4,7
1515915625564079854,67,1,72.98,3,1,2,6
1515915625564082296,72,1,144.51,3,1,3,7
1515915625564082308,75,1,71.02,2,1,2,5
1515915625564089092,75,1,449.51,2,1,4,7
1515915625564094114,75,2,104.76,2,2,3,7
1515915625564097722,75,1,284.3,2,1,3,6
1515915625564099104,75,1,72.59,2,1,2,5
1515915625564102792,75,1,40.41,2,1,2,5
1515915625564106007,34,6,1357.09,4,4,4,12
1515915625564107082,75,1,18.89,2,1,1,4
1515915625564110990,75,1,577.6,2,1,4,7
1515915625564114760,75,2,5.72,2,2,1,5
1515915625564115501,75,1,26.46,2,1,1,4
1515915625564122261,75,1,34.54,2,1,2,5
1515915625564125509,75,1,20.79,2,1,1,4
1515915625564127707,74,2,219.68,2,2,3,7
1515915625564131737,75,1,23.57,2,1,1,4
1515915625564144031,74,1,71.75,2,1,2,5
1515915625564147708,74,1,42.7,2,1,2,5
1515915625564149573,74,4,129.72,2,3,3,8
1515915625564149867,74,1,104.13,2,1,3,6
1515915625564151479,28,5,144.14999999999998,4,4,3,11
1515915625564163605,74,2,408.58,2,2,4,8
1515915625564174658,74,1,374.38,2,1,4,7
1515915625564175145,73,2,1039.12,2,2,4,8
1515915625564178387,74,1,227.3,2,1,3,6
1515915625564179669,74,1,55.16,2,1,2,5
1515915625564182144,73,4,513.08,2,3,4,9
1515915625564183955,74,4,128.88,2,3,3,8
1515915625564192395,74,1,32.71,2,1,2,5
1515915625564193347,74,1,229.38,2,1,3,6
1515915625564193941,73,7,289.87,2,4,4,10
1515915625564199603,74,1,21.35,2,1,1,4
1515915625564203985,74,1,292.83,2,1,4,7
1515915625564204485,74,1,34.44,2,1,2,5
1515915625564206099,74,1,41.19,2,1,2,5
1515915625564206933,74,1,315.43,2,1,4,7
1515915625564207654,74,1,62.71,2,1,2,5
1515915625564213789,74,1,16.98,2,1,1,4
1515915625564215051,74,1,486.81,2,1,4,7
1515915625564216379,74,1,56.67,2,1,2,5
1515915625564218488,74,2,1201.2,2,2,4,8
1515915625564218743,74,1,30.16,2,1,1,4
1515915625564221385,64,1,294.41,3,1,4,8
1515915625564227051,74,1,201.33,2,1,3,6
1515915625564228744,74,3,140.01,2,3,3,8
1515915625564235911,74,2,46.96,2,2,2,6
1515915625564250332,74,1,62.3,2,1,2,5
1515915625564252393,74,3,510.75,2,3,4,9
1515915625564252398,74,5,3858.8,2,4,4,10
1515915625564256082,74,1,373.46,2,1,4,7
1515915625564256299,74,1,373.46,2,1,4,7
1515915625564256650,74,1,36.49,2,1,2,5
1515915625564265800,65,1,26.19,3,1,1,5
1515915625564271789,74,1,16.19,2,1,1,4
1515915625564272136,74,1,146.92,2,1,3,6
1515915625564272879,74,2,1002.82,2,2,4,8
1515915625564276750,74,1,53.06,2,1,2,5
1515915625564277729,74,1,53.17,2,1,2,5
1515915625564278396,74,1,449.51,2,1,4,7
1515915625564282084,70,2,51.46,3,2,2,7
1515915625564283418,70,2,95.56,3,2,3,8
1515915625564283646,74,1,349.46,2,1,4,7
1515915625564284872,73,2,1504.44,2,2,4,8
1515915625564288158,36,1,199.37,3,1,3,7
1515915625564288320,74,1,9.86,2,1,1,4
1515915625564291324,36,5,1524.33,3,4,4,11
1515915625564295236,74,4,907.36,2,3,4,9
1515915625564297995,74,1,15.1,2,1,1,4
1515915625564298581,74,1,226.84,2,1,3,6
1515915625564313644,69,2,71.42,3,2,2,7
1515915625564318564,74,1,47.46,2,1,2,5
1515915625564320336,59,1,399.48,3,1,4,8
1515915625564326734,74,1,461.52,2,1,4,7
1515915625564328354,74,1,190.03,2,1,3,6
1515915625564331072,74,1,38.57,2,1,2,5
1515915625564332143,74,1,336.57,2,1,4,7
1515915625564332179,73,8,180.56,2,4,3,9
1515915625564335789,74,1,25.59,2,1,1,4
1515915625564336276,74,2,798.96,2,2,4,8
1515915625564337745,74,1,448.51,2,1,4,7
1515915625564342387,38,2,416.77,3,2,4,9
1515915625564342851,74,2,49.2,2,2,2,6
1515915625564343050,72,1,16.98,3,1,1,5
1515915625564344842,74,1,403.46,2,1,4,7
1515915625564348653,74,2,30.32,2,2,1,5
1515915625564370503,74,1,3.21,2,1,1,4
1515915625564385403,73,1,22.52,2,1,1,4
1515915625564386184,74,1,415.54,2,1,4,7
1515915625564387613,74,1,63.27,2,1,2,5
1515915625564388367,74,1,64.48,2,1,2,5
1515915625564390935,74,2,30.32,2,2,1,5
1515915625564392658,74,1,205.49,2,1,3,6
1515915625564393442,74,1,122.86,2,1,3,6
1515915625564395379,74,4,1460.72,2,3,4,9
1515915625564397468,74,1,192.86,2,1,3,6
1515915625564399096,74,1,274.4,2,1,3,6
1515915625564400173,64,2,899.02,3,2,4,9
1515915625564401450,74,1,292.83,2,1,4,7
1515915625564403222,74,1,94.06,2,1,3,6
1515915625564404206,71,3,393.38,3,3,4,10
1515915625564409387,21,2,116.5,4,2,3,9
1515915625564428426,42,2,274.33,3,2,3,8
1515915625564435814,74,2,95.56,2,2,3,7
1515915625564436098,74,1,18.57,2,1,1,4
1515915625564437774,74,1,42.46,2,1,2,5
1515915625564441706,73,1,126.83,2,1,3,6
1515915625564444704,74,2,253.66,2,2,3,7
1515915625564445324,73,4,47.019999999999996,2,3,2,7
1515915625564445989,74,3,521.01,2,3,4,9
1515915625564446422,72,2,458.76,3,2,4,9
1515915625564450298,74,2,52.92,2,2,2,6
1515915625564453039,74,1,20.16,2,1,1,4
1515915625564457139,74,1,104.13,2,1,3,6
1515915625564457697,74,1,229.38,2,1,3,6
1515915625564462890,74,1,63.33,2,1,2,5
1515915625564462933,74,1,166.02,2,1,3,6
1515915625564464279,74,1,31.11,2,1,1,4
1515915625564466432,74,5,282.78,2,4,3,9
1515915625564468390,69,5,610.01,3,4,4,11
1515915625564473410,74,1,357.46,2,1,4,7
1515915625564474570,74,3,773.61,2,3,4,9
1515915625564477313,73,2,115.24,2,2,3,7
1515915625564478366,74,1,13.65,2,1,1,4
1515915625564478816,72,2,52.92,3,2,2,7
1515915625564479954,74,2,406.04,2,2,4,8
1515915625564480530,70,2,68.88,3,2,2,7
1515915625564480926,74,1,41.75,2,1,2,5
1515915625564482394,70,1,11.9,3,1,1,5
1515915625564482813,73,3,106.50999999999999,2,3,3,8
1515915625564483184,74,2,214.06,2,2,3,7
1515915625564485316,74,1,524.56,2,1,4,7
1515915625564486447,73,2,402.66,2,2,4,8
1515915625564491095,22,1,466.52,4,1,4,9
1515915625564492577,74,2,90.8,2,2,3,7
1515915625564493205,74,1,201.11,2,1,3,6
1515915625564495414,68,4,186.68,3,3,3,9
1515915625564496809,74,1,479.51,2,1,4,7
1515915625564497870,74,1,32.71,2,1,2,5
1515915625564499772,74,2,59.04,2,2,2,6
1515915625564501638,74,1,11.62,2,1,1,4
1515915625564517020,74,2,84.12,2,2,2,6
1515915625564532059,74,2,221.56,2,2,3,7
1515915625564532721,74,3,140.94,2,3,3,8
1515915625564533944,74,2,27.04,2,2,1,5
1515915625564534608,73,3,46.56,2,3,2,7
1515915625564534751,74,1,168.95,2,1,3,6
1515915625564535811,74,1,57.48,2,1,2,5
1515915625564536014,74,1,57.52,2,1,2,5
1515915625564536471,74,2,212.42999999999998,2,2,3,7
1515915625564538072,72,2,949.04,3,2,4,9
1515915625564544880,74,2,327.04,2,2,4,8
1515915625564545367,74,1,26.81,2,1,1,4
1515915625564551210,74,1,11.81,2,1,1,4
1515915625564551286,73,1,370.46,2,1,4,7
1515915625564556500,73,2,188.2,2,2,3,7
1515915625564559156,74,1,201.33,2,1,3,6
1515915625564562046,74,1,11.43,2,1,1,4
1515915625564566102,74,2,151.67,2,2,3,7
1515915625564567899,74,1,29.48,2,1,1,4
1515915625564568153,74,1,284.3,2,1,3,6
1515915625564574656,71,1,453.98,3,1,4,8
1515915625564576209,74,2,131.26,2,2,3,7
1515915625564579095,74,1,10.59,2,1,1,4
1515915625564581515,74,1,26.98,2,1,1,4
1515915625564582203,74,1,113.81,2,1,3,6
1515915625564585316,74,2,64.44,2,2,2,6
1515915625564586757,74,1,25.4,2,1,1,4
1515915625564591375,74,2,55.4,2,2,2,6
1515915625564598265,74,2,74.0,2,2,2,6
1515915625564598574,73,3,195.71999999999997,2,3,3,8
1515915625564609103,73,1,959.83,2,1,4,7
1515915625564612174,27,6,2192.46,4,4,4,12
1515915625564625869,36,1,415.54,3,1,4,8
1515915625564636434,73,1,49.38,2,1,2,5
1515915625564643361,73,2,27.3,2,2,1,5
1515915625564647461,73,1,191.52,2,1,3,6
1515915625564649807,73,1,449.51,2,1,4,7
1515915625564652086,73,3,291.57,2,3,4,9
1515915625564653367,73,4,1830.04,2,3,4,9
1515915625564655056,73,1,25.4,2,1,1,4
1515915625564664391,73,1,268.17,2,1,3,6
1515915625564672642,73,4,313.4,2,3,4,9
1515915625564672702,45,2,176.5,3,2,3,8
1515915625564676313,73,1,159.1,2,1,3,6
1515915625564678673,32,2,484.57,4,2,4,10
1515915625564683557,73,1,32.7,2,1,2,5
1515915625564684935,73,1,13.65,2,1,1,4
1515915625564687792,73,2,846.98,2,2,4,8
1515915625564689915,73,1,26.98,2,1,1,4
1515915625564691569,73,1,11.98,2,1,1,4
1515915625564691680,73,1,150.29,2,1,3,6
1515915625564691928,65,1,30.83,3,1,1,5
1515915625564697635,73,1,26.19,2,1,1,4
1515915625564697840,73,1,153.83,2,1,3,6
1515915625564699305,73,1,153.83,2,1,3,6
1515915625564705607,73,2,97.56,2,2,3,7
1515915625564714330,73,1,24.9,2,1,1,4
1515915625564714554,73,1,49.6,2,1,2,5
1515915625564714609,73,2,82.64,2,2,2,6
1515915625564719306,72,1,72.98,3,1,2,6
1515915625564722629,61,1,444.51,3,1,4,8
1515915625564724608,73,1,10.71,2,1,1,4
1515915625564724816,73,2,500.76,2,2,4,8
1515915625564724942,57,7,1438.43,3,4,4,11
1515915625564728538,49,8,1643.92,3,4,4,11
1515915625564729669,73,1,29.22,2,1,1,4
1515915625564733134,73,1,209.05,2,1,3,6
1515915625564735401,73,1,12.48,2,1,1,4
1515915625564736330,73,1,10.71,2,1,1,4
1515915625564738890,73,1,95.52,2,1,3,6
1515915625564741068,48,6,1657.88,3,4,4,11
1515915625564741576,73,2,80.64,2,2,2,6
1515915625564744686,71,2,397.24,3,2,4,9
1515915625564750776,73,2,53.5,2,2,2,6
1515915625564754935,73,2,18.7,2,2,1,5
1515915625564755441,73,2,500.76,2,2,4,8
1515915625564756612,73,1,21.65,2,1,1,4
1515915625564760219,73,2,165.94,2,2,3,7
1515915625564762288,73,3,80.94,2,3,2,7
1515915625564762856,39,1,13.65,3,1,1,5
1515915625564770102,72,2,453.68,3,2,4,9
1515915625564770619,73,1,45.24,2,1,2,5
1515915625564771601,73,1,23.9,2,1,1,4
1515915625564772568,18,1,294.41,4,1,4,9
1515915625564774355,73,2,1256.23,2,2,4,8
1515915625564775316,21,3,31.44,4,3,1,8
1515915625564776537,73,1,17.48,2,1,1,4
1515915625564778197,73,4,40.2,2,3,2,7
1515915625564801330,73,1,9.57,2,1,1,4
1515915625564801339,73,1,136.05,2,1,3,6
1515915625564802923,42,3,46.2,3,3,2,8
1515915625564804073,71,2,106.34,3,2,3,8
1515915625564806018,12,1,288.41,4,1,4,9
1515915625564806184,68,12,237.36,3,4,3,10
1515915625564806360,73,1,155.1,2,1,3,6
1515915625564808548,73,1,266.75,2,1,3,6
1515915625564810694,73,1,211.71,2,1,3,6
1515915625564811389,73,3,1278.47,2,3,4,9
1515915625564813605,73,1,211.71,2,1,3,6
1515915625564819910,71,4,47.92,3,3,2,8
1515915625564823742,73,1,25.4,2,1,1,4
1515915625564827203,73,1,25.4,2,1,1,4
1515915625564828654,73,3,111.0,2,3,3,8
1515915625564828782,73,3,140.94,2,3,3,8
1515915625564829655,73,1,371.46,2,1,4,7
1515915625564830595,73,1,466.52,2,1,4,7
1515915625564831413,66,2,1795.58,3,2,4,9
1515915625564833076,54,2,405.34,3,2,4,9
1515915625564833833,69,6,509.70000000000005,3,4,4,11
1515915625564837346,73,1,310.21,2,1,4,7
1515915625564838793,73,1,149.32,2,1,3,6
1515915625564839925,73,1,203.02,2,1,3,6
1515915625564841070,65,1,42.87,3,1,2,6
1515915625564842055,71,2,889.02,3,2,4,9
1515915625564842260,73,1,104.13,2,1,3,6
1515915625564843877,73,1,23.78,2,1,1,4
1515915625564844292,73,2,19.18,2,2,1,5
1515915625564849782,73,3,928.23,2,3,4,9
1515915625564852847,73,1,371.46,2,1,4,7
1515915625564855534,68,1,587.6,3,1,4,8
1515915625564856872,73,1,60.78,2,1,2,5
1515915625564858029,73,1,584.59,2,1,4,7
1515915625564889420,73,1,14.22,2,1,1,4
1515915625564896265,72,2,254.16000000000003,3,2,3,8
1515915625564901474,73,2,272.1,2,2,3,7
1515915625564903053,73,1,34.44,2,1,2,5
1515915625564906875,67,2,155.46,3,2,3,8
1515915625564909312,73,1,23.57,2,1,1,4
1515915625564916618,72,1,204.29,3,1,3,7
1515915625564917509,72,1,441.49,3,1,4,8
1515915625564924404,73,1,167.62,2,1,3,6
1515915625564926879,73,2,227.62,2,2,3,7
1515915625564934132,73,8,395.04,2,4,4,10
1515915625564939205,73,1,14.37,2,1,1,4
1515915625564940230,73,1,107.3,2,1,3,6
1515915625564941247,73,1,423.49,2,1,4,7
1515915625564941887,67,4,288.76,3,3,4,10
1515915625564942225,73,1,284.3,2,1,3,6
1515915625564945094,44,1,88.25,3,1,2,6
1515915625564947910,73,1,294.41,2,1,4,7
1515915625564951740,73,1,9.35,2,1,1,4
1515915625564953464,73,5,2364.6,2,4,4,10
1515915625564955189,73,5,275.79999999999995,2,4,3,9
1515915625564957308,70,1,199.7,3,1,3,7
1515915625564958107,73,2,27.3,2,2,1,5
1515915625564965419,70,3,78.57000000000001,3,3,2,8
1515915625564990737,73,1,21.51,2,1,1,4
1515915625564991053,73,1,34.44,2,1,2,5
1515915625564993583,73,3,96.66,2,3,3,8
1515915625564994268,73,2,26.04,2,2,1,5
1515915625564999985,55,1,38.83,3,1,2,6
1515915625565004865,39,2,87.66,3,2,2,7
1515915625565015019,69,2,1191.33,3,2,4,9
1515915625565020495,73,4,429.2,2,3,4,9
1515915625565020642,73,2,143.18,2,2,3,7
1515915625565033746,73,1,71.59,2,1,2,5
1515915625565034701,73,1,257.87,2,1,3,6
1515915625565036369,73,1,26.98,2,1,1,4
1515915625565040025,73,2,53.66,2,2,2,6
1515915625565045776,73,1,457.51,2,1,4,7
1515915625565047234,70,2,410.5,3,2,4,9
1515915625565049975,73,1,669.05,2,1,4,7
1515915625565050058,73,1,1828.4,2,1,4,7
1515915625565051059,73,4,2134.92,2,3,4,9
1515915625565053121,70,1,57.57,3,1,2,6
1515915625565071557,72,1,10.43,3,1,1,5
1515915625565076001,53,1,382.94,3,1,4,8
1515915625565078204,72,1,13.4,3,1,1,5
1515915625565081048,72,1,136.83,3,1,3,7
1515915625565085420,72,1,77.73,3,1,2,6
1515915625565086581,72,2,33.96,3,2,2,7
1515915625565086789,72,1,21.25,3,1,1,5
1515915625565089253,72,1,63.33,3,1,2,6
1515915625565089971,72,4,137.76,3,3,3,9
1515915625565093371,72,1,88.41,3,1,2,6
1515915625565103568,72,1,94.1,3,1,3,7
1515915625565107790,72,1,50.63,3,1,2,6
1515915625565118501,72,2,187.26,3,2,3,8
1515915625565119510,72,1,45.27,3,1,2,6
1515915625565122184,72,1,34.44,3,1,2,6
1515915625565127547,72,1,501.54,3,1,4,8
1515915625565128031,72,1,126.68,3,1,3,7
1515915625565130484,72,1,167.62,3,1,3,7
1515915625565131324,72,4,41.72,3,3,2,8
1515915625565132256,72,3,151.89000000000001,3,3,3,9
1515915625565134768,72,1,502.87,3,1,4,8
1515915625565135205,72,1,15.44,3,1,1,5
1515915625565142309,72,1,33.97,3,1,2,6
1515915625565143725,72,3,76.62,3,3,2,8
1515915625565149746,72,1,189.54,3,1,3,7
1515915625565160538,72,1,397.48,3,1,4,8
1515915625565174840,72,1,33.14,3,1,2,6
1515915625565177454,72,2,70.2,3,2,2,7
1515915625565179032,72,1,26.98,3,1,1,5
1515915625565179321,72,2,428.2,3,2,4,9
1515915625565180287,72,1,35.1,3,1,2,6
1515915625565180581,72,1,67.0,3,1,2,6
1515915625565183792,72,20,3694.56,3,4,4,11
1515915625565184986,72,1,198.62,3,1,3,7
1515915625565185241,24,3,721.03,4,3,4,11
1515915625565187310,70,2,428.2,3,2,4,9
1515915625565187510,71,1,118.57,3,1,3,7
1515915625565191178,69,4,1030.8,3,3,4,10
1515915625565191386,72,1,130.0,3,1,3,7
1515915625565197839,72,4,212.68,3,3,3,9
1515915625565199248,72,1,113.81,3,1,3,7
1515915625565199940,72,1,137.4,3,1,3,7
1515915625565200288,72,1,43.11,3,1,2,6
1515915625565207471,71,13,1529.08,3,4,4,11
1515915625565207688,72,1,74.59,3,1,2,6
1515915625565208108,72,1,28.1,3,1,1,5
1515915625565209925,69,1,80.03,3,1,2,6
1515915625565212931,72,2,794.96,3,2,4,9
1515915625565253781,72,1,187.29,3,1,3,7
1515915625565254406,72,2,58.44,3,2,2,7
1515915625565254936,72,1,15.08,3,1,1,5
1515915625565257495,44,1,32.22,3,1,1,5
1515915625565259376,72,1,11.13,3,1,1,5
1515915625565261480,72,2,56.16,3,2,2,7
1515915625565261698,72,1,18.89,3,1,1,5
1515915625565261977,72,1,113.81,3,1,3,7
1515915625565264533,72,1,67.27,3,1,2,6
1515915625565267409,64,1,10.21,3,1,1,5
1515915625565269866,72,3,755.76,3,3,4,10
1515915625565271029,72,1,130.0,3,1,3,7
1515915625565275861,71,1,107.79,3,1,3,7
1515915625565277429,72,2,923.04,3,2,4,9
1515915625565279333,72,1,23.48,3,1,1,5
1515915625565280343,72,1,10.95,3,1,1,5
1515915625565282234,72,2,42.0,3,2,2,7
1515915625565283541,72,2,18.7,3,2,1,6
1515915625565285046,72,1,81.27,3,1,2,6
1515915625565287726,72,4,139.68,3,3,3,9
1515915625565288403,72,1,486.81,3,1,4,8
1515915625565290455,72,1,155.1,3,1,3,7
1515915625565290701,72,1,48.57,3,1,2,6
1515915625565294495,72,3,248.91,3,3,3,9
1515915625565297433,72,1,11.98,3,1,1,5
1515915625565299850,72,2,52.92,3,2,2,7
1515915625565301888,69,1,85.71,3,1,2,6
1515915625565303557,72,1,17.3,3,1,1,5
1515915625565305071,72,1,90.73,3,1,3,7
1515915625565305785,72,1,47.89,3,1,2,6
1515915625565307079,70,2,111.74,3,2,3,8
1515915625565312360,69,1,128.33,3,1,3,7
1515915625565330077,72,1,159.97,3,1,3,7
1515915625565352391,70,1,397.48,3,1,4,8
1515915625565352738,72,1,397.48,3,1,4,8
1515915625565353843,72,1,142.05,3,1,3,7
1515915625565358026,72,1,51.33,3,1,2,6
1515915625565360682,72,1,26.19,3,1,1,5
1515915625565365926,53,1,547.97,3,1,4,8
1515915625565366188,72,1,98.21,3,1,3,7
1515915625565371531,72,1,29.22,3,1,1,5
1515915625565374171,72,1,170.95,3,1,3,7
1515915625565378595,72,2,128.58,3,2,3,8
1515915625565382582,72,5,250.55,3,4,3,10
1515915625565382653,72,1,29.22,3,1,1,5
1515915625565385220,72,10,1523.29,3,4,4,11
1515915625565385411,72,3,150.32999999999998,3,3,3,9
1515915625565385528,72,1,371.46,3,1,4,8
1515915625565386978,72,2,711.31,3,2,4,9
1515915625565393156,72,3,78.51,3,3,2,8
1515915625565399343,72,1,80.35,3,1,2,6
1515915625565405471,72,1,80.35,3,1,2,6
1515915625565406254,72,1,82.89,3,1,2,6
1515915625565407106,72,1,63.98,3,1,2,6
1515915625565407728,72,1,13.65,3,1,1,5
1515915625565409276,72,1,32.22,3,1,1,5
1515915625565413104,72,1,148.37,3,1,3,7
1515915625565414885,72,2,515.74,3,2,4,9
1515915625565415328,67,1,14.17,3,1,1,5
1515915625565416411,72,1,490.54,3,1,4,8
1515915625565419081,72,1,26.98,3,1,1,5
1515915625565422558,72,1,10.97,3,1,1,5
1515915625565439904,70,3,248.67000000000002,3,3,3,9
1515915625565454165,72,1,9.89,3,1,1,5
1515915625565455379,3,1,819.75,4,1,4,9
1515915625565456121,72,1,29.52,3,1,1,5
1515915625565456689,48,1,73.81,3,1,2,6
1515915625565459117,57,1,46.67,3,1,2,6
1515915625565465782,72,1,600.6,3,1,4,8
1515915625565468687,17,1,230.35,4,1,3,8
1515915625565469110,72,1,79.68,3,1,2,6
1515915625565470562,70,3,105.30000000000001,3,3,3,9
1515915625565472479,72,1,23.48,3,1,1,5
1515915625565477424,65,5,1034.23,3,4,4,11
1515915625565484431,72,1,68.57,3,1,2,6
1515915625565485367,72,1,210.9,3,1,3,7
1515915625565486025,72,2,130.28,3,2,3,8
1515915625565489304,72,2,70.16,3,2,2,7
1515915625565490986,72,2,298.64,3,2,4,9
1515915625565493828,72,1,355.35,3,1,4,8
1515915625565500431,72,1,72.19,3,1,2,6
1515915625565505812,69,2,23.72,3,2,1,6
1515915625565509936,72,1,61.16,3,1,2,6
1515915625565512516,60,1,449.51,3,1,4,8
1515915625565518707,72,2,81.26,3,2,2,7
1515915625565519720,70,3,76.19999999999999,3,3,2,8
1515915625565521551,71,3,159.51,3,3,3,9
1515915625565521754,72,8,1922.49,3,4,4,11
1515915625565521938,72,1,349.46,3,1,4,8
1515915625565526720,71,1,12.51,3,1,1,5
1515915625565527880,72,1,187.29,3,1,3,7
1515915625565538809,71,1,20.16,3,1,1,5
1515915625565544028,59,3,209.4,3,3,3,9
1515915625565545016,71,1,176.17,3,1,3,7
1515915625565546453,71,1,33.97,3,1,2,6
1515915625565565671,71,2,165.94,3,2,3,8
1515915625565572117,71,2,420.38,3,2,4,9
1515915625565576868,71,2,100.32,3,2,3,8
1515915625565581602,71,1,55.87,3,1,2,6
1515915625565591281,71,2,75.34,3,2,2,7
1515915625565592271,20,1,34.59,4,1,2,7
1515915625565596684,71,1,9.81,3,1,1,5
1515915625565598800,71,2,765.88,3,2,4,9
1515915625565599095,71,1,45.24,3,1,2,6
1515915625565602927,71,1,36.51,3,1,2,6
1515915625565603438,71,1,257.87,3,1,3,7
1515915625565604413,71,1,48.68,3,1,2,6
1515915625565609212,71,2,47.4,3,2,2,7
1515915625565615548,71,1,19.68,3,1,1,5
1515915625565617941,11,3,148.39000000000001,4,3,3,10
1515915625565640229,55,1,259.38,3,1,3,7
1515915625565644258,33,3,1616.68,4,3,4,11
1515915625565650240,71,3,400.95000000000005,3,3,4,10
1515915625565655191,71,1,132.37,3,1,3,7
1515915625565658490,52,9,289.98,3,4,4,11
1515915625565662207,43,2,1079.14,3,2,4,9
1515915625565663228,71,1,52.9,3,1,2,6
1515915625565664531,61,1,189.17,3,1,3,7
1515915625565665053,71,1,102.7,3,1,3,7
1515915625565669009,59,14,2968.21,3,4,4,11
1515915625565670020,71,2,62.54,3,2,2,7
1515915625565674347,69,1,55.16,3,1,2,6
1515915625565681241,71,1,263.52,3,1,3,7
1515915625565685409,71,1,79.68,3,1,2,6
1515915625565686650,71,4,1947.24,3,3,4,10
1515915625565686656,70,2,447.15999999999997,3,2,4,9
1515915625565689157,71,1,61.86,3,1,2,6
1515915625565690475,71,2,134.7,3,2,3,8
1515915625565707176,71,3,790.7199999999999,3,3,4,10
1515915625565707315,71,1,203.29,3,1,3,7
1515915625565730400,71,1,42.86,3,1,2,6
1515915625565731745,71,1,53.17,3,1,2,6
1515915625565734413,71,1,118.57,3,1,3,7
1515915625565740867,71,2,171.42,3,2,3,8
1515915625565741092,71,5,181.69,3,4,3,10
1515915625565743600,71,2,42.54,3,2,2,7
1515915625565744526,71,1,110.95,3,1,3,7
1515915625565749642,68,3,30.96,3,3,1,7
1515915625565755754,71,3,608.8499999999999,3,3,4,10
1515915625565755922,71,1,466.52,3,1,4,8
1515915625565756118,71,2,305.4,3,2,4,9
1515915625565768166,65,3,1242.3899999999999,3,3,4,10
1515915625565774594,71,1,466.52,3,1,4,8
1515915625565775164,71,1,466.52,3,1,4,8
1515915625565775271,52,1,12.22,3,1,1,5
1515915625565778402,71,1,16.67,3,1,1,5
1515915625565779753,71,1,64.48,3,1,2,6
1515915625565781322,71,3,612.87,3,3,4,10
1515915625565787516,71,1,398.7,3,1,4,8
1515915625565797145,71,1,34.3,3,1,2,6
1515915625565833648,71,2,196.12,3,2,3,8
1515915625565833830,71,2,310.2,3,2,4,9
1515915625565834881,71,1,13.1,3,1,1,5
1515915625565835627,71,2,518.76,3,2,4,9
1515915625565837394,71,1,46.98,3,1,2,6
1515915625565837629,71,1,35.87,3,1,2,6
1515915625565843822,71,1,20.16,3,1,1,5
1515915625565862117,71,3,259.44,3,3,3,9
1515915625565862194,71,1,25.4,3,1,1,5
1515915625565862602,71,1,149.05,3,1,3,7
1515915625565864562,63,1,220.3,3,1,3,7
1515915625565864739,35,1,248.29,4,1,3,8
1515915625565870812,71,1,29.68,3,1,1,5
1515915625565874615,70,1,370.46,3,1,4,8
1515915625565878311,64,7,938.4599999999999,3,4,4,11
1515915625565879446,71,2,49.84,3,2,2,7
1515915625565879714,71,1,23.65,3,1,1,5
1515915625565880513,71,1,57.62,3,1,2,6
1515915625565880783,71,1,32.38,3,1,2,6
1515915625565880937,71,1,11.75,3,1,1,5
1515915625565881511,71,3,70.71000000000001,3,3,2,8
1515915625565881963,71,1,23.57,3,1,1,5
1515915625565883603,71,1,281.21,3,1,3,7
1515915625565883819,71,1,12.46,3,1,1,5
1515915625565886525,71,1,23.57,3,1,1,5
1515915625565888115,71,1,222.06,3,1,3,7
1515915625565890053,40,3,166.68,3,3,3,9
1515915625565896186,45,1,277.1,3,1,3,7
1515915625565907155,71,1,32.7,3,1,2,6
1515915625565911660,71,2,177.78,3,2,3,8
1515915625565926044,71,1,126.68,3,1,3,7
1515915625565936924,71,1,16.19,3,1,1,5
1515915625565939100,71,1,73.81,3,1,2,6
1515915625565940226,71,1,107.16,3,1,3,7
1515915625565945645,27,1,188.06,4,1,3,8
1515915625565957281,71,1,32.22,3,1,1,5
1515915625565957343,70,2,386.5,3,2,4,9
1515915625565958502,71,1,18.57,3,1,1,5
1515915625565958738,68,1,87.16,3,1,2,6
1515915625565959199,70,6,451.74,3,4,4,11
1515915625565959220,45,2,515.74,3,2,4,9
1515915625565960937,70,1,370.46,3,1,4,8
1515915625565963984,14,1,33.33,4,1,2,7
1515915625565967229,71,4,74.45,3,3,2,8
1515915625565967446,44,1,294.41,3,1,4,8
1515915625565978047,71,1,316.43,3,1,4,8
1515915625565993392,64,1,399.48,3,1,4,8
1515915625565996806,71,1,20.71,3,1,1,5
1515915625565996933,70,2,176.92,3,2,3,8
1515915625566000460,55,5,1277.87,3,4,4,11
1515915625566002860,71,1,20.63,3,1,1,5
1515915625566006036,71,2,21.42,3,2,1,6
1515915625566009347,71,1,167.0,3,1,3,7
1515915625566013768,71,1,449.51,3,1,4,8
1515915625566020203,71,1,204.29,3,1,3,7
1515915625566023453,70,1,72.98,3,1,2,6
1515915625566025732,70,1,382.94,3,1,4,8
1515915625566034278,70,1,13.54,3,1,1,5
1515915625566040830,70,2,568.81,3,2,4,9
1515915625566043851,70,3,1361.58,3,3,4,10
1515915625566045592,70,1,11.65,3,1,1,5
1515915625566050655,70,1,86.37,3,1,2,6
1515915625566050945,70,4,770.04,3,3,4,10
1515915625566051255,70,4,228.24,3,3,3,9
1515915625566054130,70,2,59.68,3,2,2,7
1515915625566058215,70,1,44.13,3,1,2,6
1515915625566059991,63,1,187.29,3,1,3,7
1515915625566060921,70,1,466.52,3,1,4,8
1515915625566070961,70,1,19.52,3,1,1,5
1515915625566071269,70,1,204.29,3,1,3,7
1515915625566072983,70,2,36.5,3,2,2,7
1515915625566075580,70,1,210.68,3,1,3,7
1515915625566078582,70,1,399.48,3,1,4,8
1515915625566083977,67,4,310.92,3,3,4,10
1515915625566085614,21,2,919.04,4,2,4,10
1515915625566086186,63,9,4001.5299999999997,3,4,4,11
1515915625566086671,70,1,9.43,3,1,1,5
1515915625566086811,70,1,127.08,3,1,3,7
1515915625566088637,70,1,67.97,3,1,2,6
1515915625566090538,70,1,397.48,3,1,4,8
1515915625566093382,66,2,81.58,3,2,2,7
1515915625566097084,69,1,155.1,3,1,3,7
1515915625566098610,70,2,126.03,3,2,3,8
1515915625566100878,70,1,88.44,3,1,2,6
1515915625566101876,70,1,16.51,3,1,1,5
1515915625566105519,70,1,10.38,3,1,1,5
1515915625566107272,70,1,205.49,3,1,3,7
1515915625566107373,70,1,22.22,3,1,1,5
1515915625566107540,70,1,155.1,3,1,3,7
1515915625566109927,11,7,351.12,4,4,4,12
1515915625566112850,70,1,26.98,3,1,1,5
1515915625566113454,70,1,16.67,3,1,1,5
1515915625566113712,70,2,111.2,3,2,3,8
1515915625566128588,10,2,408.58,4,2,4,10
1515915625566129237,70,3,71.52,3,3,2,8
1515915625566135235,70,1,14.14,3,1,1,5
1515915625566138429,70,1,21.43,3,1,1,5
1515915625566139741,68,4,465.69000000000005,3,3,4,10
1515915625566142874,70,1,16.98,3,1,1,5
1515915625566146403,70,5,79.35,3,4,2,9
1515915625566146678,70,1,52.9,3,1,2,6
1515915625566148831,70,1,11.62,3,1,1,5
1515915625566150803,55,1,548.37,3,1,4,8
1515915625566157209,67,1,490.54,3,1,4,8
1515915625566157284,70,1,68.57,3,1,2,6
1515915625566165139,70,1,397.48,3,1,4,8
1515915625566165239,70,1,11.13,3,1,1,5
1515915625566169944,70,1,45.24,3,1,2,6
1515915625566170331,70,1,23.81,3,1,1,5
1515915625566171833,70,1,600.6,3,1,4,8
1515915625566173184,70,1,56.27,3,1,2,6
1515915625566173627,70,1,56.27,3,1,2,6
1515915625566174872,70,1,58.32,3,1,2,6
1515915625566179125,70,3,1384.56,3,3,4,10
1515915625566182340,69,1,466.52,3,1,4,8
1515915625566184244,39,4,1633.52,3,3,4,10
1515915625566184744,70,1,21.21,3,1,1,5
1515915625566186779,70,1,22.43,3,1,1,5
1515915625566214787,70,3,1399.56,3,3,4,10
1515915625566215101,70,1,64.89,3,1,2,6
1515915625566217655,70,1,23.57,3,1,1,5
1515915625566218454,70,1,10.21,3,1,1,5
1515915625566218940,70,1,114.6,3,1,3,7
1515915625566220248,70,1,55.16,3,1,2,6
1515915625566226466,70,1,27.62,3,1,1,5
1515915625566227681,70,1,12.27,3,1,1,5
1515915625566228321,70,1,115.4,3,1,3,7
1515915625566228647,70,1,69.21,3,1,2,6
1515915625566228830,70,1,183.6,3,1,3,7
1515915625566231935,68,4,1529.92,3,3,4,10
1515915625566237056,70,1,50.6,3,1,2,6
1515915625566238367,41,3,985.5,3,3,4,10
1515915625566239751,70,1,23.57,3,1,1,5
1515915625566240290,70,1,130.17,3,1,3,7
1515915625566244502,70,1,449.51,3,1,4,8
1515915625566247449,70,1,183.49,3,1,3,7
1515915625566248234,70,1,115.4,3,1,3,7
1515915625566249512,70,1,599.6,3,1,4,8
1515915625566255778,70,1,20.16,3,1,1,5
1515915625566260271,70,1,100.75,3,1,3,7
1515915625566261864,70,4,73.60000000000001,3,3,2,8
1515915625566263664,63,2,1543.46,3,2,4,9
1515915625566265280,70,1,98.81,3,1,3,7
1515915625566267200,70,2,421.8,3,2,4,9
1515915625566268176,70,1,9.35,3,1,1,5
1515915625566269363,70,1,34.56,3,1,2,6
1515915625566270143,70,1,32.22,3,1,1,5
1515915625566271295,70,2,1141.18,3,2,4,9
1515915625566273583,70,1,201.33,3,1,3,7
1515915625566282433,70,1,64.48,3,1,2,6
1515915625566295922,70,2,27.72,3,2,1,6
1515915625566296499,63,3,533.8499999999999,3,3,4,10
1515915625566298173,69,2,81.58,3,2,2,7
1515915625566298970,70,1,77.73,3,1,2,6
1515915625566302318,70,1,26.19,3,1,1,5
1515915625566302618,70,1,9.35,3,1,1,5
1515915625566305269,64,3,50.010000000000005,3,3,2,8
1515915625566310628,9,4,116.88,4,3,3,10
1515915625566320655,70,2,3.14,3,2,1,6
1515915625566321285,48,1,97.57,3,1,3,7
1515915625566326919,69,7,2973.58,3,4,4,11
1515915625566345432,70,5,69.7,3,4,2,9
1515915625566347873,70,1,52.9,3,1,2,6
1515915625566350652,70,7,143.23,3,4,3,10
1515915625566351746,70,1,24.6,3,1,1,5
1515915625566352380,70,10,199.84,3,4,3,10
1515915625566353173,70,1,482.52,3,1,4,8
1515915625566354325,59,1,75.05,3,1,2,6
1515915625566355039,70,1,32.22,3,1,1,5
1515915625566355813,70,1,163.52,3,1,3,7
1515915625566358560,69,1,108.73,3,1,3,7
1515915625566358594,70,1,173.67,3,1,3,7
1515915625566359221,69,3,853.46,3,3,4,10
1515915625566362264,69,1,284.46,3,1,3,7
1515915625566368918,35,2,289.02,4,2,4,10
1515915625566370209,70,1,10.48,3,1,1,5
1515915625566371385,46,8,1712.8,3,4,4,11
1515915625566373017,70,1,8.7,3,1,1,5
1515915625566373340,69,1,34.76,3,1,2,6
1515915625566374387,70,1,215.24,3,1,3,7
1515915625566374530,70,1,415.54,3,1,4,8
1515915625566379011,70,1,72.59,3,1,2,6
1515915625566403622,70,1,59.06,3,1,2,6
1515915625566408237,70,1,29.84,3,1,1,5
1515915625566413678,70,1,26.19,3,1,1,5
1515915625566413869,44,2,97.46,3,2,3,8
1515915625566417082,45,5,2978.0,3,4,4,11
1515915625566417536,70,2,88.26,3,2,2,7
1515915625566418765,69,1,397.48,3,1,4,8
1515915625566420204,70,1,13.65,3,1,1,5
1515915625566420345,70,1,274.4,3,1,3,7
1515915625566421905,70,2,69.4,3,2,2,7
1515915625566422860,69,2,880.0,3,2,4,9
1515915625566428313,70,3,227.01,3,3,3,9
1515915625566428692,70,2,21.26,3,2,1,6
1515915625566429476,70,1,210.19,3,1,3,7
1515915625566433950,69,2,85.56,3,2,2,7
1515915625566436217,69,2,104.33,3,2,3,8
1515915625566440571,70,1,14.02,3,1,1,5
1515915625566444110,70,1,23.48,3,1,1,5
1515915625566444567,66,1,53.9,3,1,2,6
1515915625566448478,70,1,77.73,3,1,2,6
1515915625566454965,51,1,166.02,3,1,3,7
1515915625566456992,69,1,449.51,3,1,4,8
1515915625566457274,56,1,397.48,3,1,4,8
1515915625566465108,70,1,44.57,3,1,2,6
1515915625566470767,70,1,23.49,3,1,1,5
1515915625566471703,70,1,242.86,3,1,3,7
1515915625566476176,70,2,536.34,3,2,4,9
1515915625566476443,42,1,21.4,3,1,1,5
1515915625566477621,69,1,292.83,3,1,4,8
1515915625566478542,70,1,25.73,3,1,1,5
1515915625566482958,69,2,19.68,3,2,1,6
1515915625566484083,69,1,115.4,3,1,3,7
1515915625566502089,69,1,458.51,3,1,4,8
1515915625566502310,68,2,72.06,3,2,2,7
1515915625566502762,69,1,149.7,3,1,3,7
1515915625566503271,69,1,17.78,3,1,1,5
1515915625566503846,68,2,72.06,3,2,2,7
1515915625566504260,69,1,72.05,3,1,2,6
1515915625566506255,1,1,38.78,4,1,2,7
1515915625566516008,67,4,880.06,3,3,4,10
1515915625566516340,69,1,444.51,3,1,4,8
1515915625566517611,69,1,203.02,3,1,3,7
1515915625566523792,64,1,183.03,3,1,3,7
1515915625566526490,69,3,261.48,3,3,3,9
1515915625566526777,69,1,154.32,3,1,3,7
1515915625566529424,68,2,18.7,3,2,1,6
1515915625566532210,69,3,83.64,3,3,2,8
1515915625566532459,69,1,21.11,3,1,1,5
1515915625566535303,15,2,77.26,4,2,2,8
1515915625566537293,69,1,136.05,3,1,3,7
1515915625566539155,69,2,253.56,3,2,3,8
1515915625566539579,69,2,29.2,3,2,1,6
1515915625566542646,69,1,53.95,3,1,2,6
1515915625566542943,69,1,49.11,3,1,2,6
1515915625566544949,69,1,14.29,3,1,1,5
1515915625566549954,69,1,13.81,3,1,1,5
1515915625566551129,69,1,202.95,3,1,3,7
1515915625566553524,69,6,711.42,3,4,4,11
1515915625566555320,69,1,10.59,3,1,1,5
1515915625566559972,69,3,397.47,3,3,4,10
1515915625566560234,69,2,264.98,3,2,3,8
1515915625566562317,68,1,449.51,3,1,4,8
1515915625566562811,69,3,642.24,3,3,4,10
1515915625566563267,69,1,32.22,3,1,1,5
1515915625566565628,69,1,236.67,3,1,3,7
1515915625566567057,69,1,10.63,3,1,1,5
1515915625566567265,69,8,272.64,3,4,3,10
1515915625566575996,56,1,457.51,3,1,4,8
1515915625566577434,69,1,156.57,3,1,3,7
1515915625566578363,69,2,279.2,3,2,3,8
1515915625566762341,69,1,414.13,3,1,4,8
1515915625566806759,69,1,161.51,3,1,3,7
1515915625566825839,69,1,45.24,3,1,2,6
1515915625566829184,69,1,171.41,3,1,3,7
1515915625566838858,68,3,103.32,3,3,3,9
1515915625566893410,69,1,12.54,3,1,1,5
1515915625566948446,69,1,314.68,3,1,4,8
1515915625566949049,69,1,54.44,3,1,2,6
1515915625566952828,69,1,31.59,3,1,1,5
1515915625566953373,69,2,68.88,3,2,2,7
1515915625566953500,69,2,47.78,3,2,2,7
1515915625566954634,69,2,69.52,3,2,2,7
1515915625566955471,69,2,1095.94,3,2,4,9
1515915625566958242,69,1,263.78,3,1,3,7
1515915625566959668,69,2,52.92,3,2,2,7
1515915625566959883,69,2,90.48,3,2,2,7
1515915625566962865,69,1,150.79,3,1,3,7
1515915625566964558,69,2,42.86,3,2,2,7
1515915625566964691,69,1,26.19,3,1,1,5
1515915625566966811,69,2,308.64,3,2,4,9
1515915625566971688,69,1,257.87,3,1,3,7
1515915625566972262,69,1,10.32,3,1,1,5
1515915625566975846,69,1,13.86,3,1,1,5
1515915625566980771,68,1,34.44,3,1,2,6
1515915625566981517,69,1,77.35,3,1,2,6
1515915625566985809,69,1,34.65,3,1,2,6
1515915625566986560,69,1,77.35,3,1,2,6
1515915625566988757,69,1,16.19,3,1,1,5
1515915625566988957,69,1,40.48,3,1,2,6
1515915625566993400,69,3,770.43,3,3,4,10
1515915625566994343,69,2,100.22,3,2,3,8
1515915625566998692,69,1,13.16,3,1,1,5
1515915625567006696,69,1,88.89,3,1,2,6
1515915625567008938,69,1,454.86,3,1,4,8
1515915625567009027,67,5,26.630000000000003,3,4,1,8
1515915625567009617,69,1,449.51,3,1,4,8
1515915625567009753,69,1,52.54,3,1,2,6
1515915625567010138,69,1,32.22,3,1,1,5
1515915625567016948,69,1,259.38,3,1,3,7
1515915625567021090,69,2,739.46,3,2,4,9
1515915625567023689,69,1,34.44,3,1,2,6
1515915625567027082,69,5,957.1500000000001,3,4,4,11
1515915625567028760,69,1,45.4,3,1,2,6
1515915625567034269,69,2,3751.94,3,2,4,9
1515915625567036530,69,1,29.22,3,1,1,5
1515915625567038587,69,1,136.05,3,1,3,7
1515915625567038649,69,1,482.52,3,1,4,8
1515915625567043027,69,1,86.51,3,1,2,6
1515915625567058890,69,1,26.19,3,1,1,5
1515915625567060100,69,1,17.46,3,1,1,5
1515915625567061897,69,6,117.12,3,4,3,10
1515915625567067124,62,1,93.43,3,1,3,7
1515915625567068386,68,5,69.05,3,4,2,9
1515915625567078093,52,1,577.6,3,1,4,8
1515915625567094265,69,3,346.23,3,3,4,10
1515915625567097251,69,1,32.22,3,1,1,5
1515915625567099739,69,1,32.22,3,1,1,5
1515915625567100567,69,1,30.89,3,1,1,5
1515915625567101036,69,1,52.87,3,1,2,6
1515915625567103130,69,1,188.06,3,1,3,7
1515915625567103642,69,1,397.79,3,1,4,8
1515915625567108290,69,1,58.24,3,1,2,6
1515915625567113009,69,2,212.86,3,2,3,8
1515915625567113913,69,1,107.62,3,1,3,7
1515915625567115534,69,1,23.33,3,1,1,5
1515915625567115821,69,2,167.19,3,2,3,8
1515915625567116024,69,1,77.4,3,1,2,6
1515915625567116632,69,1,311.6,3,1,4,8
1515915625567116855,69,1,407.4,3,1,4,8
1515915625567118774,69,1,397.48,3,1,4,8
1515915625567120248,67,4,811.8,3,3,4,10
1515915625567121843,69,1,167.62,3,1,3,7
1515915625567122454,66,1,51.9,3,1,2,6
1515915625567123150,69,2,103.8,3,2,3,8
1515915625567127753,66,1,11.65,3,1,1,5
1515915625567129806,14,4,205.32,4,3,3,10
1515915625567129870,67,1,55.6,3,1,2,6
1515915625567130106,69,1,112.33,3,1,3,7
1515915625567133902,69,4,222.4,3,3,3,9
1515915625567135320,69,1,28.08,3,1,1,5
1515915625567137198,68,3,159.96,3,3,3,9
1515915625567137970,69,1,26.46,3,1,1,5
1515915625567138057,69,1,490.54,3,1,4,8
1515915625567140868,69,1,418.48,3,1,4,8
1515915625567143674,69,1,19.52,3,1,1,5
1515915625567148675,69,1,430.02,3,1,4,8
1515915625567148878,51,1,365.44,3,1,4,8
1515915625567149852,69,1,13.48,3,1,1,5
1515915625567151002,69,1,12.22,3,1,1,5
1515915625567151541,67,3,142.51,3,3,3,9
1515915625567155594,69,1,63.98,3,1,2,6
1515915625567157327,66,2,328.66,3,2,4,9
1515915625567157630,69,3,896.28,3,3,4,10
1515915625567168246,69,1,420.63,3,1,4,8
1515915625567168351,69,3,414.71999999999997,3,3,4,10
1515915625567168625,69,1,374.38,3,1,4,8
1515915625567168705,69,2,245.94,3,2,3,8
1515915625567172759,48,1,268.17,3,1,3,7
1515915625567173404,69,1,65.4,3,1,2,6
1515915625567175512,68,1,15.08,3,1,1,5
1515915625567201042,69,1,19.05,3,1,1,5
1515915625567201791,69,1,284.46,3,1,3,7
1515915625567202311,69,1,46.78,3,1,2,6
1515915625567203002,69,1,15.87,3,1,1,5
1515915625567210063,69,1,110.86,3,1,3,7
1515915625567212432,69,1,55.6,3,1,2,6
1515915625567214205,68,1,53.9,3,1,2,6
1515915625567214537,69,1,10.48,3,1,1,5
1515915625567220535,69,4,118.08,3,3,3,9
1515915625567220911,69,1,210.9,3,1,3,7
1515915625567221018,33,1,164.33,4,1,3,8
1515915625567221477,69,1,26.19,3,1,1,5
1515915625567221723,68,1,18.73,3,1,1,5
1515915625567223341,68,3,612.87,3,3,4,10
1515915625567225776,69,1,66.76,3,1,2,6
1515915625567226772,69,2,18.7,3,2,1,6
1515915625567227454,69,1,26.19,3,1,1,5
1515915625567230926,69,1,23.57,3,1,1,5
1515915625567231674,69,2,436.98,3,2,4,9
1515915625567238962,69,1,384.46,3,1,4,8
1515915625567243982,68,4,1668.04,3,3,4,10
1515915625567245369,69,2,42.42,3,2,2,7
1515915625567252021,29,1,22.22,4,1,1,6
1515915625567252283,68,2,30.48,3,2,1,6
1515915625567260065,69,1,88.89,3,1,2,6
1515915625567264473,37,1,77.73,3,1,2,6
1515915625567266709,69,1,586.54,3,1,4,8
1515915625567267642,63,2,33.4,3,2,2,7
1515915625567271203,69,3,35.519999999999996,3,3,2,8
1515915625567273616,54,2,67.94,3,2,2,7
1515915625567274438,68,1,126.68,3,1,3,7
1515915625567280886,68,2,26.96,3,2,1,6
1515915625567281324,68,4,141.28,3,3,3,9
1515915625567284297,68,1,87.57,3,1,2,6
1515915625567289197,68,3,70.71000000000001,3,3,2,8
1515915625567294237,68,1,164.33,3,1,3,7
1515915625567307742,68,2,382.86,3,2,4,9
1515915625567312428,68,1,194.95,3,1,3,7
1515915625567317915,66,1,187.78,3,1,3,7
1515915625567318234,63,9,770.22,3,4,4,11
1515915625567319478,68,1,57.33,3,1,2,6
1515915625567319786,68,1,149.32,3,1,3,7
1515915625567319894,68,2,3.14,3,2,1,6
1515915625567328295,66,1,65.08,3,1,2,6
1515915625567341406,54,2,294.76,3,2,4,9
1515915625567351733,68,2,167.94,3,2,3,8
1515915625567354450,68,1,72.38,3,1,2,6
1515915625567356381,68,2,53.96,3,2,2,7
1515915625567357222,68,1,33.54,3,1,2,6
1515915625567358031,68,1,43.11,3,1,2,6
1515915625567359549,68,1,192.86,3,1,3,7
1515915625567364847,68,1,23.48,3,1,1,5
1515915625567365061,68,1,113.38,3,1,3,7
1515915625567370035,68,1,23.81,3,1,1,5
1515915625567374797,68,3,311.49,3,3,4,10
1515915625567381357,68,1,87.4,3,1,2,6
1515915625567381859,46,1,249.38,3,1,3,7
1515915625567382606,68,1,41.41,3,1,2,6
1515915625567391323,68,1,184.13,3,1,3,7
1515915625567408697,68,1,205.49,3,1,3,7
1515915625567414170,68,1,18.57,3,1,1,5
1515915625567426826,68,2,44.16,3,2,2,7
1515915625567427164,68,2,54.1,3,2,2,7
1515915625567443389,67,2,510.06,3,2,4,9
1515915625567449784,68,4,47.239999999999995,3,3,2,8
1515915625567450275,68,1,61.05,3,1,2,6
1515915625567450556,68,1,24.92,3,1,1,5
1515915625567455074,68,1,96.33,3,1,3,7
1515915625567461046,68,1,261.9,3,1,3,7
1515915625567462707,68,1,75.29,3,1,2,6
1515915625567464629,68,1,577.6,3,1,4,8
1515915625567464841,68,1,86.54,3,1,2,6
1515915625567468342,68,1,193.25,3,1,3,7
1515915625567474361,68,1,20.79,3,1,1,5
1515915625567480951,68,1,21.9,3,1,1,5
1515915625567481544,68,3,492.99,3,3,4,10
1515915625567482066,68,1,10.57,3,1,1,5
1515915625567484028,68,1,18.13,3,1,1,5
1515915625567491332,68,2,64.44,3,2,2,7
1515915625567493648,68,1,98.21,3,1,3,7
1515915625567494385,67,2,94.64,3,2,3,8
1515915625567496514,68,1,41.9,3,1,2,6
1515915625567496734,68,2,42.42,3,2,2,7
1515915625567497880,68,1,82.1,3,1,2,6
1515915625567503719,68,2,64.44,3,2,2,7
1515915625567504108,68,1,23.33,3,1,1,5
1515915625567508496,68,1,32.22,3,1,1,5
1515915625567511233,68,1,126.68,3,1,3,7
1515915625567512033,68,1,32.22,3,1,1,5
1515915625567513379,68,1,67.51,3,1,2,6
1515915625567513698,68,1,98.25,3,1,3,7
1515915625567514046,68,1,9.43,3,1,1,5
1515915625567514720,68,1,418.48,3,1,4,8
1515915625567548646,26,1,214.1,4,1,3,8
1515915625567550300,68,2,523.78,3,2,4,9
1515915625567551200,68,1,321.33,3,1,4,8
1515915625567553057,68,1,397.48,3,1,4,8
1515915625567554812,68,2,31.04,3,2,1,6
1515915625567556837,68,1,415.54,3,1,4,8
1515915625567557046,67,2,68.88,3,2,2,7
1515915625567558377,68,2,189.2,3,2,3,8
1515915625567558640,68,1,826.86,3,1,4,8
1515915625567562953,68,1,264.4,3,1,3,7
1515915625567566009,68,1,25.73,3,1,1,5
1515915625567568583,68,1,591.59,3,1,4,8
1515915625567570962,5,1,28.41,4,1,1,6
1515915625567573860,68,1,31.75,3,1,1,5
1515915625567575822,67,2,114.26,3,2,3,8
1515915625567576181,56,2,3.14,3,2,1,6
1515915625567576613,68,1,70.6,3,1,2,6
1515915625567576634,68,1,23.22,3,1,1,5
1515915625567580054,68,2,86.22,3,2,2,7
1515915625567582570,68,1,140.86,3,1,3,7
1515915625567583878,68,1,71.78,3,1,2,6
1515915625567586259,68,1,53.51,3,1,2,6
1515915625567595257,68,1,34.87,3,1,2,6
1515915625567603591,68,2,422.28,3,2,4,9
1515915625567608220,68,1,114.13,3,1,3,7
1515915625567611116,6,5,785.6999999999999,4,4,4,12
1515915625567612167,68,1,194.06,3,1,3,7
1515915625567631967,63,1,63.02,3,1,2,6
1515915625567634387,68,1,229.78,3,1,3,7
1515915625567641380,68,1,36.51,3,1,2,6
1515915625567643192,68,5,47.21,3,4,2,9
1515915625567644244,49,2,1039.12,3,2,4,9
1515915625567645976,68,2,110.32,3,2,3,8
1515915625567646199,62,2,548.8,3,2,4,9
1515915625567646272,67,4,215.24,3,3,3,9
1515915625567646618,68,1,55.6,3,1,2,6
1515915625567647459,68,3,93.33,3,3,3,9
1515915625567647659,68,1,26.83,3,1,1,5
1515915625567656414,20,4,70.48,4,3,2,9
1515915625567659504,68,2,328.66,3,2,4,9
1515915625567663820,68,1,14.86,3,1,1,5
1515915625567667448,35,6,985.98,4,4,4,12
1515915625567669140,31,3,490.56000000000006,4,3,4,11
1515915625567673918,68,1,27.62,3,1,1,5
1515915625567679827,65,2,408.58,3,2,4,9
1515915625567694618,68,1,17.78,3,1,1,5
1515915625567694784,68,1,18.41,3,1,1,5
1515915625567706516,68,2,263.34,3,2,3,8
1515915625567708723,68,2,123.4,3,2,3,8
1515915625567711404,68,1,173.67,3,1,3,7
1515915625567712199,67,1,10.13,3,1,1,5
1515915625567716648,68,2,128.89,3,2,3,8
1515915625567718028,68,2,338.9,3,2,4,9
1515915625567722792,62,1,519.56,3,1,4,8
1515915625567724557,68,2,64.44,3,2,2,7
1515915625567742979,68,1,61.16,3,1,2,6
1515915625567743180,67,2,145.96,3,2,3,8
1515915625567750557,68,4,116.14,3,3,3,9
1515915625567754001,65,1,43.11,3,1,2,6
1515915625567754531,68,1,73.81,3,1,2,6
1515915625567754658,63,18,1796.45,3,4,4,11
1515915625567764204,68,1,4.13,3,1,1,5
1515915625567767213,68,1,30.0,3,1,1,5
1515915625567770781,68,3,89.1,3,3,2,8
1515915625567773428,68,2,899.02,3,2,4,9
1515915625567779205,68,1,13.86,3,1,1,5
1515915625567780404,53,2,1064.41,3,2,4,9
1515915625567783333,66,3,64.28999999999999,3,3,2,8
1515915625567785743,68,1,34.48,3,1,2,6
1515915625567789683,68,1,209.7,3,1,3,7
1515915625567792892,68,1,86.16,3,1,2,6
1515915625567794266,68,1,449.51,3,1,4,8
1515915625567804517,63,6,1165.38,3,4,4,11
1515915625567810213,68,1,55.6,3,1,2,6
1515915625567818542,68,1,457.51,3,1,4,8
1515915625567829144,67,1,399.48,3,1,4,8
1515915625567829866,67,1,106.73,3,1,3,7
1515915625567829929,67,1,202.67,3,1,3,7
1515915625567831791,67,2,853.34,3,2,4,9
1515915625567844025,67,1,415.54,3,1,4,8
1515915625567854397,65,1,23.57,3,1,1,5
1515915625567854418,67,3,165.48,3,3,3,9
1515915625567855181,65,4,234.16,3,3,3,9
1515915625567863917,67,2,88.35,3,2,2,7
1515915625567871373,67,1,68.33,3,1,2,6
1515915625567874885,55,1,432.3,3,1,4,8
1515915625567875103,67,1,432.3,3,1,4,8
1515915625567875216,67,2,64.44,3,2,2,7
1515915625567875290,67,1,34.44,3,1,2,6
1515915625567877729,67,1,284.46,3,1,3,7
1515915625567878770,67,2,58.44,3,2,2,7
1515915625567880753,67,1,100.79,3,1,3,7
1515915625567885912,67,1,204.29,3,1,3,7
1515915625567886663,67,2,47.94,3,2,2,7
1515915625567886883,67,1,30.7,3,1,1,5
1515915625567887990,67,1,1.57,3,1,1,5
1515915625567888898,67,1,20.16,3,1,1,5
1515915625567893150,67,1,26.57,3,1,1,5
1515915625567894794,67,3,96.66,3,3,3,9
1515915625567900412,67,1,21.21,3,1,1,5
1515915625567901804,67,1,38.37,3,1,2,6
1515915625567909257,67,4,172.68,3,3,3,9
1515915625567915146,67,1,32.81,3,1,2,6
1515915625567924411,67,1,297.94,3,1,4,8
1515915625567926652,67,1,22.41,3,1,1,5
1515915625567937568,67,2,86.8,3,2,2,7
1515915625567940228,67,1,72.98,3,1,2,6
1515915625567943083,67,1,20.95,3,1,1,5
1515915625567943555,66,1,39.75,3,1,2,6
1515915625567955292,35,1,205.25,4,1,3,8
1515915625567955341,67,1,42.22,3,1,2,6
1515915625567959455,67,4,372.08,3,3,4,10
1515915625567959763,67,1,32.22,3,1,1,5
1515915625567960259,20,5,2479.7000000000003,4,4,4,12
1515915625567960805,67,1,32.22,3,1,1,5
1515915625567969311,67,1,31.59,3,1,1,5
1515915625567971633,47,2,155.46,3,2,3,8
1515915625567972093,67,1,26.35,3,1,1,5
1515915625567973146,67,1,1.57,3,1,1,5
1515915625567973533,67,1,12.51,3,1,1,5
1515915625567975242,61,1,58.24,3,1,2,6
1515915625567975518,67,1,251.4,3,1,3,7
1515915625567975527,67,5,160.79999999999998,3,4,3,10
1515915625567976463,67,1,251.4,3,1,3,7
1515915625567977425,67,1,43.02,3,1,2,6
1515915625567978241,67,1,397.48,3,1,4,8
1515915625567979657,67,2,93.9,3,2,3,8
1515915625567980757,67,1,123.35,3,1,3,7
1515915625567980879,67,1,397.48,3,1,4,8
1515915625567982763,67,2,46.66,3,2,2,7
1515915625567986931,67,1,148.37,3,1,3,7
1515915625567992056,67,1,34.24,3,1,2,6
1515915625567992512,64,1,204.79,3,1,3,7
1515915625567994294,67,2,917.02,3,2,4,9
1515915625567994400,67,1,33.97,3,1,2,6
1515915625568021779,67,2,102.66,3,2,3,8
1515915625568022710,67,2,81.26,3,2,2,7
1515915625568023516,67,1,73.81,3,1,2,6
1515915625568024053,67,2,965.04,3,2,4,9
1515915625568027406,67,2,83.6,3,2,2,7
1515915625568030489,67,1,226.84,3,1,3,7
1515915625568031182,67,3,65.78,3,3,2,8
1515915625568031859,67,1,482.52,3,1,4,8
1515915625568038032,66,4,810.68,3,3,4,10
1515915625568040240,67,2,201.5,3,2,3,8
1515915625568046626,67,1,18.73,3,1,1,5
1515915625568046695,67,1,478.52,3,1,4,8
1515915625568047685,35,4,1309.72,4,3,4,11
1515915625568049473,67,1,13.02,3,1,1,5
1515915625568050940,67,3,1456.9299999999998,3,3,4,10
1515915625568053806,67,1,47.14,3,1,2,6
1515915625568054312,67,1,155.1,3,1,3,7
1515915625568055715,17,5,328.54999999999995,4,4,4,12
1515915625568055862,66,1,21.43,3,1,1,5
1515915625568056824,67,3,243.81,3,3,3,9
1515915625568057052,67,1,479.51,3,1,4,8
1515915625568059388,49,2,69.46,3,2,2,7
1515915625568063330,67,1,21.43,3,1,1,5
1515915625568068857,67,2,112.54,3,2,3,8
1515915625568070390,67,2,523.31,3,2,4,9
1515915625568070434,67,2,409.46,3,2,4,9
1515915625568079006,67,2,30.2,3,2,1,6
1515915625568084736,67,3,109.47,3,3,3,9
1515915625568106764,67,1,21.11,3,1,1,5
1515915625568108451,67,1,250.38,3,1,3,7
1515915625568108515,67,1,52.9,3,1,2,6
1515915625568109139,67,1,251.4,3,1,3,7
1515915625568112724,11,1,32.22,4,1,1,6
1515915625568112902,67,1,133.83,3,1,3,7
1515915625568119076,67,2,103.26,3,2,3,8
1515915625568121470,67,1,9.24,3,1,1,5
1515915625568125126,67,1,337.44,3,1,4,8
1515915625568126120,67,1,600.6,3,1,4,8
1515915625568143617,18,2,981.08,4,2,4,10
1515915625568143852,67,1,96.67,3,1,3,7
1515915625568144050,67,2,235.52,3,2,3,8
1515915625568148612,66,1,16.19,3,1,1,5
1515915625568150486,67,1,32.38,3,1,2,6
1515915625568151811,67,1,17.46,3,1,1,5
1515915625568151979,67,3,1048.3799999999999,3,3,4,10
1515915625568154984,67,1,13.02,3,1,1,5
1515915625568156550,67,1,32.38,3,1,2,6
1515915625568157377,66,3,97.14000000000001,3,3,3,9
1515915625568167614,53,2,585.66,3,2,4,9
1515915625568177551,66,3,1158.4,3,3,4,10
1515915625568180875,67,1,298.32,3,1,4,8
1515915625568182402,67,1,28.25,3,1,1,5
1515915625568182779,67,1,420.63,3,1,4,8
1515915625568184142,67,1,21.9,3,1,1,5
1515915625568184153,66,1,176.17,3,1,3,7
1515915625568189109,67,2,33.019999999999996,3,2,2,7
1515915625568213861,67,1,486.81,3,1,4,8
1515915625568216363,67,1,172.97,3,1,3,7
1515915625568216863,67,1,251.92,3,1,3,7
1515915625568221932,66,1,50.63,3,1,2,6
1515915625568224223,53,1,19.87,3,1,1,5
1515915625568230474,67,1,13.65,3,1,1,5
1515915625568232556,67,1,211.59,3,1,3,7
1515915625568232709,67,1,37.62,3,1,2,6
1515915625568250669,67,1,298.76,3,1,4,8
1515915625568253796,67,2,503.84,3,2,4,9
1515915625568263494,67,1,14.02,3,1,1,5
1515915625568270627,67,1,444.51,3,1,4,8
1515915625568271366,42,1,397.48,3,1,4,8
1515915625568273951,1,1,672.63,4,1,4,9
1515915625568276756,56,2,135.56,3,2,3,8
1515915625568286045,33,1,187.29,4,1,3,8
1515915625568286107,60,3,41.01,3,3,2,8
1515915625568293704,66,1,70.16,3,1,2,6
1515915625568303050,66,1,16.83,3,1,1,5
1515915625568313418,66,1,629.95,3,1,4,8
1515915625568318160,9,3,81.75,4,3,2,9
1515915625568322406,66,1,24.52,3,1,1,5
1515915625568323418,66,1,27.62,3,1,1,5
1515915625568325126,65,2,63.5,3,2,2,7
1515915625568336301,66,1,32.22,3,1,1,5
1515915625568338065,66,2,328.66,3,2,4,9
1515915625568338110,66,3,46.56,3,3,2,8
1515915625568343781,66,1,14.17,3,1,1,5
1515915625568346886,66,1,11.65,3,1,1,5
1515915625568353428,46,2,19.66,3,2,1,6
1515915625568354381,63,1,62.17,3,1,2,6
1515915625568362946,66,1,10.84,3,1,1,5
1515915625568363365,66,2,32.38,3,2,2,7
1515915625568364081,13,4,116.74000000000001,4,3,3,10
1515915625568365527,66,1,523.56,3,1,4,8
1515915625568366669,66,2,42.55,3,2,2,7
1515915625568370220,19,3,254.67000000000002,4,3,3,10
1515915625568395382,66,1,26.95,3,1,1,5
1515915625568400681,66,1,107.16,3,1,3,7
1515915625568401177,66,1,38.83,3,1,2,6
1515915625568407258,64,1,19.37,3,1,1,5
1515915625568408528,63,1,50.11,3,1,2,6
1515915625568409377,63,2,214.82,3,2,3,8
1515915625568410695,66,2,64.44,3,2,2,7
1515915625568415078,66,1,397.48,3,1,4,8
1515915625568492996,66,1,32.22,3,1,1,5
1515915625568522577,66,1,284.46,3,1,3,7
1515915625568524346,66,3,1246.6200000000001,3,3,4,10
1515915625568526912,66,1,80.67,3,1,2,6
1515915625568530235,66,1,126.68,3,1,3,7
1515915625568533759,66,1,10.29,3,1,1,5
1515915625568540115,66,7,559.09,3,4,4,11
1515915625568544834,66,1,15.71,3,1,1,5
1515915625568545019,64,4,215.8,3,3,3,9
1515915625568565893,35,1,33.19,4,1,2,7
1515915625568567929,66,2,264.44,3,2,3,8
1515915625568571478,66,1,27.62,3,1,1,5
1515915625568574560,66,1,342.13,3,1,4,8
1515915625568578507,66,1,15.87,3,1,1,5
1515915625568580599,66,1,202.67,3,1,3,7
1515915625568582116,66,3,311.49,3,3,4,10
1515915625568587602,66,1,292.83,3,1,4,8
1515915625568588068,66,1,32.22,3,1,1,5
1515915625568589339,66,1,53.17,3,1,2,6
1515915625568590174,19,3,340.14,4,3,4,11
1515915625568598222,66,2,245.32,3,2,3,8
1515915625568600332,66,1,87.16,3,1,2,6
1515915625568605313,66,1,87.46,3,1,2,6
1515915625568605782,66,1,26.17,3,1,1,5
1515915625568607120,66,1,10.32,3,1,1,5
1515915625568608558,66,3,37.8,3,3,2,8
1515915625568612450,66,1,29.52,3,1,1,5
1515915625568612771,61,3,1192.44,3,3,4,10
1515915625568615524,66,1,381.46,3,1,4,8
1515915625568617413,66,1,292.83,3,1,4,8
1515915625568623087,66,1,292.83,3,1,4,8
1515915625568624396,66,1,21.56,3,1,1,5
1515915625568628440,66,1,27.16,3,1,1,5
1515915625568632033,66,1,486.81,3,1,4,8
1515915625568642626,66,3,246.29999999999998,3,3,3,9
1515915625568646041,66,2,64.44,3,2,2,7
1515915625568650760,61,3,773.61,3,3,4,10
1515915625568651151,56,2,31.74,3,2,1,6
1515915625568654147,66,1,33.08,3,1,2,6
1515915625568655965,66,1,11.75,3,1,1,5
1515915625568658425,40,3,309.64,3,3,4,10
1515915625568659807,66,1,26.98,3,1,1,5
1515915625568660261,66,1,84.89,3,1,2,6
1515915625568664251,61,1,13.89,3,1,1,5
1515915625568674793,66,2,42.54,3,2,2,7
1515915625568679872,66,1,46.03,3,1,2,6
1515915625568680667,66,1,43.48,3,1,2,6
1515915625568680831,66,1,9.35,3,1,1,5
1515915625568682064,63,1,33.08,3,1,2,6
1515915625568682476,55,1,40.67,3,1,2,6
1515915625568687580,55,2,217.46,3,2,3,8
1515915625568692821,66,1,15.87,3,1,1,5
1515915625568696225,66,2,460.7,3,2,4,9
1515915625568702215,66,1,26.11,3,1,1,5
1515915625568704706,66,1,20.22,3,1,1,5
1515915625568711798,66,1,102.7,3,1,3,7
1515915625568714339,66,2,24.44,3,2,1,6
1515915625568714619,66,1,16.98,3,1,1,5
1515915625568719882,66,1,52.05,3,1,2,6
1515915625568725737,56,2,568.6,3,2,4,9
1515915625568749725,66,1,21.43,3,1,1,5
1515915625568756288,66,2,933.04,3,2,4,9
1515915625568762818,66,1,284.46,3,1,3,7
1515915625568765015,51,3,449.90999999999997,3,3,4,10
1515915625568765909,66,1,15.4,3,1,1,5
1515915625568766261,66,1,26.19,3,1,1,5
1515915625568771098,24,1,122.86,4,1,3,8
1515915625568776841,66,1,58.49,3,1,2,6
1515915625568778405,66,1,10.0,3,1,1,5
1515915625568778952,66,1,20.95,3,1,1,5
1515915625568781215,66,1,26.19,3,1,1,5
1515915625568799573,66,1,29.22,3,1,1,5
1515915625568800146,66,3,87.66,3,3,2,8
1515915625568801898,66,1,180.79,3,1,3,7
1515915625568813887,66,1,32.38,3,1,2,6
1515915625568824738,64,1,77.73,3,1,2,6
1515915625568831949,65,6,168.60000000000002,3,4,3,10
1515915625568832294,65,1,34.44,3,1,2,6
1515915625568835878,65,1,77.73,3,1,2,6
1515915625568840220,65,1,21.43,3,1,1,5
1515915625568845360,61,4,818.42,3,3,4,10
1515915625568851751,65,1,229.38,3,1,3,7
1515915625568854166,63,1,104.86,3,1,3,7
1515915625568860967,44,1,32.22,3,1,1,5
1515915625568862976,65,1,25.4,3,1,1,5
1515915625568871732,65,1,34.44,3,1,2,6
1515915625568871749,65,1,166.02,3,1,3,7
1515915625568873468,65,1,23.57,3,1,1,5
1515915625568876796,65,1,22.48,3,1,1,5
1515915625568890514,65,3,603.99,3,3,4,10
1515915625568894713,65,2,64.44,3,2,2,7
1515915625568895074,65,3,99.24,3,3,3,9
1515915625568898555,65,2,145.58,3,2,3,8
1515915625568905408,65,1,31.13,3,1,1,5
1515915625568907577,20,2,933.05,4,2,4,10
1515915625568908377,65,1,51.33,3,1,2,6
1515915625568936253,65,1,13.29,3,1,1,5
1515915625568948683,65,1,31.75,3,1,1,5
1515915625568957659,65,8,681.92,3,4,4,11
1515915625568959889,65,1,20.95,3,1,1,5
1515915625568960220,65,1,81.84,3,1,2,6
1515915625568968271,65,1,126.68,3,1,3,7
1515915625568974600,65,1,31.86,3,1,1,5
1515915625568975189,37,3,1035.17,3,3,4,10
1515915625568977555,65,1,27.14,3,1,1,5
1515915625568977776,65,2,85.72,3,2,2,7
1515915625568977987,65,1,345.44,3,1,4,8
1515915625568979327,65,1,201.33,3,1,3,7
1515915625568984093,65,1,72.98,3,1,2,6
1515915625568985466,65,1,23.48,3,1,1,5
1515915625569003147,65,2,112.82,3,2,3,8
1515915625569024247,65,1,43.11,3,1,2,6
1515915625569028180,60,1,40.48,3,1,2,6
1515915625569030528,65,1,28.25,3,1,1,5
1515915625569033296,65,2,408.58,3,2,4,9
1515915625569034298,65,1,486.81,3,1,4,8
1515915625569036530,65,1,13.49,3,1,1,5
1515915625569037458,65,1,37.3,3,1,2,6
1515915625569046560,65,1,14.29,3,1,1,5
1515915625569046776,65,1,490.54,3,1,4,8
1515915625569047454,65,2,66.16,3,2,2,7
1515915625569048104,52,2,298.64,3,2,4,9
1515915625569054655,65,2,329.84,3,2,4,9
1515915625569057388,65,1,640.49,3,1,4,8
1515915625569058893,53,1,11.6,3,1,1,5
1515915625569061295,65,1,52.49,3,1,2,6
1515915625569063947,65,2,53.96,3,2,2,7
1515915625569064711,65,1,16.98,3,1,1,5
1515915625569067023,65,7,1045.24,3,4,4,11
1515915625569070049,65,1,11.9,3,1,1,5
1515915625569070727,65,1,28.1,3,1,1,5
1515915625569075550,54,2,114.28,3,2,3,8
1515915625569076681,65,2,253.36,3,2,3,8
1515915625569077724,65,1,624.62,3,1,4,8
1515915625569097676,12,1,99.92,4,1,3,8
1515915625569117196,65,1,202.67,3,1,3,7
1515915625569119692,65,1,202.67,3,1,3,7
1515915625569122380,65,1,53.17,3,1,2,6
1515915625569124561,65,1,1.57,3,1,1,5
1515915625569133946,64,1,35.87,3,1,2,6
1515915625569139873,65,1,15.21,3,1,1,5
1515915625569147641,57,1,16.98,3,1,1,5
1515915625569150101,63,2,44.44,3,2,2,7
1515915625569150136,65,4,71.56,3,3,2,8
1515915625569154665,65,1,57.62,3,1,2,6
1515915625569155987,65,1,109.84,3,1,3,7
1515915625569159243,65,1,30.21,3,1,1,5
1515915625569160552,65,1,72.19,3,1,2,6
1515915625569162540,64,1,32.22,3,1,1,5
1515915625569170406,65,1,72.98,3,1,2,6
1515915625569175524,65,2,98.76,3,2,3,8
1515915625569178542,19,1,47.86,4,1,2,7
1515915625569179484,65,1,28.68,3,1,1,5
1515915625569179855,57,1,74.21,3,1,2,6
1515915625569180977,65,1,9.81,3,1,1,5
1515915625569184079,65,1,10.0,3,1,1,5
1515915625569188887,65,1,17.38,3,1,1,5
1515915625569189185,65,1,12.94,3,1,1,5
1515915625569196066,65,2,35.46,3,2,2,7
1515915625569208381,65,2,117.16,3,2,3,8
1515915625569218957,65,1,292.83,3,1,4,8
1515915625569231678,64,2,137.46,3,2,3,8
1515915625569231912,65,2,133.96,3,2,3,8
1515915625569233151,63,1,19.37,3,1,1,5
1515915625569233423,65,5,835.85,3,4,4,11
1515915625569236420,65,2,794.96,3,2,4,9
1515915625569241912,65,1,32.22,3,1,1,5
1515915625569245075,63,6,1262.43,3,4,4,11
1515915625569248940,65,1,32.22,3,1,1,5
1515915625569251044,62,1,298.76,3,1,4,8
1515915625569255182,65,1,257.87,3,1,3,7
1515915625569259537,65,3,1261.8899999999999,3,3,4,10
1515915625569260063,65,1,15.44,3,1,1,5
1515915625569261966,65,1,29.68,3,1,1,5
1515915625569266794,65,1,16.98,3,1,1,5
1515915625569266930,65,1,13.81,3,1,1,5
1515915625569269128,65,1,34.44,3,1,2,6
1515915625569271269,65,2,763.94,3,2,4,9
1515915625569273273,65,3,1192.44,3,3,4,10
1515915625569274044,65,1,20.83,3,1,1,5
1515915625569274542,48,2,32.66,3,2,2,7
1515915625569275192,27,2,375.56,4,2,4,10
1515915625569276776,65,1,77.11,3,1,2,6
1515915625569277675,65,2,103.46,3,2,3,8
1515915625569281804,65,1,51.73,3,1,2,6
1515915625569282037,20,3,1243.47,4,3,4,11
1515915625569283975,65,2,110.32,3,2,3,8
1515915625569284849,65,1,23.57,3,1,1,5
1515915625569285497,65,1,23.57,3,1,1,5
1515915625569286861,65,1,349.46,3,1,4,8
1515915625569287184,65,1,44.65,3,1,2,6
1515915625569289059,65,4,1113.18,3,3,4,10
1515915625569290886,64,5,357.64,3,4,4,11
1515915625569292520,64,1,259.38,3,1,3,7
1515915625569303660,64,1,10.86,3,1,1,5
1515915625569305476,64,1,27.62,3,1,1,5
1515915625569305843,64,1,259.38,3,1,3,7
1515915625569305959,64,3,98.58,3,3,3,9
1515915625569312716,47,1,203.02,3,1,3,7
1515915625569318880,64,2,70.16,3,2,2,7
1515915625569321079,17,1,26.98,4,1,1,6
1515915625569323540,64,2,18.7,3,2,1,6
1515915625569326007,64,1,18.41,3,1,1,5
1515915625569341326,64,1,287.94,3,1,4,8
1515915625569344200,64,1,252.4,3,1,3,7
1515915625569350241,64,1,25.08,3,1,1,5
1515915625569356496,29,1,83.06,4,1,2,7
1515915625569359113,64,1,56.38,3,1,2,6
1515915625569360034,64,2,24.44,3,2,1,6
1515915625569364251,64,2,26.66,3,2,1,6
1515915625569364913,64,1,20.0,3,1,1,5
1515915625569366579,64,2,32.38,3,2,2,7
1515915625569370155,64,1,33.33,3,1,2,6
1515915625569370664,64,2,147.62,3,2,3,8
1515915625569374775,64,2,59.04,3,2,2,7
1515915625569375494,64,1,121.87,3,1,3,7
1515915625569377221,64,1,230.75,3,1,3,7
1515915625569377547,51,1,55.4,3,1,2,6
1515915625569401366,64,1,656.63,3,1,4,8
1515915625569404471,64,1,164.92,3,1,3,7
1515915625569406805,64,1,14.43,3,1,1,5
1515915625569409236,64,1,77.73,3,1,2,6
1515915625569410407,64,1,214.1,3,1,3,7
1515915625569414523,64,2,68.88,3,2,2,7
1515915625569415727,64,2,3.14,3,2,1,6
1515915625569415806,64,2,26.09,3,2,1,6
1515915625569415878,63,3,1921.47,3,3,4,10
1515915625569421172,64,1,18.89,3,1,1,5
1515915625569421964,64,4,69.0,3,3,2,8
1515915625569422049,64,1,10.83,3,1,1,5
1515915625569423635,64,1,33.65,3,1,2,6
1515915625569424364,64,5,384.6,3,4,4,11
1515915625569425280,64,1,167.62,3,1,3,7
1515915625569425342,64,1,15.68,3,1,1,5
1515915625569428304,55,2,29.22,3,2,1,6
1515915625569430572,63,1,397.48,3,1,4,8
1515915625569442000,64,2,111.3,3,2,3,8
1515915625569444951,63,2,585.66,3,2,4,9
1515915625569449013,64,2,39.36,3,2,2,7
1515915625569452336,64,2,328.66,3,2,4,9
1515915625569455016,64,1,117.75,3,1,3,7
1515915625569463801,38,5,3058.03,3,4,4,11
1515915625569494034,64,1,204.79,3,1,3,7
1515915625569497803,64,5,1987.4,3,4,4,11
1515915625569498871,64,1,274.4,3,1,3,7
1515915625569499007,64,1,204.79,3,1,3,7
1515915625569499473,62,1,73.81,3,1,2,6
1515915625569500313,64,1,42.57,3,1,2,6
1515915625569502885,64,2,899.02,3,2,4,9
1515915625569504813,64,1,166.02,3,1,3,7
1515915625569505952,64,2,50.8,3,2,2,7
1515915625569506250,64,1,218.98,3,1,3,7
1515915625569507736,64,1,11.98,3,1,1,5
1515915625569510929,52,2,1027.1100000000001,3,2,4,9
1515915625569511755,64,1,399.48,3,1,4,8
1515915625569515442,64,1,29.52,3,1,1,5
1515915625569519542,64,1,11.98,3,1,1,5
1515915625569521042,64,1,18.56,3,1,1,5
1515915625569521856,64,1,29.22,3,1,1,5
1515915625569523686,64,1,15.6,3,1,1,5
1515915625569523997,64,1,13.0,3,1,1,5
1515915625569525711,64,3,78.57000000000001,3,3,2,8
1515915625569530410,64,2,64.44,3,2,2,7
1515915625569530717,64,2,624.86,3,2,4,9
1515915625569532566,64,2,122.54,3,2,3,8
1515915625569535751,63,3,193.44,3,3,3,9
1515915625569541768,58,1,414.13,3,1,4,8
1515915625569542840,64,3,103.68,3,3,3,9
1515915625569549709,64,1,58.32,3,1,2,6
1515915625569550061,64,2,38.25,3,2,2,7
1515915625569584842,64,1,449.51,3,1,4,8
1515915625569593765,64,1,466.52,3,1,4,8
1515915625569595219,64,1,19.84,3,1,1,5
1515915625569596343,63,1,204.29,3,1,3,7
1515915625569597394,64,3,114.18,3,3,3,9
1515915625569606369,64,1,9.92,3,1,1,5
1515915625569606407,11,1,25.24,4,1,1,6
1515915625569607008,64,1,20.71,3,1,1,5
1515915625569621166,64,2,39.04,3,2,2,7
1515915625569627185,64,1,33.97,3,1,2,6
1515915625569627498,64,1,111.92,3,1,3,7
1515915625569630103,64,3,476.95,3,3,4,10
1515915625569630701,61,1,71.75,3,1,2,6
1515915625569631518,64,2,90.2,3,2,2,7
1515915625569631706,63,4,1589.92,3,3,4,10
1515915625569636447,64,1,157.14,3,1,3,7
1515915625569636577,64,1,633.3,3,1,4,8
1515915625569646991,63,1,15.68,3,1,1,5
1515915625569649459,64,1,55.16,3,1,2,6
1515915625569649516,64,1,10.21,3,1,1,5
1515915625569649672,64,2,169.78,3,2,3,8
1515915625569651205,58,2,728.92,3,2,4,9
1515915625569651329,63,1,7.86,3,1,1,5
1515915625569651919,64,1,21.83,3,1,1,5
1515915625569656355,64,1,453.86,3,1,4,8
1515915625569656763,64,1,369.73,3,1,4,8
1515915625569657245,61,6,491.01000000000005,3,4,4,11
1515915625569657504,64,2,86.34,3,2,2,7
1515915625569658231,64,1,519.56,3,1,4,8
1515915625569659588,57,5,1275.46,3,4,4,11
1515915625569669495,63,7,583.78,3,4,4,11
1515915625569699280,61,2,46.96,3,2,2,7
1515915625569699672,63,2,46.96,3,2,2,7
1515915625569699842,64,2,169.78,3,2,3,8
1515915625569699909,64,1,304.41,3,1,4,8
1515915625569705914,64,1,9.84,3,1,1,5
1515915625569707033,64,1,470.51,3,1,4,8
1515915625569707884,64,1,259.94,3,1,3,7
1515915625569713045,63,4,747.04,3,3,4,10
1515915625569720421,49,3,80.94,3,3,2,8
1515915625569724402,52,1,56.48,3,1,2,6
1515915625569726915,64,1,17.22,3,1,1,5
1515915625569727027,64,1,32.22,3,1,1,5
1515915625569731409,64,2,155.46,3,2,3,8
1515915625569733979,62,2,899.02,3,2,4,9
1515915625569734166,64,6,1633.8999999999999,3,4,4,11
1515915625569737214,59,2,421.8,3,2,4,9
1515915625569737313,64,1,215.4,3,1,3,7
1515915625569739034,64,1,13.02,3,1,1,5
1515915625569739996,64,4,126.36,3,3,3,9
1515915625569740200,64,1,68.56,3,1,2,6
1515915625569740809,64,1,73.81,3,1,2,6
1515915625569744770,64,1,449.51,3,1,4,8
1515915625569744848,64,1,218.1,3,1,3,7
1515915625569746024,64,1,399.48,3,1,4,8
1515915625569751381,64,1,82.97,3,1,2,6
1515915625569751989,63,1,77.73,3,1,2,6
1515915625569752220,9,1,752.22,4,1,4,9
1515915625569754125,64,1,177.95,3,1,3,7
1515915625569756205,64,2,112.54,3,2,3,8
1515915625569757221,62,5,592.8499999999999,3,4,4,11
1515915625569762713,64,1,29.22,3,1,1,5
1515915625569763315,64,1,34.08,3,1,2,6
1515915625569767639,64,2,165.94,3,2,3,8
1515915625569768156,64,1,82.97,3,1,2,6
1515915625569769909,63,2,206.57,3,2,3,8
1515915625569771379,63,4,385.48,3,3,4,10
1515915625569777103,64,1,47.14,3,1,2,6
1515915625569777569,63,2,472.74,3,2,4,9
1515915625569778121,63,1,203.29,3,1,3,7
1515915625569785073,63,1,32.22,3,1,1,5
1515915625569789342,63,1,51.75,3,1,2,6
1515915625569793013,63,1,32.22,3,1,1,5
1515915625569793890,63,1,104.86,3,1,3,7
1515915625569801463,63,1,88.25,3,1,2,6
1515915625569804674,63,2,72.28,3,2,2,7
1515915625569805632,63,1,256.22,3,1,3,7
1515915625569806330,62,1,61.16,3,1,2,6
1515915625569806692,63,1,14.08,3,1,1,5
1515915625569808096,63,1,205.25,3,1,3,7
1515915625569809172,63,1,15.43,3,1,1,5
1515915625569813271,48,2,933.04,3,2,4,9
1515915625569822349,63,1,29.21,3,1,1,5
1515915625569825097,63,1,49.1,3,1,2,6
1515915625569826879,63,2,217.46,3,2,3,8
1515915625569829523,63,1,36.14,3,1,2,6
1515915625569831526,63,1,79.87,3,1,2,6
1515915625569834999,63,2,172.32,3,2,3,8
1515915625569837166,19,1,12.71,4,1,1,6
1515915625569837848,63,2,523.78,3,2,4,9
1515915625569840490,63,1,32.22,3,1,1,5
1515915625569840621,63,4,1017.52,3,3,4,10
1515915625569841239,63,1,349.46,3,1,4,8
1515915625569841611,63,1,77.73,3,1,2,6
1515915625569843604,63,2,111.74,3,2,3,8
1515915625569844217,62,2,473.34,3,2,4,9
1515915625569844448,63,1,292.83,3,1,4,8
1515915625569844831,63,1,254.38,3,1,3,7
1515915625569845848,63,1,23.81,3,1,1,5
1515915625569846629,63,1,18.25,3,1,1,5
1515915625569851404,63,1,21.11,3,1,1,5
1515915625569852123,63,2,105.8,3,2,3,8
1515915625569852271,63,2,19.62,3,2,1,6
1515915625569852953,63,1,55.56,3,1,2,6
1515915625569855725,63,5,1021.4499999999999,3,4,4,11
1515915625569856147,63,1,21.48,3,1,1,5
1515915625569858117,63,1,97.35,3,1,3,7
1515915625569859747,48,1,73.81,3,1,2,6
1515915625569862055,63,1,16.35,3,1,1,5
1515915625569863087,63,1,44.6,3,1,2,6
1515915625569864391,63,1,43.11,3,1,2,6
1515915625569875626,63,1,13.79,3,1,1,5
1515915625569875950,63,1,11.11,3,1,1,5
1515915625569876885,63,1,24.6,3,1,1,5
1515915625569877447,63,1,11.65,3,1,1,5
1515915625569877725,63,1,121.87,3,1,3,7
1515915625569881641,63,1,259.38,3,1,3,7
1515915625569883604,46,2,37.14,3,2,2,7
1515915625569885436,63,1,163.52,3,1,3,7
1515915625569889643,39,1,33.35,3,1,2,6
1515915625569889987,63,1,138.4,3,1,3,7
1515915625569890033,63,2,49.2,3,2,2,7
1515915625569891551,63,1,17.62,3,1,1,5
1515915625569893149,63,1,370.46,3,1,4,8
1515915625569895145,63,1,37.3,3,1,2,6
1515915625569896291,63,1,482.52,3,1,4,8
1515915625569897319,63,1,14.29,3,1,1,5
1515915625569898497,63,1,415.54,3,1,4,8
1515915625569899235,63,1,72.98,3,1,2,6
1515915625569901603,63,1,82.52,3,1,2,6
1515915625569905618,63,1,33.08,3,1,2,6
1515915625569905759,63,1,15.87,3,1,1,5
1515915625569906493,63,1,202.67,3,1,3,7
1515915625569907031,39,3,592.2,3,3,4,10
1515915625569910578,63,1,374.44,3,1,4,8
1515915625569910976,63,1,29.22,3,1,1,5
1515915625569911030,63,2,56.2,3,2,2,7
1515915625569912529,63,1,27.62,3,1,1,5
1515915625569912673,63,1,54.32,3,1,2,6
1515915625569916164,63,1,9.35,3,1,1,5
1515915625569916483,63,1,31.75,3,1,1,5
1515915625569919680,63,1,12.62,3,1,1,5
1515915625569924268,63,1,52.71,3,1,2,6
1515915625569924923,63,1,13.02,3,1,1,5
1515915625569925499,63,1,10.08,3,1,1,5
1515915625569925762,63,1,39.37,3,1,2,6
1515915625569925834,63,2,65.34,3,2,2,7
1515915625569926920,63,1,64.48,3,1,2,6
1515915625569928384,63,1,11.13,3,1,1,5
1515915625569930509,63,1,18.57,3,1,1,5
1515915625569931104,55,1,236.08,3,1,3,7
1515915625569958697,61,1,236.08,3,1,3,7
1515915625569958860,63,1,10.95,3,1,1,5
1515915625569959069,45,1,15.1,3,1,1,5
1515915625569959829,63,1,23.57,3,1,1,5
1515915625569960137,63,1,486.81,3,1,4,8
1515915625569962138,63,1,52.54,3,1,2,6
1515915625569963826,63,2,87.94,3,2,2,7
1515915625569969543,63,1,572.57,3,1,4,8
1515915625569970617,63,2,293.52000000000004,3,2,4,9
1515915625569972572,63,1,26.19,3,1,1,5
1515915625569973734,49,1,204.29,3,1,3,7
1515915625569974926,63,1,201.33,3,1,3,7
1515915625569975007,61,1,427.75,3,1,4,8
1515915625569977013,63,2,72.28,3,2,2,7
1515915625569978575,63,1,34.06,3,1,2,6
1515915625569980656,63,1,190.46,3,1,3,7
1515915625569983286,63,1,31.11,3,1,1,5
1515915625569984304,3,1,101.05,4,1,3,8
1515915625569989132,63,1,29.37,3,1,1,5
1515915625569992072,63,2,86.66,3,2,2,7
1515915625569995777,63,2,1190.2,3,2,4,9
1515915625570000542,12,3,481.56000000000006,4,3,4,11
1515915625570005038,62,2,568.6,3,2,4,9
1515915625570008274,63,1,26.17,3,1,1,5
1515915625570014272,63,1,56.51,3,1,2,6
1515915625570014570,63,2,232.7,3,2,3,8
1515915625570015283,62,6,2697.06,3,4,4,11
1515915625570023880,63,1,120.27,3,1,3,7
1515915625570041996,63,1,190.27,3,1,3,7
1515915625570044479,63,8,540.89,3,4,4,11
1515915625570047901,63,4,200.44,3,3,3,9
1515915625570049094,63,1,9.35,3,1,1,5
1515915625570049540,40,4,105.84,3,3,3,9
1515915625570050496,63,2,169.26,3,2,3,8
1515915625570051650,63,1,59.32,3,1,2,6
1515915625570053428,63,1,126.68,3,1,3,7
1515915625570056640,63,1,577.6,3,1,4,8
1515915625570057246,63,1,17.63,3,1,1,5
1515915625570058232,63,1,466.52,3,1,4,8
1515915625570061594,63,2,194.7,3,2,3,8
1515915625570063017,63,3,158.60999999999999,3,3,3,9
1515915625570071928,39,1,282.65,3,1,3,7
1515915625570076765,63,1,418.02,3,1,4,8
1515915625570080146,63,3,480.48,3,3,4,10
1515915625570081302,62,2,26.04,3,2,1,6
1515915625570086505,63,1,44.37,3,1,2,6
1515915625570089469,63,1,144.51,3,1,3,7
1515915625570091591,63,1,102.1,3,1,3,7
1515915625570094535,63,1,210.19,3,1,3,7
1515915625570097762,47,1,51.97,3,1,2,6
1515915625570098510,63,1,180.63,3,1,3,7
1515915625570108077,63,2,165.94,3,2,3,8
1515915625570108479,63,1,73.81,3,1,2,6
1515915625570111400,62,6,760.08,3,4,4,11
1515915625570118983,4,2,77.66,4,2,2,8
1515915625570142367,63,2,157.68,3,2,3,8
1515915625570144752,63,3,221.04000000000002,3,3,3,9
1515915625570146273,50,2,150.88,3,2,3,8
1515915625570148335,63,2,199.84,3,2,3,8
1515915625570153149,63,2,55.88,3,2,2,7
1515915625570154867,63,1,72.98,3,1,2,6
1515915625570155097,57,2,27.14,3,2,1,6
1515915625570157935,63,1,23.57,3,1,1,5
1515915625570158239,58,3,425.51,3,3,4,10
1515915625570159454,63,1,29.89,3,1,1,5
1515915625570159901,63,1,20.95,3,1,1,5
1515915625570163002,63,1,263.52,3,1,3,7
1515915625570163138,63,2,102.66,3,2,3,8
1515915625570163224,53,1,51.33,3,1,2,6
1515915625570166983,62,1,51.33,3,1,2,6
1515915625570169162,59,2,110.32,3,2,3,8
1515915625570169313,63,2,66.38,3,2,2,7
1515915625570171293,63,2,175.12,3,2,3,8
1515915625570178639,48,1,466.52,3,1,4,8
1515915625570179149,55,2,511.80999999999995,3,2,4,9
1515915625570183917,63,3,490.56000000000006,3,3,4,10
1515915625570187739,63,2,408.58,3,2,4,9
1515915625570188616,62,1,164.33,3,1,3,7
1515915625570190521,63,3,41.910000000000004,3,3,2,8
1515915625570195453,63,1,13.65,3,1,1,5
1515915625570200087,7,1,607.92,4,1,4,9
1515915625570200271,63,1,10.62,3,1,1,5
1515915625570213507,63,2,794.96,3,2,4,9
1515915625570220601,62,1,191.59,3,1,3,7
1515915625570221115,23,4,1849.0700000000002,4,3,4,11
1515915625570221469,40,2,155.46,3,2,3,8
1515915625570238362,62,1,13.79,3,1,1,5
1515915625570243189,62,1,56.14,3,1,2,6
1515915625570254757,62,1,32.86,3,1,2,6
1515915625570259986,44,12,1835.73,3,4,4,11
1515915625570261342,62,5,85.7,3,4,2,9
1515915625570271803,61,1,24.92,3,1,1,5
1515915625570282293,29,1,46.98,4,1,2,7
1515915625570296336,62,1,314.41,3,1,4,8
1515915625570296823,18,3,67.86,4,3,2,9
1515915625570298589,62,1,18.57,3,1,1,5
1515915625570299002,62,1,155.1,3,1,3,7
1515915625570304283,62,1,36.14,3,1,2,6
1515915625570312517,62,1,10.08,3,1,1,5
1515915625570314775,62,3,483.03999999999996,3,3,4,10
1515915625570316237,62,1,273.62,3,1,3,7
1515915625570317711,62,1,144.51,3,1,3,7
1515915625570318483,62,1,100.33,3,1,3,7
1515915625570320289,62,1,12.7,3,1,1,5
1515915625570334379,62,1,43.65,3,1,2,6
1515915625570335205,62,2,941.42,3,2,4,9
1515915625570338663,38,1,21.11,3,1,1,5
1515915625570340366,62,1,257.87,3,1,3,7
1515915625570346223,62,1,204.29,3,1,3,7
1515915625570348457,62,1,30.95,3,1,1,5
1515915625570350763,62,1,20.16,3,1,1,5
1515915625570355044,62,2,62.22,3,2,2,7
1515915625570355415,62,1,205.25,3,1,3,7
1515915625570356815,62,1,20.0,3,1,1,5
1515915625570366539,48,4,174.6,3,3,3,9
1515915625570374511,62,2,147.36,3,2,3,8
1515915625570375651,62,1,27.78,3,1,1,5
1515915625570376037,62,1,32.54,3,1,2,6
1515915625570376310,60,3,351.52,3,3,4,10
1515915625570378637,62,1,6.43,3,1,1,5
1515915625570380874,62,1,32.95,3,1,2,6
1515915625570381212,62,1,21.21,3,1,1,5
1515915625570385074,62,1,62.54,3,1,2,6
1515915625570387196,62,1,382.94,3,1,4,8
1515915625570388632,62,1,97.3,3,1,3,7
1515915625570389554,55,3,176.34,3,3,3,9
1515915625570394814,62,2,64.44,3,2,2,7
1515915625570395018,62,1,609.6,3,1,4,8
1515915625570448060,62,1,71.75,3,1,2,6
1515915625570451020,62,1,26.81,3,1,1,5
1515915625570452543,62,1,123.32,3,1,3,7
1515915625570452794,62,2,368.26,3,2,4,9
1515915625570457075,62,1,77.73,3,1,2,6
1515915625570461084,61,1,32.13,3,1,1,5
1515915625570465069,62,1,73.81,3,1,2,6
1515915625570468706,62,2,104.98,3,2,3,8
1515915625570469921,62,1,575.73,3,1,4,8
1515915625570471917,62,2,899.02,3,2,4,9
1515915625570472746,62,1,10.48,3,1,1,5
1515915625570479021,62,2,144.38,3,2,3,8
1515915625570481582,61,2,568.6,3,2,4,9
1515915625570482422,62,1,78.89,3,1,2,6
1515915625570483245,62,1,374.38,3,1,4,8
1515915625570485110,62,1,284.3,3,1,3,7
1515915625570486659,62,1,161.3,3,1,3,7
1515915625570491725,62,3,283.38,3,3,3,9
1515915625570495430,61,3,45.24,3,3,2,8
1515915625570540050,62,2,515.74,3,2,4,9
1515915625570540270,62,1,48.73,3,1,2,6
1515915625570544762,62,1,202.67,3,1,3,7
1515915625570546903,62,1,10.05,3,1,1,5
1515915625570563082,62,2,221.66,3,2,3,8
1515915625570564300,61,1,125.71,3,1,3,7
1515915625570566324,62,1,29.49,3,1,1,5
1515915625570568858,62,1,94.1,3,1,3,7
1515915625570572857,62,1,21.75,3,1,1,5
1515915625570573626,62,1,107.79,3,1,3,7
1515915625570575712,32,1,27.62,4,1,1,6
1515915625570588381,62,1,205.25,3,1,3,7
1515915625570588911,62,1,284.3,3,1,3,7
1515915625570590931,62,1,18.94,3,1,1,5
1515915625570593698,62,2,47.4,3,2,2,7
1515915625570593788,52,2,168.13,3,2,3,8
1515915625570595189,30,1,204.79,4,1,3,8
1515915625570598740,61,1,55.6,3,1,2,6
1515915625570599708,62,1,17.48,3,1,1,5
1515915625570603201,62,2,106.34,3,2,3,8
1515915625570639310,62,2,13.02,3,2,1,6
1515915625570639576,62,3,69.87,3,3,2,8
1515915625570641466,62,1,82.97,3,1,2,6
1515915625570644480,62,1,178.73,3,1,3,7
1515915625570647267,25,1,57.62,4,1,2,7
1515915625570648918,20,4,128.88,4,3,3,10
1515915625570649508,62,1,14.6,3,1,1,5
1515915625570649818,62,1,466.52,3,1,4,8
1515915625570651796,62,1,173.67,3,1,3,7
1515915625570678980,27,1,211.59,4,1,3,8
1515915625570680215,62,2,338.12,3,2,4,9
1515915625570680234,62,1,177.95,3,1,3,7
1515915625570684460,62,1,214.1,3,1,3,7
1515915625570687014,9,3,799.76,4,3,4,11
1515915625570698955,25,1,14.6,4,1,1,6
1515915625570699920,58,1,24.92,3,1,1,5
1515915625570700238,62,1,486.81,3,1,4,8
1515915625570705827,58,2,19.68,3,2,1,6
1515915625570706291,61,1,19.27,3,1,1,5
1515915625570712376,61,1,36.51,3,1,2,6
1515915625570727925,61,1,56.27,3,1,2,6
1515915625570728906,61,1,28.73,3,1,1,5
1515915625570730716,61,5,150.78,3,4,3,10
1515915625570732149,61,4,1429.28,3,3,4,10
1515915625570738839,61,1,65.24,3,1,2,6
1515915625570740323,61,1,25.4,3,1,1,5
1515915625570745371,10,1,68.57,4,1,2,7
1515915625570748491,14,3,608.01,4,3,4,11
1515915625570752578,61,1,32.22,3,1,1,5
1515915625570758718,61,1,38.44,3,1,2,6
1515915625570760935,61,3,210.51,3,3,3,9
1515915625570761957,61,1,9.14,3,1,1,5
1515915625570765899,52,3,803.14,3,3,4,10
1515915625570765907,52,1,349.46,3,1,4,8
1515915625570767835,61,1,26.19,3,1,1,5
1515915625570770006,61,1,49.38,3,1,2,6
1515915625570772654,61,1,25.86,3,1,1,5
1515915625570774195,61,1,34.56,3,1,2,6
1515915625570775314,61,2,498.04,3,2,4,9
1515915625570778203,60,3,445.11,3,3,4,10
1515915625570779106,61,1,14.29,3,1,1,5
1515915625570780317,61,1,377.46,3,1,4,8
1515915625570781732,61,1,21.9,3,1,1,5
1515915625570784798,61,1,603.62,3,1,4,8
1515915625570788223,37,2,899.02,3,2,4,9
1515915625570795725,61,1,56.27,3,1,2,6
1515915625570807936,61,1,34.44,3,1,2,6
1515915625570810686,61,1,55.29,3,1,2,6
1515915625570811073,61,1,97.41,3,1,3,7
1515915625570812779,61,1,2568.08,3,1,4,8
1515915625570813890,61,1,449.51,3,1,4,8
1515915625570814305,61,1,52.44,3,1,2,6
1515915625570814672,61,1,53.37,3,1,2,6
1515915625570816190,61,1,23.33,3,1,1,5
1515915625570818100,61,1,107.79,3,1,3,7
1515915625570819318,18,2,899.02,4,2,4,10
1515915625570821023,61,1,292.83,3,1,4,8
1515915625570821534,61,1,257.87,3,1,3,7
1515915625570824439,61,1,50.67,3,1,2,6
1515915625570825420,61,2,3.14,3,2,1,6
1515915625570826628,61,1,12.46,3,1,1,5
1515915625570829530,61,1,26.19,3,1,1,5
1515915625570832617,29,1,397.48,4,1,4,9
1515915625570839335,61,1,72.83,3,1,2,6
1515915625570839523,35,3,1502.6200000000001,4,3,4,11
1515915625570863851,61,3,51.989999999999995,3,3,2,8
1515915625570881348,59,2,26.76,3,2,1,6
1515915625570883103,61,1,205.25,3,1,3,7
1515915625570885036,61,1,26.98,3,1,1,5
1515915625570887697,61,2,18.7,3,2,1,6
1515915625570903166,61,1,177.95,3,1,3,7
1515915625570907045,61,1,304.41,3,1,4,8
1515915625570909646,61,1,251.92,3,1,3,7
1515915625570919452,61,1,331.59,3,1,4,8
1515915625570922144,50,1,48.84,3,1,2,6
1515915625570923700,61,1,99.38,3,1,3,7
1515915625570924832,18,1,486.81,4,1,4,9
1515915625570926762,61,1,202.67,3,1,3,7
1515915625570928317,52,5,1806.27,3,4,4,11
1515915625570942270,61,1,29.52,3,1,1,5
1515915625570967226,61,1,202.67,3,1,3,7
1515915625570969549,53,3,126.55000000000001,3,3,3,9
1515915625570970372,61,1,29.62,3,1,1,5
1515915625570972372,59,1,21.75,3,1,1,5
1515915625570983464,35,1,397.48,4,1,4,9
1515915625570991863,61,1,13.02,3,1,1,5
1515915625570993754,61,1,331.59,3,1,4,8
1515915625570999211,61,1,284.3,3,1,3,7
1515915625571006243,61,1,24.92,3,1,1,5
1515915625571014609,61,4,883.8,3,3,4,10
1515915625571015325,61,1,75.76,3,1,2,6
1515915625571018862,61,1,84.92,3,1,2,6
1515915625571024396,61,2,116.48,3,2,3,8
1515915625571026773,61,3,220.95000000000002,3,3,3,9
1515915625571028402,61,3,100.94999999999999,3,3,3,9
1515915625571070106,10,2,18.26,4,2,1,7
1515915625571070123,61,1,33.97,3,1,2,6
1515915625571070388,60,1,188.06,3,1,3,7
1515915625571073462,61,1,11.62,3,1,1,5
1515915625571074446,61,1,202.95,3,1,3,7
1515915625571080497,55,2,657.29,3,2,4,9
1515915625571083425,61,18,930.24,3,4,4,11
1515915625571084802,5,1,31.27,4,1,1,6
1515915625571087374,61,3,381.24,3,3,4,10
1515915625571088161,57,3,514.5600000000001,3,3,4,10
1515915625571088913,61,1,9.86,3,1,1,5
1515915625571089457,61,1,18.19,3,1,1,5
1515915625571092424,61,1,115.4,3,1,3,7
1515915625571099827,61,1,119.79,3,1,3,7
1515915625571100046,61,3,461.49,3,3,4,10
1515915625571101454,61,1,60.83,3,1,2,6
1515915625571104307,42,4,1078.84,3,3,4,10
1515915625571104770,61,4,34.980000000000004,3,3,2,8
1515915625571105877,61,1,34.44,3,1,2,6
1515915625571107599,61,2,939.0500000000001,3,2,4,9
1515915625571111901,61,4,200.2,3,3,3,9
1515915625571113438,61,1,23.81,3,1,1,5
1515915625571114724,61,1,1.57,3,1,1,5
1515915625571119025,59,1,13.97,3,1,1,5
1515915625571132019,37,3,32.1,3,3,1,7
1515915625571135687,60,1,229.38,3,1,3,7
1515915625571143370,60,1,205.25,3,1,3,7
1515915625571143514,60,1,77.73,3,1,2,6
1515915625571143781,59,2,1142.16,3,2,4,9
1515915625571156166,60,1,135.87,3,1,3,7
1515915625571157566,60,1,27.32,3,1,1,5
1515915625571161065,60,1,27.62,3,1,1,5
1515915625571164991,60,1,300.17,3,1,4,8
1515915625571175662,60,1,23.7,3,1,1,5
1515915625571184545,60,2,1219.2,3,2,4,9
1515915625571189434,60,1,50.87,3,1,2,6
1515915625571194994,60,1,466.52,3,1,4,8
1515915625571195603,60,5,2332.6,3,4,4,11
1515915625571198689,25,3,58.09,4,3,2,9
1515915625571201107,60,2,27.94,3,2,1,6
1515915625571203653,60,1,83.97,3,1,2,6
1515915625571204531,60,1,292.83,3,1,4,8
1515915625571206628,60,1,211.59,3,1,3,7
1515915625571213176,60,2,442.89,3,2,4,9
1515915625571215062,60,2,172.12,3,2,3,8
1515915625571227371,60,2,83.5,3,2,2,7
1515915625571230036,60,3,608.01,3,3,4,10
1515915625571237954,60,2,29.9,3,2,1,6
1515915625571240003,60,2,150.16,3,2,3,8
1515915625571242531,60,1,110.03,3,1,3,7
1515915625571245644,60,2,172.96,3,2,3,8
1515915625571252375,46,2,33.4,3,2,2,7
1515915625571266868,60,4,376.24,3,3,4,10
1515915625571269235,60,1,30.81,3,1,1,5
1515915625571270380,60,2,93.34,3,2,3,8
1515915625571281719,60,1,19.52,3,1,1,5
1515915625571307907,60,1,292.83,3,1,4,8
1515915625571309215,36,1,78.14,3,1,2,6
1515915625571315826,60,3,459.87,3,3,4,10
1515915625571315965,60,5,2045.5800000000002,3,4,4,11
1515915625571316115,60,1,12.9,3,1,1,5
1515915625571320553,60,1,82.41,3,1,2,6
1515915625571327249,60,1,144.24,3,1,3,7
1515915625571332357,60,2,57.4,3,2,2,7
1515915625571333515,60,1,200.35,3,1,3,7
1515915625571364519,60,1,482.52,3,1,4,8
1515915625571368351,60,1,397.48,3,1,4,8
1515915625571381298,12,4,248.60000000000002,4,3,3,10
1515915625571384402,57,2,193.72,3,2,3,8
1515915625571417333,60,1,69.87,3,1,2,6
1515915625571426854,49,2,1037.78,3,2,4,9
1515915625571427217,46,1,292.83,3,1,4,8
1515915625571450182,60,1,47.49,3,1,2,6
1515915625571453144,60,1,397.48,3,1,4,8
1515915625571458636,59,1,32.22,3,1,1,5
1515915625571460648,59,2,66.38,3,2,2,7
1515915625571460999,59,2,405.34,3,2,4,9
1515915625571468566,35,1,523.56,4,1,4,9
1515915625571473504,59,1,32.22,3,1,1,5
1515915625571474322,59,1,48.84,3,1,2,6
1515915625571475221,29,4,1590.88,4,3,4,11
1515915625571481161,42,6,379.98,3,4,4,11
1515915625571488683,59,1,47.78,3,1,2,6
1515915625571490818,59,1,486.81,3,1,4,8
1515915625571496028,58,1,87.32,3,1,2,6
1515915625571500215,59,1,40.63,3,1,2,6
1515915625571502381,55,2,124.28,3,2,3,8
1515915625571506995,59,1,29.52,3,1,1,5
1515915625571512360,59,1,371.46,3,1,4,8
1515915625571513960,57,2,115.24,3,2,3,8
1515915625571526459,59,1,226.84,3,1,3,7
1515915625571528842,59,1,2.86,3,1,1,5
1515915625571535133,59,1,12.13,3,1,1,5
1515915625571536618,59,1,284.46,3,1,3,7
1515915625571542038,59,1,609.6,3,1,4,8
1515915625571542142,57,3,67.23,3,3,2,8
1515915625571544579,59,3,340.14,3,3,4,10
1515915625571545469,59,1,77.73,3,1,2,6
1515915625571549005,59,1,11.11,3,1,1,5
1515915625571553048,59,1,397.48,3,1,4,8
1515915625571555620,59,1,26.67,3,1,1,5
1515915625571559441,53,1,37.0,3,1,2,6
1515915625571563329,59,6,784.52,3,4,4,11
1515915625571564758,59,1,82.33,3,1,2,6
1515915625571564963,59,3,246.99,3,3,3,9
1515915625571566959,59,1,10.87,3,1,1,5
1515915625571567187,59,1,21.9,3,1,1,5
1515915625571568392,59,2,42.86,3,2,2,7
1515915625571573836,58,2,775.3499999999999,3,2,4,9
1515915625571579196,40,1,600.6,3,1,4,8
1515915625571580133,58,1,521.56,3,1,4,8
1515915625571582865,43,3,116.25,3,3,3,9
1515915625571583210,59,1,18.43,3,1,1,5
1515915625571584698,51,1,18.43,3,1,1,5
1515915625571589875,32,3,221.43,4,3,3,10
1515915625571591470,57,1,218.98,3,1,3,7
1515915625571598250,59,2,116.48,3,2,3,8
1515915625571600553,54,1,127.08,3,1,3,7
1515915625571601682,59,1,292.83,3,1,4,8
1515915625571604290,59,1,35.25,3,1,2,6
1515915625571611448,56,3,221.43,3,3,3,9
1515915625571614111,59,2,7.14,3,2,1,6
1515915625571614398,16,1,397.48,4,1,4,9
1515915625571614525,50,1,6.43,3,1,1,5
1515915625571617143,59,1,640.49,3,1,4,8
1515915625571619008,59,1,11.6,3,1,1,5
1515915625571619324,59,2,120.64,3,2,3,8
1515915625571622136,57,2,284.1,3,2,3,8
1515915625571623783,59,1,35.67,3,1,2,6
1515915625571633060,34,1,17.38,4,1,1,6
1515915625571633265,57,2,55.5,3,2,2,7
1515915625571635668,59,1,218.98,3,1,3,7
1515915625571635933,59,4,413.64,3,3,4,10
1515915625571647357,59,3,710.01,3,3,4,10
1515915625571653216,59,3,878.49,3,3,4,10
1515915625571659001,58,1,251.4,3,1,3,7
1515915625571659737,20,7,2013.9199999999998,4,4,4,12
1515915625571662375,59,3,406.23,3,3,4,10
1515915625571668485,59,1,486.81,3,1,4,8
1515915625571673335,59,1,415.54,3,1,4,8
1515915625571673446,58,4,442.52,3,3,4,10
1515915625571675369,42,1,78.84,3,1,2,6
1515915625571675560,59,2,37.46,3,2,2,7
1515915625571677454,59,5,73.18,3,4,2,9
1515915625571678544,59,3,130.44,3,3,3,9
1515915625571684731,56,4,39.8,3,3,2,8
1515915625571685000,59,1,10.59,3,1,1,5
1515915625571685962,59,1,397.48,3,1,4,8
1515915625571686123,59,1,10.59,3,1,1,5
1515915625571687658,59,1,8.59,3,1,1,5
1515915625571693504,23,1,911.79,4,1,4,9
1515915625571695784,59,2,497.12,3,2,4,9
1515915625571695926,59,1,126.68,3,1,3,7
1515915625571698588,59,1,27.62,3,1,1,5
1515915625571703301,58,1,78.7,3,1,2,6
1515915625571706766,56,2,63.0,3,2,2,7
1515915625571713894,7,2,969.0699999999999,4,2,4,10
1515915625571714428,59,2,22.2,3,2,1,6
1515915625571728106,58,1,19.68,3,1,1,5
1515915625571729521,58,1,149.32,3,1,3,7
1515915625571730546,58,1,22.22,3,1,1,5
1515915625571734528,58,1,18.71,3,1,1,5
1515915625571734684,58,1,312.43,3,1,4,8
1515915625571740142,58,1,126.68,3,1,3,7
1515915625571742626,58,2,33.96,3,2,2,7
1515915625571752733,56,3,380.04,3,3,4,10
1515915625571754029,58,1,18.19,3,1,1,5
1515915625571771983,58,1,29.37,3,1,1,5
1515915625571773032,58,2,409.58,3,2,4,9
1515915625571779460,58,1,27.62,3,1,1,5
1515915625571781012,58,3,439.95000000000005,3,3,4,10
1515915625571790553,58,1,15.87,3,1,1,5
1515915625571798986,58,3,84.30000000000001,3,3,2,8
1515915625571803995,58,1,64.48,3,1,2,6
1515915625571809291,58,3,372.39,3,3,4,10
1515915625571811936,58,2,63.18,3,2,2,7
1515915625571814980,58,2,518.76,3,2,4,9
1515915625571817309,58,2,65.72,3,2,2,7
1515915625571819957,55,1,298.76,3,1,4,8
1515915625571823508,37,2,530.1,3,2,4,9
1515915625571832269,38,2,587.24,3,2,4,9
1515915625571832421,58,3,2.7,3,3,1,7
1515915625571836741,58,1,18.25,3,1,1,5
1515915625571838713,58,3,778.14,3,3,4,10
1515915625571856832,58,1,78.7,3,1,2,6
1515915625571864861,58,1,26.98,3,1,1,5
1515915625571866108,58,1,11.59,3,1,1,5
1515915625571867280,58,1,20.48,3,1,1,5
1515915625571871344,58,1,31.11,3,1,1,5
1515915625571872809,58,1,82.33,3,1,2,6
1515915625571876040,58,1,94.06,3,1,3,7
1515915625571876680,58,1,209.7,3,1,3,7
1515915625571878830,58,2,893.02,3,2,4,9
1515915625571879838,44,3,125.22999999999999,3,3,3,9
1515915625571885159,55,3,1172.48,3,3,4,10
1515915625571886410,57,1,64.48,3,1,2,6
1515915625571887924,58,1,24.98,3,1,1,5
1515915625571888465,58,1,204.29,3,1,3,7
1515915625571888647,58,1,16.98,3,1,1,5
1515915625571888964,58,1,45.24,3,1,2,6
1515915625571896613,58,1,202.67,3,1,3,7
1515915625571900159,58,1,206.19,3,1,3,7
1515915625571900662,58,1,32.6,3,1,2,6
1515915625571903718,58,1,27.3,3,1,1,5
1515915625571905631,58,2,281.72,3,2,3,8
1515915625571939066,58,1,87.63,3,1,2,6
1515915625571939500,58,2,26.41,3,2,1,6
1515915625571940922,58,2,446.7,3,2,4,9
1515915625571950107,49,4,1866.08,3,3,4,10
1515915625571956194,58,2,113.05000000000001,3,2,3,8
1515915625571958681,58,2,107.8,3,2,3,8
1515915625571959044,56,2,629.94,3,2,4,9
1515915625571970360,58,4,128.88,3,3,3,9
1515915625571970751,58,1,21.75,3,1,1,5
1515915625571973148,58,3,492.99,3,3,4,10
1515915625571973555,58,2,102.66,3,2,3,8
1515915625571975475,58,3,50.94,3,3,2,8
1515915625571976623,58,1,55.87,3,1,2,6
1515915625571985242,58,1,202.67,3,1,3,7
1515915625571986431,58,2,973.62,3,2,4,9
1515915625571988998,58,5,2074.55,3,4,4,11
1515915625571989615,58,2,381.08,3,2,4,9
1515915625571990049,58,1,21.59,3,1,1,5
1515915625571995821,58,1,38.32,3,1,2,6
1515915625571995894,58,1,292.83,3,1,4,8
1515915625572019767,58,1,20.48,3,1,1,5
1515915625572020031,58,2,79.02,3,2,2,7
1515915625572022262,58,1,18.19,3,1,1,5
1515915625572023499,58,1,18.19,3,1,1,5
1515915625572025812,58,1,95.13,3,1,3,7
1515915625572029452,58,2,32.38,3,2,2,7
1515915625572036766,57,2,32.38,3,2,2,7
1515915625572049974,58,1,415.54,3,1,4,8
1515915625572050171,58,1,47.62,3,1,2,6
1515915625572051662,55,2,568.6,3,2,4,9
1515915625572058800,58,1,12.27,3,1,1,5
1515915625572061241,58,4,1054.8700000000001,3,3,4,10
1515915625572062815,56,1,548.37,3,1,4,8
1515915625572067763,58,1,12.51,3,1,1,5
1515915625572069326,58,1,164.33,3,1,3,7
1515915625572076407,55,1,897.79,3,1,4,8
1515915625572084019,58,2,40.96,3,2,2,7
1515915625572085684,58,8,96.74000000000001,3,4,3,10
1515915625572086300,58,1,150.65,3,1,3,7
1515915625572092368,57,4,87.32,3,3,2,8
1515915625572092519,57,1,18.41,3,1,1,5
1515915625572094841,25,2,405.34,4,2,4,10
1515915625572097565,33,1,202.67,4,1,3,8
1515915625572097974,54,2,757.9300000000001,3,2,4,9
1515915625572101311,57,1,226.84,3,1,3,7
1515915625572101417,57,1,61.16,3,1,2,6
1515915625572113393,57,2,5.72,3,2,1,6
1515915625572114813,57,1,274.4,3,1,3,7
1515915625572120505,57,2,1049.12,3,2,4,9
1515915625572120625,57,1,441.49,3,1,4,8
1515915625572133073,57,1,9.71,3,1,1,5
1515915625572136813,50,1,200.35,3,1,3,7
1515915625572139081,57,4,153.28,3,3,3,9
1515915625572141189,57,1,16.98,3,1,1,5
1515915625572147640,57,1,11.43,3,1,1,5
1515915625572148499,43,2,649.87,3,2,4,9
1515915625572149066,57,1,15.87,3,1,1,5
1515915625572149188,47,2,42.6,3,2,2,7
1515915625572151419,57,1,397.48,3,1,4,8
1515915625572152512,57,1,31.44,3,1,1,5
1515915625572160843,57,1,113.56,3,1,3,7
1515915625572165354,57,2,586.77,3,2,4,9
1515915625572172616,57,1,9.86,3,1,1,5
1515915625572173724,57,1,220.3,3,1,3,7
1515915625572175014,57,1,202.67,3,1,3,7
1515915625572175732,56,1,27.78,3,1,1,5
1515915625572176064,57,3,1261.8899999999999,3,3,4,10
1515915625572176513,57,2,344.76,3,2,4,9
1515915625572177804,57,3,592.2,3,3,4,10
1515915625572178110,57,2,44.04,3,2,2,7
1515915625572179401,57,1,15.08,3,1,1,5
1515915625572181201,57,3,43.38,3,3,2,8
1515915625572181639,57,1,200.35,3,1,3,7
1515915625572191645,57,1,31.76,3,1,1,5
1515915625572191723,53,1,25.71,3,1,1,5
1515915625572193361,57,1,44.13,3,1,2,6
1515915625572196159,57,1,106.76,3,1,3,7
1515915625572204378,57,1,204.29,3,1,3,7
1515915625572206925,57,1,214.1,3,1,3,7
1515915625572207902,57,2,283.66,3,2,3,8
1515915625572208558,57,1,32.22,3,1,1,5
1515915625572210919,57,1,1.57,3,1,1,5
1515915625572212656,57,1,114.46,3,1,3,7
1515915625572213407,57,14,137.54,3,4,3,10
1515915625572219890,49,1,29.57,3,1,1,5
1515915625572221023,57,1,415.54,3,1,4,8
1515915625572222341,56,1,274.4,3,1,3,7
1515915625572232455,39,1,294.41,3,1,4,8
1515915625572240645,39,1,357.35,3,1,4,8
1515915625572250917,57,1,322.57,3,1,4,8
1515915625572261287,57,1,77.73,3,1,2,6
1515915625572262407,57,3,883.23,3,3,4,10
1515915625572264276,57,1,15.87,3,1,1,5
1515915625572266540,57,1,397.48,3,1,4,8
1515915625572268810,57,1,291.41,3,1,4,8
1515915625572276284,57,1,294.41,3,1,4,8
1515915625572277206,57,1,187.78,3,1,3,7
1515915625572277828,57,1,28.89,3,1,1,5
1515915625572277840,57,4,805.32,3,3,4,10
1515915625572280080,40,2,355.9,3,2,4,9
1515915625572281256,57,2,129.94,3,2,3,8
1515915625572281704,57,3,99.57,3,3,3,9
1515915625572282500,57,1,55.6,3,1,2,6
1515915625572285724,56,2,55.24,3,2,2,7
1515915625572286839,57,1,153.83,3,1,3,7
1515915625572288317,41,2,298.1,3,2,4,9
1515915625572288426,57,1,40.79,3,1,2,6
1515915625572288593,56,3,298.53000000000003,3,3,4,10
1515915625572289127,57,1,435.73,3,1,4,8
1515915625572292020,44,1,287.63,3,1,4,8
1515915625572294711,57,1,15.87,3,1,1,5
1515915625572295561,57,1,284.46,3,1,3,7
1515915625572295908,56,2,409.58,3,2,4,9
1515915625572298773,57,1,612.6,3,1,4,8
1515915625572300986,57,1,377.46,3,1,4,8
1515915625572339553,57,3,223.42,3,3,3,9
1515915625572340315,56,1,82.97,3,1,2,6
1515915625572340361,56,2,165.94,3,2,3,8
1515915625572341963,57,1,18.89,3,1,1,5
1515915625572343330,57,2,385.72,3,2,4,9
1515915625572343523,45,8,203.18,3,4,3,10
1515915625572352091,42,1,104.86,3,1,3,7
1515915625572353730,57,1,71.38,3,1,2,6
1515915625572358512,57,1,77.73,3,1,2,6
1515915625572361889,57,4,492.48999999999995,3,3,4,10
1515915625572365962,57,1,229.38,3,1,3,7
1515915625572367619,57,1,47.46,3,1,2,6
1515915625572368728,57,2,30.48,3,2,1,6
1515915625572371387,55,2,105.24,3,2,3,8
1515915625572373368,57,1,136.83,3,1,3,7
1515915625572374349,46,1,26.19,3,1,1,5
1515915625572378224,57,3,811.5899999999999,3,3,4,10
1515915625572383459,57,1,57.62,3,1,2,6
1515915625572384658,57,1,187.29,3,1,3,7
1515915625572385884,57,1,77.73,3,1,2,6
1515915625572386532,57,1,98.62,3,1,3,7
1515915625572387709,57,1,77.35,3,1,2,6
1515915625572393873,41,2,86.38,3,2,2,7
1515915625572395277,57,4,169.28,3,3,3,9
1515915625572397998,57,2,37.78,3,2,2,7
1515915625572401254,57,1,15.4,3,1,1,5
1515915625572401423,57,1,113.38,3,1,3,7
1515915625572427070,57,2,174.32,3,2,3,8
1515915625572432660,57,1,13.81,3,1,1,5
1515915625572433531,11,1,64.48,4,1,2,7
1515915625572438577,56,2,794.96,3,2,4,9
1515915625572446440,57,1,86.16,3,1,2,6
1515915625572448730,17,3,878.49,4,3,4,11
1515915625572450080,57,4,119.03999999999999,3,3,3,9
1515915625572450263,57,3,1440.96,3,3,4,10
1515915625572450510,57,2,375.2,3,2,4,9
1515915625572454077,18,3,1198.44,4,3,4,11
1515915625572459416,36,4,410.8,3,3,4,10
1515915625572459557,56,10,1658.79,3,4,4,11
1515915625572459850,19,1,33.08,4,1,2,7
1515915625572461448,57,1,316.43,3,1,4,8
1515915625572461544,57,3,4.71,3,3,1,7
1515915625572461562,51,2,208.92,3,2,3,8
1515915625572463456,57,1,15.7,3,1,1,5
1515915625572467232,57,1,11.11,3,1,1,5
1515915625572479230,56,1,373.46,3,1,4,8
1515915625572484584,57,1,82.33,3,1,2,6
1515915625572487539,27,1,471.52,4,1,4,9
1515915625572487981,56,4,257.92,3,3,3,9
1515915625572491908,57,3,337.96000000000004,3,3,4,10
1515915625572499856,56,1,259.94,3,1,3,7
1515915625572500155,48,1,202.67,3,1,3,7
1515915625572503049,56,1,23.65,3,1,1,5
1515915625572504780,56,1,57.62,3,1,2,6
1515915625572505463,56,1,349.46,3,1,4,8
1515915625572515043,56,1,163.52,3,1,3,7
1515915625572518684,54,3,186.51,3,3,3,9
1515915625572518976,55,3,473.82,3,3,4,10
1515915625572522511,56,1,27.62,3,1,1,5
1515915625572522946,56,2,548.8,3,2,4,9
1515915625572539799,56,1,20.48,3,1,1,5
1515915625572539952,56,1,17.08,3,1,1,5
1515915625572542209,56,1,16.35,3,1,1,5
1515915625572544990,25,5,671.6500000000001,4,4,4,12
1515915625572548016,56,1,56.51,3,1,2,6
1515915625572554996,49,1,47.49,3,1,2,6
1515915625572556657,56,1,177.95,3,1,3,7
1515915625572560262,56,1,75.29,3,1,2,6
1515915625572561894,39,1,177.95,3,1,3,7
1515915625572566357,56,1,274.4,3,1,3,7
1515915625572566565,56,1,482.52,3,1,4,8
1515915625572566857,41,4,810.68,3,3,4,10
1515915625572579261,56,2,34.16,3,2,2,7
1515915625572580636,56,2,50.8,3,2,2,7
1515915625572581253,56,1,9.35,3,1,1,5
1515915625572582525,56,1,32.86,3,1,2,6
1515915625572582873,56,1,100.75,3,1,3,7
1515915625572584165,48,3,839.0999999999999,3,3,4,10
1515915625572585398,56,1,32.22,3,1,1,5
1515915625572588727,49,1,18.27,3,1,1,5
1515915625572588806,56,2,588.82,3,2,4,9
1515915625572589710,56,1,32.22,3,1,1,5
1515915625572591209,49,2,30.16,3,2,1,6
1515915625572595085,56,1,349.46,3,1,4,8
1515915625572596030,56,2,69.3,3,2,2,7
1515915625572598287,52,3,853.3799999999999,3,3,4,10
1515915625572601819,56,9,1387.26,3,4,4,11
1515915625572604747,56,7,4296.110000000001,3,4,4,11
1515915625572609487,56,3,88.71000000000001,3,3,2,8
1515915625572613669,56,1,157.94,3,1,3,7
1515915625572614169,56,1,250.02,3,1,3,7
1515915625572614800,56,1,16.33,3,1,1,5
1515915625572615022,54,1,73.81,3,1,2,6
1515915625572616167,56,2,1037.78,3,2,4,9
1515915625572620484,55,9,1770.48,3,4,4,11
1515915625572624398,46,1,257.87,3,1,3,7
1515915625572626997,56,2,21.12,3,2,1,6
1515915625572628489,56,1,1.57,3,1,1,5
1515915625572635893,56,1,600.6,3,1,4,8
1515915625572638212,56,1,44.13,3,1,2,6
1515915625572653249,49,5,388.65000000000003,3,4,4,11
1515915625572662175,46,1,28.25,3,1,1,5
1515915625572662781,56,1,126.68,3,1,3,7
1515915625572665959,56,1,204.79,3,1,3,7
1515915625572666030,56,13,597.23,3,4,4,11
1515915625572669192,56,3,45.24,3,3,2,8
1515915625572669250,56,2,73.66,3,2,2,7
1515915625572669306,56,1,92.81,3,1,3,7
1515915625572669682,56,1,15.56,3,1,1,5
1515915625572670078,56,1,519.56,3,1,4,8
1515915625572671494,56,4,173.92,3,3,3,9
1515915625572676430,56,1,105.87,3,1,3,7
1515915625572677961,56,2,719.91,3,2,4,9
1515915625572686899,56,1,218.98,3,1,3,7
1515915625572686969,54,2,53.96,3,2,2,7
1515915625572687147,13,1,489.54,4,1,4,9
1515915625572694741,56,1,1.57,3,1,1,5
1515915625572702373,56,1,143.97,3,1,3,7
1515915625572702507,55,1,12.21,3,1,1,5
1515915625572702931,56,1,125.73,3,1,3,7
1515915625572706400,56,1,29.52,3,1,1,5
1515915625572712660,56,2,34.74,3,2,2,7
1515915625572739225,44,3,983.14,3,3,4,10
1515915625572742433,56,1,346.08,3,1,4,8
1515915625572746726,25,4,1016.59,4,3,4,11
1515915625572748253,56,1,25.4,3,1,1,5
1515915625572750558,35,3,1087.79,4,3,4,11
1515915625572752099,56,2,29.68,3,2,1,6
1515915625572757347,45,2,408.58,3,2,4,9
1515915625572762314,55,1,16.83,3,1,1,5
1515915625572764290,56,1,202.67,3,1,3,7
1515915625572768123,52,1,31.59,3,1,1,5
1515915625572771423,56,2,38.98,3,2,2,7
1515915625572772861,56,1,524.56,3,1,4,8
1515915625572776200,56,1,133.03,3,1,3,7
1515915625572776695,56,2,193.66,3,2,3,8
1515915625572777480,56,4,89.6,3,3,2,8
1515915625572784459,52,5,91.25,3,4,3,10
1515915625572791182,56,1,19.52,3,1,1,5
1515915625572791331,56,2,1096.1399999999999,3,2,4,9
1515915625572795041,56,1,49.52,3,1,2,6
1515915625572803766,51,2,399.99,3,2,4,9
1515915625572826718,56,3,250.86,3,3,3,9
1515915625572828091,56,1,8.59,3,1,1,5
1515915625572829980,55,1,93.51,3,1,3,7
1515915625572834901,55,3,191.94,3,3,3,9
1515915625572834959,44,1,113.81,3,1,3,7
1515915625572835540,55,4,125.64,3,3,3,9
1515915625572842809,55,1,453.86,3,1,4,8
1515915625572843072,56,1,18.3,3,1,1,5
1515915625572845774,56,4,694.68,3,3,4,10
1515915625572846260,56,1,259.38,3,1,3,7
1515915625572850508,56,1,171.27,3,1,3,7
1515915625572852106,56,3,380.04,3,3,4,10
1515915625572852818,56,1,294.41,3,1,4,8
1515915625572853024,56,1,202.38,3,1,3,7
1515915625572853135,56,3,88.61,3,3,2,8
1515915625572854404,55,3,160.44,3,3,3,9
1515915625572855387,56,1,11.11,3,1,1,5
1515915625572856978,56,1,418.48,3,1,4,8
1515915625572857254,56,1,284.46,3,1,3,7
1515915625572863958,56,1,56.67,3,1,2,6
1515915625572867973,56,4,810.16,3,3,4,10
1515915625572869789,56,1,75.67,3,1,2,6
1515915625572869790,56,4,349.84,3,3,4,10
1515915625572870238,54,3,129.32999999999998,3,3,3,9
1515915625572875649,56,1,133.02,3,1,3,7
1515915625572876650,56,1,24.35,3,1,1,5
1515915625572876884,56,1,336.57,3,1,4,8
1515915625572880442,54,1,200.35,3,1,3,7
1515915625572883358,56,2,266.04,3,2,3,8
1515915625572883485,56,1,13.06,3,1,1,5
1515915625572890256,26,1,224.76,4,1,3,8
1515915625572891723,56,1,269.4,3,1,3,7
1515915625572897803,55,4,2454.92,3,3,4,10
1515915625572898128,56,1,55.87,3,1,2,6
1515915625572898647,56,1,214.1,3,1,3,7
1515915625572898743,56,1,284.46,3,1,3,7
1515915625572899431,56,1,62.17,3,1,2,6
1515915625572903223,52,1,102.46,3,1,3,7
1515915625572906818,55,1,49.98,3,1,2,6
1515915625572906996,55,1,331.59,3,1,4,8
1515915625572907878,55,1,31.78,3,1,1,5
1515915625572907901,55,1,49.98,3,1,2,6
1515915625572927746,40,4,321.22,3,3,4,10
1515915625572928222,55,2,409.58,3,2,4,9
1515915625572932291,53,1,120.27,3,1,3,7
1515915625572934473,20,3,613.02,4,3,4,11
1515915625572935456,55,1,373.46,3,1,4,8
1515915625572937814,55,1,77.73,3,1,2,6
1515915625572944557,55,1,32.22,3,1,1,5
1515915625572947938,54,1,548.37,3,1,4,8
1515915625572948708,55,1,19.52,3,1,1,5
1515915625572948953,55,1,371.46,3,1,4,8
1515915625572951086,55,1,187.29,3,1,3,7
1515915625572954660,51,5,879.1500000000001,3,4,4,11
1515915625572955907,55,3,225.87,3,3,3,9
1515915625572964116,55,1,446.51,3,1,4,8
1515915625572966237,47,3,601.05,3,3,4,10
1515915625572966331,55,1,35.71,3,1,2,6
1515915625572966507,55,1,218.98,3,1,3,7
1515915625572968793,55,3,578.58,3,3,4,10
1515915625572970358,55,1,292.83,3,1,4,8
1515915625572971988,55,1,19.37,3,1,1,5
1515915625572974050,55,1,32.86,3,1,2,6
1515915625572983337,34,2,684.64,4,2,4,10
1515915625572987436,55,1,187.78,3,1,3,7
1515915625572988367,54,3,32.04,3,3,1,7
1515915625572993416,55,1,21.27,3,1,1,5
1515915625572998150,53,6,161.88,3,4,3,10
1515915625572998531,36,2,438.66999999999996,3,2,4,9
1515915625572999666,55,3,499.53,3,3,4,10
1515915625573000015,37,1,399.48,3,1,4,8
1515915625573010820,55,1,202.67,3,1,3,7
1515915625573012987,55,1,69.54,3,1,2,6
1515915625573019646,55,4,21.84,3,3,1,7
1515915625573024876,55,1,11.65,3,1,1,5
1515915625573027262,55,1,51.43,3,1,2,6
1515915625573027829,10,1,68.57,4,1,2,7
1515915625573033130,55,2,224.28,3,2,3,8
1515915625573039224,55,1,897.79,3,1,4,8
1515915625573068059,55,2,385.72,3,2,4,9
1515915625573068957,50,3,539.34,3,3,4,10
1515915625573075866,55,1,202.67,3,1,3,7
1515915625573076963,55,1,37.62,3,1,2,6
1515915625573077936,55,3,98.58,3,3,3,9
1515915625573078829,55,4,330.08,3,3,4,10
1515915625573079272,55,1,69.3,3,1,2,6
1515915625573079966,49,2,618.4300000000001,3,2,4,9
1515915625573083450,55,1,35.05,3,1,2,6
1515915625573084279,55,1,32.22,3,1,1,5
1515915625573086363,55,1,51.68,3,1,2,6
1515915625573087283,55,1,374.38,3,1,4,8
1515915625573088061,55,1,466.52,3,1,4,8
1515915625573088904,55,1,46.35,3,1,2,6
1515915625573089853,53,1,32.86,3,1,2,6
1515915625573090933,51,1,292.83,3,1,4,8
1515915625573092663,55,3,346.20000000000005,3,3,4,10
1515915625573096851,55,1,9.35,3,1,1,5
1515915625573097571,55,1,202.67,3,1,3,7
1515915625573101996,54,4,1962.16,3,3,4,10
1515915625573105656,55,3,724.04,3,3,4,10
1515915625573109559,55,1,9.35,3,1,1,5
1515915625573111437,55,1,108.59,3,1,3,7
1515915625573111783,20,1,466.52,4,1,4,9
1515915625573112155,55,1,577.6,3,1,4,8
1515915625573113546,55,2,88.39,3,2,2,7
1515915625573115706,37,1,14.6,3,1,1,5
1515915625573143938,55,1,18.89,3,1,1,5
1515915625573144567,52,4,892.8,3,3,4,10
1515915625573146306,55,1,23.02,3,1,1,5
1515915625573150619,55,1,21.11,3,1,1,5
1515915625573151369,55,1,14.14,3,1,1,5
1515915625573152246,55,1,449.51,3,1,4,8
1515915625573155617,46,3,913.23,3,3,4,10
1515915625573155980,55,3,50.94,3,3,2,8
1515915625573156553,55,1,435.7,3,1,4,8
1515915625573157374,55,1,251.4,3,1,3,7
1515915625573157677,55,10,3562.58,3,4,4,11
1515915625573157991,54,1,22.54,3,1,1,5
1515915625573158849,55,1,205.25,3,1,3,7
1515915625573159379,55,2,479.65,3,2,4,9
1515915625573160864,55,1,23.65,3,1,1,5
1515915625573161005,55,1,51.9,3,1,2,6
1515915625573163670,41,4,326.89,3,3,4,10
1515915625573166134,55,1,117.87,3,1,3,7
1515915625573167676,54,1,292.83,3,1,4,8
1515915625573169293,55,1,34.44,3,1,2,6
1515915625573171790,54,1,23.43,3,1,1,5
1515915625573173153,55,2,405.34,3,2,4,9
1515915625573175046,43,8,1030.32,3,4,4,11
1515915625573175430,48,3,466.20000000000005,3,3,4,10
1515915625573176810,55,1,420.63,3,1,4,8
1515915625573176839,55,2,973.62,3,2,4,9
1515915625573177464,46,1,214.1,3,1,3,7
1515915625573180678,55,2,3.14,3,2,1,6
1515915625573181332,2,1,9.56,4,1,1,6
1515915625573182113,55,1,107.16,3,1,3,7
1515915625573185663,55,1,26.98,3,1,1,5
1515915625573186424,13,1,201.33,4,1,3,8
1515915625573188022,47,2,58.98,3,2,2,7
1515915625573188176,32,6,544.2,4,4,4,12
1515915625573192972,55,1,51.33,3,1,2,6
1515915625573196136,55,2,965.04,3,2,4,9
1515915625573196961,55,1,577.6,3,1,4,8
1515915625573197397,55,1,27.62,3,1,1,5
1515915625573202383,55,1,399.48,3,1,4,8
1515915625573206095,55,4,61.72,3,3,2,8
1515915625573206268,55,1,115.08,3,1,3,7
1515915625573208956,55,2,798.96,3,2,4,9
1515915625573209976,55,7,4007.9900000000002,3,4,4,11
1515915625573211615,7,1,642.62,4,1,4,9
1515915625573211926,55,1,36.49,3,1,2,6
1515915625573216172,49,4,1589.92,3,3,4,10
1515915625573237174,54,1,23.48,3,1,1,5
1515915625573239565,55,1,415.54,3,1,4,8
1515915625573247154,55,1,64.48,3,1,2,6
1515915625573248526,55,3,662.8499999999999,3,3,4,10
1515915625573249173,55,2,831.08,3,2,4,9
1515915625573250965,55,2,64.44,3,2,2,7
1515915625573252621,55,1,199.7,3,1,3,7
1515915625573256427,37,3,762.1800000000001,3,3,4,10
1515915625573258323,54,3,1255.44,3,3,4,10
1515915625573266423,55,1,292.83,3,1,4,8
1515915625573266690,33,3,337.96000000000004,4,3,4,11
1515915625573268039,55,2,375.56,3,2,4,9
1515915625573268357,54,1,539.57,3,1,4,8
1515915625573270343,53,6,542.1800000000001,3,4,4,11
1515915625573273197,55,1,397.48,3,1,4,8
1515915625573273609,55,4,1238.35,3,3,4,10
1515915625573277239,15,3,548.1,4,3,4,11
1515915625573277632,55,2,794.96,3,2,4,9
1515915625573278437,55,1,63.35,3,1,2,6
1515915625573284186,55,1,415.54,3,1,4,8
1515915625573284386,55,1,599.6,3,1,4,8
1515915625573288065,55,1,519.56,3,1,4,8
1515915625573288272,52,1,29.52,3,1,1,5
1515915625573288512,55,2,49.290000000000006,3,2,2,7
1515915625573294952,55,2,64.44,3,2,2,7
1515915625573309187,52,2,66.16,3,2,2,7
1515915625573312888,54,3,633.42,3,3,4,10
1515915625573314013,55,1,24.35,3,1,1,5
1515915625573323604,54,2,202.1,3,2,3,8
1515915625573341251,54,2,101.8,3,2,3,8
1515915625573345857,54,3,1030.65,3,3,4,10
1515915625573347974,9,1,43.11,4,1,2,7
1515915625573351503,54,1,247.4,3,1,3,7
1515915625573354538,54,2,550.79,3,2,4,9
1515915625573357131,54,1,73.65,3,1,2,6
1515915625573358983,50,1,82.97,3,1,2,6
1515915625573361525,54,1,55.08,3,1,2,6
1515915625573366084,54,1,329.43,3,1,4,8
1515915625573370674,49,2,245.94,3,2,3,8
1515915625573373082,54,2,114.54,3,2,3,8
1515915625573373177,54,2,589.23,3,2,4,9
1515915625573379855,54,1,32.22,3,1,1,5
1515915625573380752,54,1,259.38,3,1,3,7
1515915625573381900,52,1,183.6,3,1,3,7
1515915625573382032,54,1,482.52,3,1,4,8
1515915625573405658,54,2,79.04,3,2,2,7
1515915625573406482,54,1,304.41,3,1,4,8
1515915625573408968,54,1,15.87,3,1,1,5
1515915625573410310,54,1,21.27,3,1,1,5
1515915625573415613,54,1,77.73,3,1,2,6
1515915625573418537,54,1,15.08,3,1,1,5
1515915625573419741,54,1,74.84,3,1,2,6
1515915625573421240,54,2,18.86,3,2,1,6
1515915625573421891,54,3,586.52,3,3,4,10
1515915625573422781,54,1,44.76,3,1,2,6
1515915625573428436,54,4,514.92,3,3,4,10
1515915625573429819,53,1,75.71,3,1,2,6
1515915625573432995,51,1,202.67,3,1,3,7
1515915625573433088,54,1,30.83,3,1,1,5
1515915625573436886,54,5,658.65,3,4,4,11
1515915625573437618,54,2,751.9200000000001,3,2,4,9
1515915625573441125,54,2,53.96,3,2,2,7
1515915625573444006,54,1,22.56,3,1,1,5
1515915625573444415,54,3,128.94,3,3,3,9
1515915625573444760,54,3,353.25,3,3,4,10
1515915625573445875,54,1,116.83,3,1,3,7
1515915625573446377,54,3,350.49,3,3,4,10
1515915625573454813,51,3,1348.91,3,3,4,10
1515915625573460522,42,1,449.51,3,1,4,8
1515915625573468769,54,1,47.14,3,1,2,6
1515915625573469252,54,1,26.98,3,1,1,5
1515915625573471780,54,2,768.92,3,2,4,9
1515915625573472818,24,1,26.83,4,1,1,6
1515915625573478684,54,2,155.46,3,2,3,8
1515915625573480309,54,1,274.4,3,1,3,7
1515915625573480704,54,2,437.96,3,2,4,9
1515915625573482744,52,2,77.66,3,2,2,7
1515915625573487789,54,1,64.48,3,1,2,6
1515915625573490991,54,1,1.57,3,1,1,5
1515915625573492987,54,2,1039.12,3,2,4,9
1515915625573494333,54,1,486.81,3,1,4,8
1515915625573495464,53,2,698.92,3,2,4,9
1515915625573497645,54,1,415.54,3,1,4,8
1515915625573501602,54,1,31.11,3,1,1,5
1515915625573501661,54,3,528.51,3,3,4,10
1515915625573504557,52,3,900.88,3,3,4,10
1515915625573504558,53,1,64.29,3,1,2,6
1515915625573504877,50,1,43.11,3,1,2,6
1515915625573507805,33,2,221.9,4,2,3,9
1515915625573510304,54,2,71.86,3,2,2,7
1515915625573518861,49,1,349.46,3,1,4,8
1515915625573519240,53,2,5.72,3,2,1,6
1515915625573521323,54,4,339.56,3,3,4,10
1515915625573549022,54,1,20.71,3,1,1,5
1515915625573550718,54,1,187.35,3,1,3,7
1515915625573551914,54,1,397.48,3,1,4,8
1515915625573553170,54,1,120.27,3,1,3,7
1515915625573555402,54,1,20.95,3,1,1,5
1515915625573560614,54,2,408.58,3,2,4,9
1515915625573568628,54,1,397.48,3,1,4,8
1515915625573571198,54,1,9.35,3,1,1,5
1515915625573571710,54,2,408.58,3,2,4,9
1515915625573572774,54,2,335.24,3,2,4,9
1515915625573574990,54,1,10.63,3,1,1,5
1515915625573575424,54,1,167.62,3,1,3,7
1515915625573583900,54,2,70.2,3,2,2,7
1515915625573584705,54,2,55.24,3,2,2,7
1515915625573585505,54,1,423.49,3,1,4,8
1515915625573587935,54,1,32.38,3,1,2,6
1515915625573588477,54,1,423.49,3,1,4,8
1515915625573588755,54,2,587.14,3,2,4,9
1515915625573590570,54,5,914.0999999999999,3,4,4,11
1515915625573600074,54,4,1171.32,3,3,4,10
1515915625573605302,54,1,9.68,3,1,1,5
1515915625573605806,54,1,331.59,3,1,4,8
1515915625573612978,54,1,14.6,3,1,1,5
1515915625573628540,54,1,13.02,3,1,1,5
1515915625573629519,53,1,77.73,3,1,2,6
1515915625573630931,54,2,673.14,3,2,4,9
1515915625573632274,49,2,1096.74,3,2,4,9
1515915625573636553,53,4,513.32,3,3,4,10
1515915625573642940,54,1,15.08,3,1,1,5
1515915625573645512,54,1,78.3,3,1,2,6
1515915625573648051,54,1,796.76,3,1,4,8
1515915625573649442,40,2,23.020000000000003,3,2,1,6
1515915625573651391,54,3,148.56,3,3,3,9
1515915625573658155,49,2,178.8,3,2,3,8
1515915625573660095,6,6,90.48,4,4,2,10
1515915625573663187,54,1,26.19,3,1,1,5
1515915625573667588,54,1,81.9,3,1,2,6
1515915625573670620,54,2,39.68,3,2,2,7
1515915625573675128,54,2,328.66,3,2,4,9
1515915625573678229,54,1,179.94,3,1,3,7
1515915625573680158,54,1,187.29,3,1,3,7
1515915625573680159,53,2,794.96,3,2,4,9
1515915625573681978,54,3,1334.58,3,3,4,10
1515915625573683536,53,1,55.35,3,1,2,6
1515915625573685591,50,1,215.06,3,1,3,7
1515915625573685795,54,1,399.48,3,1,4,8
1515915625573687931,54,1,444.51,3,1,4,8
1515915625573688665,54,1,349.46,3,1,4,8
1515915625573692372,54,1,82.86,3,1,2,6
1515915625573694640,54,1,127.08,3,1,3,7
1515915625573695238,54,1,19.84,3,1,1,5
1515915625573700047,33,7,3006.5699999999997,4,4,4,12
1515915625573700498,54,1,15.56,3,1,1,5
1515915625573704162,52,1,92.65,3,1,3,7
1515915625573717215,15,1,418.48,4,1,4,9
1515915625573717243,21,2,897.99,4,2,4,10
1515915625573725049,53,1,19.27,3,1,1,5
1515915625573727050,44,4,1424.3600000000001,3,3,4,10
1515915625573732438,53,1,292.83,3,1,4,8
1515915625573734596,53,1,43.25,3,1,2,6
1515915625573737711,48,1,274.4,3,1,3,7
1515915625573741998,53,1,572.57,3,1,4,8
1515915625573742213,53,1,97.35,3,1,3,7
1515915625573745893,52,2,472.92,3,2,4,9
1515915625573747339,53,1,16.19,3,1,1,5
1515915625573757517,53,3,52.86,3,3,2,8
1515915625573758345,51,2,53.96,3,2,2,7
1515915625573761280,52,8,1965.05,3,4,4,11
1515915625573767082,53,1,122.86,3,1,3,7
1515915625573780374,53,1,27.25,3,1,1,5
1515915625573781183,52,4,137.16,3,3,3,9
1515915625573781566,53,1,82.52,3,1,2,6
1515915625573784024,53,1,127.08,3,1,3,7
1515915625573790533,53,2,22.26,3,2,1,6
1515915625573790633,53,1,479.51,3,1,4,8
1515915625573791950,53,2,64.44,3,2,2,7
1515915625573792775,53,1,796.76,3,1,4,8
1515915625573794967,53,1,345.44,3,1,4,8
1515915625573796111,29,8,2557.75,4,4,4,12
1515915625573799476,53,1,19.43,3,1,1,5
1515915625573800044,53,1,32.22,3,1,1,5
1515915625573801185,53,1,63.33,3,1,2,6
1515915625573801337,53,1,13.14,3,1,1,5
1515915625573803114,53,2,376.12,3,2,4,9
1515915625573808875,53,2,836.96,3,2,4,9
1515915625573809365,52,4,95.61,3,3,3,9
1515915625573809867,51,2,54.64,3,2,2,7
1515915625573810563,53,1,201.33,3,1,3,7
1515915625573812748,53,1,32.06,3,1,1,5
1515915625573816373,53,1,202.67,3,1,3,7
1515915625573816704,53,1,67.92,3,1,2,6
1515915625573817907,53,1,12.83,3,1,1,5
1515915625573818804,53,1,204.29,3,1,3,7
1515915625573819286,53,1,33.19,3,1,2,6
1515915625573819839,53,2,256.34,3,2,3,8
1515915625573823420,43,3,39.06,3,3,2,8
1515915625573823770,53,1,609.6,3,1,4,8
1515915625573828151,42,3,1089.3700000000001,3,3,4,10
1515915625573838900,53,2,68.58,3,2,2,7
1515915625573847324,53,1,96.37,3,1,3,7
1515915625573852208,53,2,102.66,3,2,3,8
1515915625573855539,53,1,274.4,3,1,3,7
1515915625573856488,53,3,78.57000000000001,3,3,2,8
1515915625573859644,53,1,31.11,3,1,1,5
1515915625573861442,53,1,479.51,3,1,4,8
1515915625573864233,53,1,37.98,3,1,2,6
1515915625573870198,52,1,45.24,3,1,2,6
1515915625573880004,53,2,58.42,3,2,2,7
1515915625573880494,13,4,14.219999999999999,4,3,1,8
1515915625573880714,1,3,39.3,4,3,2,9
1515915625573882890,53,2,214.66,3,2,3,8
1515915625573884587,53,1,12.51,3,1,1,5
1515915625573884873,53,1,43.11,3,1,2,6
1515915625573887652,53,1,84.89,3,1,2,6
1515915625573888732,53,3,608.01,3,3,4,10
1515915625573889351,53,2,919.04,3,2,4,9
1515915625573889971,53,1,349.46,3,1,4,8
1515915625573891696,53,1,10.87,3,1,1,5
1515915625573894761,53,1,32.71,3,1,2,6
1515915625573895581,47,1,70.95,3,1,2,6
1515915625573929454,20,1,163.48,4,1,3,8
1515915625573931209,53,1,229.38,3,1,3,7
1515915625573931965,53,1,226.84,3,1,3,7
1515915625573938419,53,1,9.35,3,1,1,5
1515915625573938422,53,1,609.6,3,1,4,8
1515915625573941753,53,1,32.22,3,1,1,5
1515915625573948035,53,1,87.51,3,1,2,6
1515915625573951970,53,1,201.33,3,1,3,7
1515915625573952376,52,4,1883.08,3,3,4,10
1515915625573954309,53,1,51.33,3,1,2,6
1515915625573955003,50,2,159.18,3,2,3,8
1515915625573955971,52,4,223.04,3,3,3,9
1515915625573957954,44,1,250.38,3,1,3,7
1515915625573960797,53,1,499.54,3,1,4,8
1515915625573967498,53,1,170.0,3,1,3,7
1515915625573973719,53,1,220.95,3,1,3,7
1515915625573973823,53,1,486.81,3,1,4,8
1515915625573978125,53,1,27.62,3,1,1,5
1515915625573981557,53,1,339.51,3,1,4,8
1515915625573985306,26,3,96.66,4,3,3,10
1515915625573988867,53,3,823.1999999999999,3,3,4,10
1515915625573989719,53,1,170.0,3,1,3,7
1515915625574009341,53,1,349.46,3,1,4,8
1515915625574015068,53,1,18.1,3,1,1,5
1515915625574016472,39,1,839.75,3,1,4,8
1515915625574018593,40,4,880.71,3,3,4,10
1515915625574031850,22,4,856.4,4,3,4,11
1515915625574034454,1,6,704.3000000000001,4,4,4,12
1515915625574035966,33,3,346.20000000000005,4,3,4,11
1515915625574044570,52,1,478.75,3,1,4,8
1515915625574048688,53,1,519.56,3,1,4,8
1515915625574054653,49,3,130.71,3,3,3,9
1515915625574054909,35,1,1.57,4,1,1,6
1515915625574058133,48,2,933.04,3,2,4,9
1515915625574058341,53,1,70.16,3,1,2,6
1515915625574060831,53,1,294.41,3,1,4,8
1515915625574068583,52,4,2078.24,3,3,4,10
1515915625574073378,48,1,94.06,3,1,3,7
1515915625574075285,36,1,82.97,3,1,2,6
1515915625574076357,53,1,299.41,3,1,4,8
1515915625574078913,25,1,167.0,4,1,3,8
1515915625574085155,52,1,269.4,3,1,3,7
1515915625574085805,52,1,294.41,3,1,4,8
1515915625574086967,52,3,878.49,3,3,4,10
1515915625574090422,52,1,466.52,3,1,4,8
1515915625574093190,52,1,40.32,3,1,2,6
1515915625574103864,52,4,113.8,3,3,3,9
1515915625574105229,51,2,112.7,3,2,3,8
1515915625574105967,52,1,373.46,3,1,4,8
1515915625574113371,51,1,16.51,3,1,1,5
1515915625574116594,52,1,29.57,3,1,1,5
1515915625574118472,52,1,51.27,3,1,2,6
1515915625574118661,52,1,27.62,3,1,1,5
1515915625574119006,52,2,102.54,3,2,3,8
1515915625574127024,52,2,405.96,3,2,4,9
1515915625574127603,52,2,899.02,3,2,4,9
1515915625574127609,52,2,107.9,3,2,3,8
1515915625574127707,49,2,871.4,3,2,4,9
1515915625574128444,52,2,19.68,3,2,1,6
1515915625574130048,52,1,577.6,3,1,4,8
1515915625574130123,52,1,72.38,3,1,2,6
1515915625574134776,52,3,30.150000000000002,3,3,1,7
1515915625574138140,52,2,428.2,3,2,4,9
1515915625574139607,52,1,32.22,3,1,1,5
1515915625574143238,45,2,839.03,3,2,4,9
1515915625574143315,52,1,23.57,3,1,1,5
1515915625574149271,52,3,598.11,3,3,4,10
1515915625574150138,39,2,228.26000000000002,3,2,3,8
1515915625574152014,52,5,264.5,3,4,3,10
1515915625574164445,52,1,16.83,3,1,1,5
1515915625574164815,52,2,169.78,3,2,3,8
1515915625574166324,52,3,40.95,3,3,2,8
1515915625574171698,52,1,294.41,3,1,4,8
1515915625574172291,52,1,10.21,3,1,1,5
1515915625574172829,52,1,10.16,3,1,1,5
1515915625574172881,52,1,40.79,3,1,2,6
1515915625574173269,52,1,40.79,3,1,2,6
1515915625574174078,52,2,59.04,3,2,2,7
1515915625574174813,52,2,79.02,3,2,2,7
1515915625574177197,52,3,463.63,3,3,4,10
1515915625574177453,21,1,322.57,4,1,4,9
1515915625574178037,48,1,20.71,3,1,1,5
1515915625574182626,52,2,959.02,3,2,4,9
1515915625574187665,52,2,46.96,3,2,2,7
1515915625574187842,52,2,568.92,3,2,4,9
1515915625574189638,30,1,51.33,4,1,2,7
1515915625574194677,50,1,202.67,3,1,3,7
1515915625574195619,52,1,42.98,3,1,2,6
1515915625574197839,52,1,94.06,3,1,3,7
1515915625574204580,52,1,259.38,3,1,3,7
1515915625574235684,32,3,400.88,4,3,4,11
1515915625574236672,48,1,64.48,3,1,2,6
1515915625574239240,52,1,155.43,3,1,3,7
1515915625574242092,52,1,33.19,3,1,2,6
1515915625574248924,52,1,397.48,3,1,4,8
1515915625574269065,52,4,168.24,3,3,3,9
1515915625574270817,52,1,190.73,3,1,3,7
1515915625574271901,52,1,190.73,3,1,3,7
1515915625574272230,52,2,50.8,3,2,2,7
1515915625574274485,52,1,24.6,3,1,1,5
1515915625574275138,52,1,12.51,3,1,1,5
1515915625574275911,49,1,292.83,3,1,4,8
1515915625574275954,52,1,466.52,3,1,4,8
1515915625574531599,32,2,62.86,4,2,2,8
1515915625574542671,52,1,519.56,3,1,4,8
1515915625574738867,52,5,418.54,3,4,4,11
1515915625574766662,52,1,40.67,3,1,2,6
1515915625575147885,52,1,17.79,3,1,1,5
1515915625575260872,52,1,28.1,3,1,1,5
1515915625575308318,52,1,362.06,3,1,4,8
1515915625575331024,52,1,87.16,3,1,2,6
1515915625575478010,52,1,441.49,3,1,4,8
1515915625575563032,52,1,269.4,3,1,3,7
1515915625575639740,52,2,753.6700000000001,3,2,4,9
1515915625575674198,52,1,329.43,3,1,4,8
1515915625575914416,52,1,274.4,3,1,3,7
1515915625575942740,40,1,397.48,3,1,4,8
1515915625576032331,39,2,770.94,3,2,4,9
1515915625576039178,44,1,30.79,3,1,1,5
1515915625576090388,52,3,85.22999999999999,3,3,2,8
1515915625576116423,52,1,46.98,3,1,2,6
1515915625576248008,51,1,292.83,3,1,4,8
1515915625576262390,52,1,397.48,3,1,4,8
1515915625576262405,52,2,43.66,3,2,2,7
1515915625576316362,52,1,609.6,3,1,4,8
1515915625576504212,52,1,9.92,3,1,1,5
1515915625576706449,52,1,404.49,3,1,4,8
1515915625576906395,52,1,29.22,3,1,1,5
1515915625577152091,52,2,618.82,3,2,4,9
1515915625577394654,51,3,609.87,3,3,4,10
1515915625577401926,52,1,86.16,3,1,2,6
1515915625577496771,52,4,1289.08,3,3,4,10
1515915625577622395,25,3,1278.9099999999999,4,3,4,11
1515915625577643741,52,1,32.06,3,1,1,5
1515915625577705471,52,1,164.33,3,1,3,7
1515915625577764223,52,1,259.38,3,1,3,7
1515915625577920896,51,4,1032.4099999999999,3,3,4,10
1515915625577978352,52,1,449.51,3,1,4,8
1515915625578132578,52,1,577.6,3,1,4,8
1515915625578203744,52,1,26.57,3,1,1,5
1515915625578455444,52,4,1738.0,3,3,4,10
1515915625578519653,49,4,1856.04,3,3,4,10
1515915625578552539,52,2,836.96,3,2,4,9
1515915625578591396,41,1,46.67,3,1,2,6
1515915625579035641,52,2,326.02,3,2,4,9
1515915625579052628,52,1,39.51,3,1,2,6
1515915625579090428,52,2,79.02,3,2,2,7
1515915625579292757,47,7,1324.09,3,4,4,11
1515915625579539194,52,1,269.4,3,1,3,7
1515915625579669357,49,2,174.32,3,2,3,8
1515915625579703305,50,3,609.25,3,3,4,10
1515915625579789032,52,1,1.57,3,1,1,5
1515915625579869782,36,5,111.1,3,4,3,10
1515915625579888766,52,1,32.22,3,1,1,5
1515915625579945482,52,1,202.67,3,1,3,7
1515915625579960702,52,5,1014.5,3,4,4,11
1515915625580140180,52,1,496.54,3,1,4,8
1515915625580329826,47,4,60.24,3,3,2,8
1515915625580337027,52,1,457.51,3,1,4,8
1515915625580344515,52,1,284.46,3,1,3,7
1515915625580466323,38,2,629.94,3,2,4,9
1515915625580571698,36,4,530.0799999999999,3,3,4,10
1515915625580903818,52,5,750.11,3,4,4,11
1515915625580936012,52,2,1079.14,3,2,4,9
1515915625581150239,52,1,32.06,3,1,1,5
1515915625581260073,52,2,28.16,3,2,1,6
1515915625581520237,51,1,211.59,3,1,3,7
1515915625581943671,52,1,336.57,3,1,4,8
1515915625582067518,52,1,26.19,3,1,1,5
1515915625582106616,52,1,107.16,3,1,3,7
1515915625582141827,50,2,927.03,3,2,4,9
1515915625582158314,52,1,29.52,3,1,1,5
1515915625582519736,52,1,486.81,3,1,4,8
1515915625582621719,51,5,120.64999999999999,3,4,3,10
1515915625582670012,52,1,577.6,3,1,4,8
1515915625582729840,52,1,18.57,3,1,1,5
1515915625582795830,52,2,263.67,3,2,3,8
1515915625582879901,43,2,174.32,3,2,3,8
1515915625583083982,52,1,30.71,3,1,1,5
1515915625583127841,52,3,1246.6200000000001,3,3,4,10
1515915625583155551,52,1,292.83,3,1,4,8
1515915625583196434,51,1,214.1,3,1,3,7
1515915625583349255,52,1,11.9,3,1,1,5
1515915625583354685,52,2,550.78,3,2,4,9
1515915625583388780,50,1,236.97,3,1,3,7
1515915625583428747,52,1,236.97,3,1,3,7
1515915625583533583,52,1,42.57,3,1,2,6
1515915625583615231,52,3,768.35,3,3,4,10
1515915625583746651,52,1,349.46,3,1,4,8
1515915625583941699,52,2,53.489999999999995,3,2,2,7
1515915625584271627,52,1,13.49,3,1,1,5
1515915625584324716,52,2,46.66,3,2,2,7
1515915625584370973,52,1,57.62,3,1,2,6
1515915625584404738,52,1,292.83,3,1,4,8
1515915625584449552,51,1,292.83,3,1,4,8
1515915625584549237,32,1,103.83,4,1,3,8
1515915625584882786,47,2,794.96,3,2,4,9
1515915625585323971,52,2,221.96,3,2,3,8
1515915625585830112,52,1,349.46,3,1,4,8
1515915625586350862,52,1,524.92,3,1,4,8
1515915625587018414,33,5,414.85,4,4,4,12
1515915625587561349,51,2,663.18,3,2,4,9
1515915625588389401,51,1,34.56,3,1,2,6
1515915625588766425,19,6,1582.33,4,4,4,12
1515915625589032583,51,1,32.22,3,1,1,5
1515915625590178664,49,1,93.43,3,1,3,7
1515915625590870511,51,1,58.25,3,1,2,6
1515915625590886418,51,1,188.41,3,1,3,7
1515915625590886498,51,1,188.41,3,1,3,7
1515915625590887140,46,1,397.48,3,1,4,8
1515915625590887889,51,1,149.62,3,1,3,7
1515915625590889087,51,1,41.9,3,1,2,6
1515915625590900179,51,1,519.56,3,1,4,8
1515915625590903350,51,1,30.83,3,1,1,5
1515915625590903755,51,1,12.62,3,1,1,5
1515915625590905486,51,1,49.11,3,1,2,6
1515915625590912229,51,2,36.5,3,2,2,7
1515915625590914665,51,2,1219.2,3,2,4,9
1515915625590915113,51,1,18.25,3,1,1,5
1515915625590922687,50,1,7.86,3,1,1,5
1515915625590922755,51,1,192.51,3,1,3,7
1515915625590925731,47,3,78.57000000000001,3,3,2,8
1515915625590926556,51,1,203.02,3,1,3,7
1515915625590927724,51,1,31.11,3,1,1,5
1515915625590933602,51,1,11.03,3,1,1,5
1515915625590947423,51,2,585.66,3,2,4,9
1515915625590948806,51,2,784.95,3,2,4,9
1515915625590955070,40,1,656.63,3,1,4,8
1515915625590957135,6,1,188.06,4,1,3,8
1515915625590960207,51,1,292.83,3,1,4,8
1515915625590960447,51,2,949.05,3,2,4,9
1515915625590963571,28,3,1551.22,4,3,4,11
1515915625590964537,26,4,1821.0700000000002,4,3,4,11
1515915625590966262,51,5,227.8,3,4,3,10
1515915625590969403,51,2,907.96,3,2,4,9
1515915625590971416,51,1,397.48,3,1,4,8
1515915625590971626,51,1,26.7,3,1,1,5
1515915625590972379,51,1,5.0,3,1,1,5
1515915625590975689,5,5,3059.03,4,4,4,12
1515915625590979006,49,5,1013.3499999999999,3,4,4,11
1515915625590979945,51,1,599.6,3,1,4,8
1515915625590980086,51,1,599.6,3,1,4,8
1515915625590980401,51,2,158.97,3,2,3,8
1515915625590982148,51,1,214.1,3,1,3,7
1515915625590985341,50,4,509.26,3,3,4,10
1515915625590987176,51,2,760.9300000000001,3,2,4,9
1515915625590987665,51,1,32.06,3,1,1,5
1515915625590993507,29,3,489.24,4,3,4,11
1515915625590994372,51,1,298.76,3,1,4,8
1515915625590995498,51,1,33.08,3,1,2,6
1515915625590997191,51,2,44.28,3,2,2,7
1515915625591004630,51,3,294.75,3,3,4,10
1515915625591022294,51,1,23.57,3,1,1,5
1515915625591022557,41,4,124.77,3,3,3,9
1515915625591022857,51,3,368.58,3,3,4,10
1515915625591023187,34,4,326.16,4,3,4,11
1515915625591023268,51,1,519.56,3,1,4,8
1515915625591026251,51,1,51.33,3,1,2,6
1515915625591026794,50,2,240.54,3,2,3,8
1515915625591031315,51,1,15.08,3,1,1,5
1515915625591031528,51,1,23.48,3,1,1,5
1515915625591033328,51,2,889.19,3,2,4,9
1515915625591034266,51,4,616.24,3,3,4,10
1515915625591042176,51,1,28.43,3,1,1,5
1515915625591049372,51,1,370.46,3,1,4,8
1515915625591051545,51,1,125.4,3,1,3,7
1515915625591052487,51,2,740.92,3,2,4,9
1515915625591052996,51,1,48.84,3,1,2,6
1515915625591053381,50,1,86.21,3,1,2,6
1515915625591055036,51,1,38.83,3,1,2,6
1515915625591055385,51,1,38.83,3,1,2,6
1515915625591055703,51,1,125.4,3,1,3,7
1515915625591056433,51,3,715.9399999999999,3,3,4,10
1515915625591058157,51,1,15.73,3,1,1,5
1515915625591058449,51,1,35.1,3,1,2,6
1515915625591059002,50,2,798.96,3,2,4,9
1515915625591059561,51,1,73.81,3,1,2,6
1515915625591060867,25,5,1598.53,4,4,4,12
1515915625591062029,51,1,259.38,3,1,3,7
1515915625591067434,51,1,92.67,3,1,3,7
1515915625591068953,50,1,202.67,3,1,3,7
1515915625591069142,51,1,12.08,3,1,1,5
1515915625591072195,51,2,66.16,3,2,2,7
1515915625591092920,51,1,591.59,3,1,4,8
1515915625591107066,51,1,397.48,3,1,4,8
1515915625591109893,51,3,371.37,3,3,4,10
1515915625591113012,51,1,27.62,3,1,1,5
1515915625591116908,51,1,14.1,3,1,1,5
1515915625591116917,47,2,798.96,3,2,4,9
1515915625591117352,50,1,21.43,3,1,1,5
1515915625591120176,51,2,53.62,3,2,2,7
1515915625591124216,45,2,588.82,3,2,4,9
1515915625591124320,51,2,1082.12,3,2,4,9
1515915625591127346,39,4,1589.92,3,3,4,10
1515915625591132912,51,1,29.22,3,1,1,5
1515915625591137193,51,1,210.19,3,1,3,7
1515915625591138894,51,1,539.57,3,1,4,8
1515915625591139482,51,1,37.16,3,1,2,6
1515915625591141235,47,1,307.43,3,1,4,8
1515915625591141745,29,2,1201.2,4,2,4,10
1515915625591143714,50,2,672.22,3,2,4,9
1515915625591144464,51,1,609.6,3,1,4,8
1515915625591144594,51,3,934.0899999999999,3,3,4,10
1515915625591146887,51,1,22.22,3,1,1,5
1515915625591146902,51,7,322.91,3,4,4,11
1515915625591147026,51,1,45.24,3,1,2,6
1515915625591147316,51,1,53.17,3,1,2,6
1515915625591148892,51,2,44.44,3,2,2,7
1515915625591151151,51,1,449.51,3,1,4,8
1515915625591151934,51,1,19.52,3,1,1,5
1515915625591153732,51,1,403.46,3,1,4,8
1515915625591156206,51,1,16.51,3,1,1,5
1515915625591159171,51,1,399.48,3,1,4,8
1515915625591160122,51,1,600.6,3,1,4,8
1515915625591161061,51,1,38.1,3,1,2,6
1515915625591165424,49,1,94.1,3,1,3,7
1515915625591167114,36,2,165.94,3,2,3,8
1515915625591168539,51,1,449.51,3,1,4,8
1515915625591169465,51,1,397.48,3,1,4,8
1515915625591170693,51,1,466.52,3,1,4,8
1515915625591171829,51,1,13.33,3,1,1,5
1515915625591191462,51,1,64.32,3,1,2,6
1515915625591193876,44,1,154.32,3,1,3,7
1515915625591195929,51,2,32.7,3,2,2,7
1515915625591196159,51,3,105.14999999999999,3,3,3,9
1515915625591196667,51,2,64.44,3,2,2,7
1515915625591197271,51,1,331.59,3,1,4,8
1515915625591198644,50,1,19.52,3,1,1,5
1515915625591198796,51,1,581.4,3,1,4,8
1515915625591204708,50,4,331.88,3,3,4,10
1515915625591211576,51,1,294.41,3,1,4,8
1515915625591212247,28,2,272.1,4,2,3,9
1515915625591212401,51,2,25.78,3,2,1,6
1515915625591212434,51,2,336.5,3,2,4,9
1515915625591214934,11,2,1280.73,4,2,4,10
1515915625591216256,51,1,53.33,3,1,2,6
1515915625591218303,51,3,386.37,3,3,4,10
1515915625591219257,51,1,519.56,3,1,4,8
1515915625591220052,51,2,1169.18,3,2,4,9
1515915625591220684,51,1,292.83,3,1,4,8
1515915625591228437,51,1,292.83,3,1,4,8
1515915625591229743,51,1,321.7,3,1,4,8
1515915625591231867,51,1,120.75,3,1,3,7
1515915625591237325,51,2,104.98,3,2,3,8
1515915625591239769,51,1,292.83,3,1,4,8
1515915625591241594,51,3,50.489999999999995,3,3,2,8
1515915625591242575,51,1,292.83,3,1,4,8
1515915625591243973,51,1,31.11,3,1,1,5
1515915625591244876,48,2,585.66,3,2,4,9
1515915625591245174,51,3,31.799999999999997,3,3,1,7
1515915625591247989,51,1,42.78,3,1,2,6
1515915625591251821,51,2,35.24,3,2,2,7
1515915625591258138,45,2,159.36,3,2,3,8
1515915625591258156,51,1,28.1,3,1,1,5
1515915625591258380,50,1,397.48,3,1,4,8
1515915625591259192,51,2,730.88,3,2,4,9
1515915625591260867,51,3,346.20000000000005,3,3,4,10
1515915625591270592,50,1,128.79,3,1,3,7
1515915625591271422,50,1,214.1,3,1,3,7
1515915625591272422,50,1,9.84,3,1,1,5
1515915625591274843,46,1,490.54,3,1,4,8
1515915625591275902,50,4,40.0,3,3,2,8
1515915625591277886,50,1,146.4,3,1,3,7
1515915625591278229,50,1,78.89,3,1,2,6
1515915625591280057,29,3,195.24,4,3,3,10
1515915625591284693,50,1,251.38,3,1,3,7
1515915625591287066,50,1,294.41,3,1,4,8
1515915625591290089,50,1,32.22,3,1,1,5
1515915625591290538,50,2,33.34,3,2,2,7
1515915625591300401,50,3,87.66,3,3,2,8
1515915625591300414,50,1,490.54,3,1,4,8
1515915625591302335,50,1,466.52,3,1,4,8
1515915625591310186,50,2,554.2,3,2,4,9
1515915625591312747,50,3,144.81,3,3,3,9
1515915625591313860,50,1,482.52,3,1,4,8
1515915625591316379,41,2,585.66,3,2,4,9
1515915625591317449,50,1,43.33,3,1,2,6
1515915625591318230,32,3,232.94,4,3,3,10
1515915625591319070,50,1,309.41,3,1,4,8
1515915625591321996,50,1,189.17,3,1,3,7
1515915625591324557,50,1,11.9,3,1,1,5
1515915625591324678,50,1,26.52,3,1,1,5
1515915625591324909,50,2,56.2,3,2,2,7
1515915625591325109,50,1,292.83,3,1,4,8
1515915625591326405,42,3,878.49,3,3,4,10
1515915625591327130,29,4,126.36,4,3,3,10
1515915625591332945,50,1,397.48,3,1,4,8
1515915625591337779,50,2,64.12,3,2,2,7
1515915625591339070,50,1,336.57,3,1,4,8
1515915625591342071,50,1,294.41,3,1,4,8
1515915625591354484,50,1,9.81,3,1,1,5
1515915625591356704,50,3,462.18,3,3,4,10
1515915625591357160,50,1,40.67,3,1,2,6
1515915625591361539,50,1,13.76,3,1,1,5
1515915625591361552,50,1,26.46,3,1,1,5
1515915625591368048,50,1,274.4,3,1,3,7
1515915625591370418,50,1,149.05,3,1,3,7
1515915625591372135,50,1,259.38,3,1,3,7
1515915625591381410,50,2,111.74,3,2,3,8
1515915625591381612,50,1,201.33,3,1,3,7
1515915625591384882,50,1,77.14,3,1,2,6
1515915625591392674,50,2,127.88,3,2,3,8
1515915625591393212,50,1,127.08,3,1,3,7
1515915625591394758,50,1,136.19,3,1,3,7
1515915625591399572,50,1,50.11,3,1,2,6
1515915625591425563,50,3,1192.44,3,3,4,10
1515915625591438249,50,1,210.68,3,1,3,7
1515915625591438870,50,1,22.79,3,1,1,5
1515915625591443767,50,2,214.6,3,2,3,8
1515915625591446015,50,1,16.19,3,1,1,5
1515915625591448203,50,3,321.9,3,3,4,10
1515915625591448958,48,1,77.73,3,1,2,6
1515915625591452134,50,1,29.06,3,1,1,5
1515915625591453723,50,1,122.86,3,1,3,7
1515915625591454306,13,1,36.52,4,1,2,7
1515915625591461537,50,1,55.65,3,1,2,6
1515915625591462870,50,2,27.3,3,2,1,6
1515915625591462960,50,1,29.22,3,1,1,5
1515915625591463356,50,1,16.33,3,1,1,5
1515915625591463410,50,2,106.42,3,2,3,8
1515915625591465851,39,2,93.5,3,2,3,8
1515915625591465971,50,5,453.71,3,4,4,11
1515915625591468507,50,2,211.74,3,2,3,8
1515915625591473127,45,1,45.24,3,1,2,6
1515915625591475311,50,1,14.86,3,1,1,5
1515915625591477423,50,1,52.33,3,1,2,6
1515915625591478227,50,1,364.46,3,1,4,8
1515915625591478265,35,3,412.89,4,3,4,11
1515915625591480864,50,2,548.8,3,2,4,9
1515915625591481325,36,2,126.66,3,2,3,8
1515915625591483022,37,1,162.95,3,1,3,7
1515915625591519929,50,1,201.33,3,1,3,7
1515915625591525737,48,2,973.62,3,2,4,9
1515915625591525831,49,4,1134.46,3,3,4,10
1515915625591526021,50,3,131.82,3,3,3,9
1515915625591526327,50,1,154.32,3,1,3,7
1515915625591528064,50,1,519.56,3,1,4,8
1515915625591529318,47,3,492.99,3,3,4,10
1515915625591529403,50,5,2493.7799999999997,3,4,4,11
1515915625591529782,8,6,136.17,4,4,3,11
1515915625591530816,50,1,87.56,3,1,2,6
1515915625591532120,30,4,1333.88,4,3,4,11
1515915625591532172,50,1,32.46,3,1,2,6
1515915625591536128,23,2,618.82,4,2,4,10
1515915625591536175,50,1,418.48,3,1,4,8
1515915625591539199,50,1,61.29,3,1,2,6
1515915625591540731,50,17,2970.91,3,4,4,11
1515915625591544795,49,5,2597.7999999999997,3,4,4,11
1515915625591548456,50,2,33.58,3,2,2,7
1515915625591548773,50,3,1543.21,3,3,4,10
1515915625591554775,17,2,174.32,4,2,3,9
1515915625591556805,50,1,539.57,3,1,4,8
1515915625591558819,50,2,536.34,3,2,4,9
1515915625591562462,50,1,43.27,3,1,2,6
1515915625591563245,50,1,82.41,3,1,2,6
1515915625591563937,50,1,64.48,3,1,2,6
1515915625591565299,8,1,226.84,4,1,3,8
1515915625591566382,50,1,78.37,3,1,2,6
1515915625591566581,50,2,315.14,3,2,4,9
1515915625591567191,36,1,176.17,3,1,3,7
1515915625591570491,50,1,214.1,3,1,3,7
1515915625591571684,50,1,16.19,3,1,1,5
1515915625591572204,50,2,3.14,3,2,1,6
1515915625591572296,46,1,56.27,3,1,2,6
1515915625591574921,48,2,899.02,3,2,4,9
1515915625591574996,50,1,587.6,3,1,4,8
1515915625591575834,50,1,43.11,3,1,2,6
1515915625591580610,50,1,600.6,3,1,4,8
1515915625591586427,50,2,698.92,3,2,4,9
1515915625591588627,50,2,209.02,3,2,3,8
1515915625591589480,46,3,91.47999999999999,3,3,3,9
1515915625591589597,50,1,397.48,3,1,4,8
1515915625591618206,50,1,34.06,3,1,2,6
1515915625591624905,50,2,402.66,3,2,4,9
1515915625591626014,44,1,466.52,3,1,4,8
1515915625591626353,1,3,833.5,4,3,4,11
1515915625591626694,44,2,810.98,3,2,4,9
1515915625591628592,50,3,48.35,3,3,2,8
1515915625591635244,49,2,113.34,3,2,3,8
1515915625591640561,50,2,98.2,3,2,3,8
1515915625591641733,6,3,890.06,4,3,4,11
1515915625591643866,50,3,116.49,3,3,3,9
1515915625591646977,50,5,1747.3,3,4,4,11
1515915625591653554,50,3,110.49,3,3,3,9
1515915625591654298,45,2,1795.58,3,2,4,9
1515915625591657096,50,2,765.88,3,2,4,9
1515915625591658170,37,6,464.40000000000003,3,4,4,11
1515915625591658775,50,1,259.38,3,1,3,7
1515915625591659276,50,2,23.72,3,2,1,6
1515915625591659523,27,49,6629.87,4,4,4,12
1515915625591662715,50,1,373.02,3,1,4,8
1515915625591665177,50,1,31.75,3,1,1,5
1515915625591666314,49,2,282.75,3,2,3,8
1515915625591669416,50,1,6.79,3,1,1,5
1515915625591677747,50,1,370.46,3,1,4,8
1515915625591681214,50,1,577.6,3,1,4,8
1515915625591681219,43,1,247.4,3,1,3,7
1515915625591684081,49,1,49.86,3,1,2,6
1515915625591689274,49,1,415.54,3,1,4,8
1515915625591693333,49,1,13.57,3,1,1,5
1515915625591699469,27,5,1584.13,4,4,4,12
1515915625591699484,49,1,349.46,3,1,4,8
1515915625591703343,49,3,50.489999999999995,3,3,2,8
1515915625591703642,49,1,15.24,3,1,1,5
1515915625591703794,49,1,35.05,3,1,2,6
1515915625591711822,49,1,524.92,3,1,4,8
1515915625591712433,49,1,61.16,3,1,2,6
1515915625591712816,49,1,10.21,3,1,1,5
1515915625591714503,49,2,1504.44,3,2,4,9
1515915625591719570,17,2,150.58,4,2,3,9
1515915625591720546,49,3,143.82,3,3,3,9
1515915625591721598,49,2,228.26,3,2,3,8
1515915625591722077,49,1,95.52,3,1,3,7
1515915625591728898,49,1,752.22,3,1,4,8
1515915625591729856,49,2,64.44,3,2,2,7
1515915625591730231,49,1,471.52,3,1,4,8
1515915625591730417,47,1,471.52,3,1,4,8
1515915625591731019,49,1,457.51,3,1,4,8
1515915625591732447,49,2,30.2,3,2,1,6
1515915625591734111,48,2,865.0,3,2,4,9
1515915625591738242,49,1,482.52,3,1,4,8
1515915625591738257,49,1,11.11,3,1,1,5
1515915625591739791,49,1,25.29,3,1,1,5
1515915625591740215,49,3,360.81,3,3,4,10
1515915625591742495,49,3,642.24,3,3,4,10
1515915625591743024,49,1,17.62,3,1,1,5
1515915625591744061,49,1,13.65,3,1,1,5
1515915625591744480,7,1,36.83,4,1,2,7
1515915625591745530,46,1,397.48,3,1,4,8
1515915625591746425,47,4,107.32,3,3,3,9
1515915625591749217,40,9,943.74,3,4,4,11
1515915625591752048,49,1,160.16,3,1,3,7
1515915625591752406,49,1,22.7,3,1,1,5
1515915625591756174,49,2,308.64,3,2,4,9
1515915625591759347,47,2,973.62,3,2,4,9
1515915625591759377,49,1,14.6,3,1,1,5
1515915625591759442,49,1,202.67,3,1,3,7
1515915625591764456,21,1,33.97,4,1,2,7
1515915625591766341,49,1,5.0,3,1,1,5
1515915625591770582,49,1,115.4,3,1,3,7
1515915625591774000,49,1,43.57,3,1,2,6
1515915625591776075,49,2,70.2,3,2,2,7
1515915625591777706,49,1,365.41,3,1,4,8
1515915625591779465,49,1,415.54,3,1,4,8
1515915625591780643,49,1,43.33,3,1,2,6
1515915625591785039,49,1,226.84,3,1,3,7
1515915625591790012,49,1,41.32,3,1,2,6
1515915625591795399,49,2,242.2,3,2,3,8
1515915625591797363,49,1,26.13,3,1,1,5
1515915625591797989,49,3,608.01,3,3,4,10
1515915625591799919,47,1,27.78,3,1,1,5
1515915625591800537,49,5,32.45,3,4,2,9
1515915625591800596,49,1,35.25,3,1,2,6
1515915625591802192,49,1,397.48,3,1,4,8
1515915625591802805,47,1,87.51,3,1,2,6
1515915625591805005,48,1,33.97,3,1,2,6
1515915625591807715,49,2,102.66,3,2,3,8
1515915625591811496,49,1,35.92,3,1,2,6
1515915625591813904,42,1,346.08,3,1,4,8
1515915625591815954,49,1,958.57,3,1,4,8
1515915625591817190,49,2,86.22,3,2,2,7
1515915625591820296,17,1,397.48,4,1,4,9
1515915625591820425,48,1,10.87,3,1,1,5
1515915625591822539,49,1,33.97,3,1,2,6
1515915625591822859,5,3,92.92,4,3,3,10
1515915625591826086,49,1,20.95,3,1,1,5
1515915625591826842,28,1,122.57,4,1,3,8
1515915625591843869,49,3,1288.5900000000001,3,3,4,10
1515915625591844398,49,2,55.68,3,2,2,7
1515915625591847130,49,1,9.35,3,1,1,5
1515915625591848359,49,1,43.65,3,1,2,6
1515915625591848923,49,1,399.48,3,1,4,8
1515915625591850439,22,1,656.63,4,1,4,9
1515915625591851091,49,1,292.83,3,1,4,8
1515915625591853286,49,1,21.75,3,1,1,5
1515915625591853867,49,2,943.04,3,2,4,9
1515915625591855798,12,1,201.33,4,1,3,8
1515915625591857469,49,2,128.96,3,2,3,8
1515915625591857639,49,1,22.22,3,1,1,5
1515915625591858713,49,3,1192.44,3,3,4,10
1515915625591859270,49,1,603.62,3,1,4,8
1515915625591861497,49,1,33.35,3,1,2,6
1515915625591862361,49,3,346.20000000000005,3,3,4,10
1515915625591866909,49,1,24.95,3,1,1,5
1515915625591866938,49,1,24.95,3,1,1,5
1515915625591867605,49,1,30.4,3,1,1,5
1515915625591868169,49,1,397.48,3,1,4,8
1515915625591868585,49,2,1225.2,3,2,4,9
1515915625591869816,49,1,55.16,3,1,2,6
1515915625591872548,49,1,499.54,3,1,4,8
1515915625591874008,49,1,294.41,3,1,4,8
1515915625591874305,5,10,2366.7,4,4,4,12
1515915625591875899,49,1,587.6,3,1,4,8
1515915625591876500,49,1,203.02,3,1,3,7
1515915625591882846,47,1,373.02,3,1,4,8
1515915625591883667,49,1,53.9,3,1,2,6
1515915625591888418,49,1,87.16,3,1,2,6
1515915625591888786,45,6,89.04,3,4,2,9
1515915625591890393,49,2,405.34,3,2,4,9
1515915625591890886,48,2,1219.2,3,2,4,9
1515915625591890965,49,3,1192.44,3,3,4,10
1515915625591892011,49,2,235.5,3,2,3,8
1515915625591892296,48,1,314.68,3,1,4,8
1515915625591892600,49,2,317.14,3,2,4,9
1515915625591896270,49,1,115.4,3,1,3,7
1515915625591898046,48,4,138.92,3,3,3,9
1515915625591898142,49,1,466.52,3,1,4,8
1515915625591902333,49,1,104.86,3,1,3,7
1515915625591918501,49,1,55.87,3,1,2,6
1515915625591920218,45,8,501.64,3,4,4,11
1515915625591922316,49,1,16.11,3,1,1,5
1515915625591922418,49,1,277.41,3,1,3,7
1515915625591925290,47,2,453.68,3,2,4,9
1515915625591926448,49,1,77.73,3,1,2,6
1515915625591929374,44,1,304.41,3,1,4,8
1515915625591931224,49,7,594.23,3,4,4,11
1515915625591931567,49,1,253.38,3,1,3,7
1515915625591933046,48,1,77.32,3,1,2,6
1515915625591933074,49,2,154.64,3,2,3,8
1515915625591933555,49,4,1101.6,3,3,4,10
1515915625591938417,49,4,821.0,3,3,4,10
1515915625591939063,49,1,35.1,3,1,2,6
1515915625591939084,49,1,56.41,3,1,2,6
1515915625591940835,49,1,15.24,3,1,1,5
1515915625591941787,21,1,523.56,4,1,4,9
1515915625591944100,49,2,568.92,3,2,4,9
1515915625591947915,49,2,711.12,3,2,4,9
1515915625591949079,49,1,212.06,3,1,3,7
1515915625591951072,49,1,26.98,3,1,1,5
1515915625591956567,48,4,654.08,3,3,4,10
1515915625591957702,47,1,274.4,3,1,3,7
1515915625591959996,49,2,794.96,3,2,4,9
1515915625591960204,49,1,397.48,3,1,4,8
1515915625591960483,49,1,397.48,3,1,4,8
1515915625591960768,49,1,29.49,3,1,1,5
1515915625591960875,49,1,205.25,3,1,3,7
1515915625591961598,43,1,482.52,3,1,4,8
1515915625591962435,49,2,88.26,3,2,2,7
1515915625591962795,49,2,44.44,3,2,2,7
1515915625591967673,49,3,40.71,3,3,2,8
1515915625591969108,49,2,1010.08,3,2,4,9
1515915625591969258,49,1,51.73,3,1,2,6
1515915625591970346,34,3,1762.8000000000002,4,3,4,11
1515915625591971882,43,1,14.6,3,1,1,5
1515915625591972163,49,1,399.48,3,1,4,8
1515915625591972605,49,4,339.56,3,3,4,10
1515915625591973201,49,2,798.96,3,2,4,9
1515915625591974567,49,1,418.48,3,1,4,8
1515915625591976158,49,1,52.87,3,1,2,6
1515915625591977652,49,1,41.6,3,1,2,6
1515915625591978235,49,2,32.28,3,2,2,7
1515915625591980662,49,1,292.83,3,1,4,8
1515915625591980856,49,1,104.86,3,1,3,7
1515915625591983378,49,1,519.56,3,1,4,8
1515915625591984564,49,1,415.54,3,1,4,8
1515915625591986297,49,1,68.57,3,1,2,6
1515915625591988664,49,2,69.67999999999999,3,2,2,7
1515915625591989143,49,2,59.14,3,2,2,7
1515915625591989678,35,4,303.04,4,3,4,11
1515915625591991170,48,2,42.46,3,2,2,7
1515915625592003178,49,4,59.44,3,3,2,8
1515915625592003951,49,1,72.86,3,1,2,6
1515915625592009918,48,2,298.1,3,2,4,9
1515915625592012466,49,1,201.33,3,1,3,7
1515915625592019415,49,1,13.02,3,1,1,5
1515915625592020759,49,1,86.27,3,1,2,6
1515915625592021106,49,1,136.05,3,1,3,7
1515915625592023177,49,1,18.1,3,1,1,5
1515915625592027918,49,3,221.43,3,3,3,9
1515915625592029159,13,1,20.13,4,1,1,6
1515915625592030709,1,2,97.4,4,2,3,9
1515915625592032178,49,1,174.44,3,1,3,7
1515915625592033532,49,1,58.25,3,1,2,6
1515915625592033563,49,2,620.82,3,2,4,9
1515915625592034807,49,2,585.66,3,2,4,9
1515915625592037243,30,2,794.96,4,2,4,10
1515915625592037955,49,1,33.97,3,1,2,6
1515915625592041432,49,1,32.22,3,1,1,5
1515915625592042749,38,1,331.41,3,1,4,8
1515915625592042788,49,2,155.12,3,2,3,8
1515915625592044180,49,4,97.67,3,3,3,9
1515915625592057413,49,6,67.38,3,4,2,9
1515915625592062524,49,2,49.24,3,2,2,7
1515915625592063026,49,1,633.3,3,1,4,8
1515915625592064771,49,1,55.41,3,1,2,6
1515915625592066196,49,1,399.48,3,1,4,8
1515915625592066816,48,2,147.62,3,2,3,8
1515915625592069104,49,2,597.52,3,2,4,9
1515915625592069563,49,1,399.48,3,1,4,8
1515915625592070992,49,2,78.0,3,2,2,7
1515915625592074387,49,1,294.41,3,1,4,8
1515915625592075490,49,1,294.41,3,1,4,8
1515915625592077529,49,1,29.52,3,1,1,5
1515915625592079034,49,2,41.58,3,2,2,7
1515915625592079060,49,1,28.11,3,1,1,5
1515915625592079139,49,4,331.88,3,3,4,10
1515915625592080850,49,1,122.86,3,1,3,7
1515915625592084998,49,1,89.4,3,1,2,6
1515915625592089091,48,1,449.51,3,1,4,8
1515915625592093752,48,1,13.86,3,1,1,5
1515915625592098213,48,1,11.27,3,1,1,5
1515915625592104800,5,2,155.46,4,2,3,9
1515915625592107360,48,1,67.97,3,1,2,6
1515915625592107458,48,1,397.48,3,1,4,8
1515915625592109325,48,1,397.48,3,1,4,8
1515915625592115334,48,1,17.49,3,1,1,5
1515915625592125894,48,1,114.76,3,1,3,7
1515915625592127703,48,2,428.2,3,2,4,9
1515915625592131528,48,1,397.48,3,1,4,8
1515915625592133854,48,1,23.49,3,1,1,5
1515915625592135608,48,1,107.16,3,1,3,7
1515915625592140991,10,1,204.29,4,1,3,8
1515915625592142196,48,3,878.49,3,3,4,10
1515915625592142461,48,1,599.6,3,1,4,8
1515915625592144694,48,1,310.41,3,1,4,8
1515915625592144824,48,1,482.52,3,1,4,8
1515915625592145375,48,5,152.7,3,4,3,10
1515915625592145489,32,1,11.52,4,1,1,6
1515915625592147018,48,1,214.1,3,1,3,7
1515915625592147869,41,1,32.22,3,1,1,5
1515915625592150261,48,1,55.87,3,1,2,6
1515915625592153374,48,1,26.19,3,1,1,5
1515915625592154137,48,1,399.48,3,1,4,8
1515915625592159485,48,1,349.46,3,1,4,8
1515915625592159635,48,2,39.18,3,2,2,7
1515915625592160380,48,1,397.48,3,1,4,8
1515915625592161528,42,1,40.0,3,1,2,6
1515915625592163223,48,1,32.22,3,1,1,5
1515915625592165742,48,2,981.08,3,2,4,9
1515915625592165749,48,2,75.55,3,2,2,7
1515915625592165854,48,1,99.92,3,1,3,7
1515915625592166630,48,1,29.06,3,1,1,5
1515915625592175493,48,3,492.99,3,3,4,10
1515915625592182590,48,2,272.1,3,2,3,8
1515915625592182768,48,2,818.98,3,2,4,9
1515915625592186783,48,1,84.89,3,1,2,6
1515915625592187996,47,2,1039.12,3,2,4,9
1515915625592188837,48,1,15.9,3,1,1,5
1515915625592189790,45,2,1234.23,3,2,4,9
1515915625592190896,18,1,10.43,4,1,1,6
1515915625592197634,45,2,103.5,3,2,3,8
1515915625592197823,48,1,113.81,3,1,3,7
1515915625592200002,48,4,149.92,3,3,3,9
1515915625592201365,48,2,548.8,3,2,4,9
1515915625592201910,48,1,149.62,3,1,3,7
1515915625592202493,48,1,53.24,3,1,2,6
1515915625592203524,48,2,20.64,3,2,1,6
1515915625592204040,48,2,588.82,3,2,4,9
1515915625592205386,27,2,252.54,4,2,3,9
1515915625592206207,48,1,314.68,3,1,4,8
1515915625592206624,21,1,10.4,4,1,1,6
1515915625592206778,48,1,205.25,3,1,3,7
1515915625592207773,48,1,15.08,3,1,1,5
1515915625592213779,48,2,33.96,3,2,2,7
1515915625592214897,48,1,18.7,3,1,1,5
1515915625592220527,48,2,64.44,3,2,2,7
1515915625592220696,47,4,2480.43,3,3,4,10
1515915625592224789,43,2,276.35,3,2,3,8
1515915625592227883,48,1,20.0,3,1,1,5
1515915625592230613,48,1,19.37,3,1,1,5
1515915625592231210,48,2,135.94,3,2,3,8
1515915625592233027,48,1,214.1,3,1,3,7
1515915625592233241,46,2,882.98,3,2,4,9
1515915625592236041,48,3,1138.4,3,3,4,10
1515915625592236244,48,1,127.3,3,1,3,7
1515915625592237471,48,1,32.22,3,1,1,5
1515915625592242041,48,1,397.48,3,1,4,8
1515915625592251921,1,3,479.5,4,3,4,11
1515915625592254645,48,1,213.63,3,1,3,7
1515915625592256205,48,2,506.92999999999995,3,2,4,9
1515915625592257272,48,2,172.96,3,2,3,8
1515915625592259896,47,2,644.8,3,2,4,9
1515915625592260411,34,4,344.77,4,3,4,11
1515915625592261403,48,2,172.96,3,2,3,8
1515915625592262061,21,2,585.66,4,2,4,10
1515915625592262842,48,1,87.56,3,1,2,6
1515915625592262928,48,2,59.14,3,2,2,7
1515915625592264140,48,1,12.51,3,1,1,5
1515915625592265511,48,1,202.67,3,1,3,7
1515915625592268594,48,4,105.64,3,3,3,9
1515915625592269224,45,2,59.4,3,2,2,7
1515915625592269979,48,1,90.62,3,1,2,6
1515915625592270214,41,3,2678.37,3,3,4,10
1515915625592273211,48,3,107.60999999999999,3,3,3,9
1515915625592275188,46,4,339.16,3,3,4,10
1515915625592275815,48,1,156.95,3,1,3,7
1515915625592277671,48,1,10.16,3,1,1,5
1515915625592280790,48,1,129.05,3,1,3,7
1515915625592283525,48,1,897.79,3,1,4,8
1515915625592285224,27,1,56.16,4,1,2,7
1515915625592286736,47,3,461.49,3,3,4,10
1515915625592289922,3,2,585.66,4,2,4,10
1515915625592290637,48,1,34.22,3,1,2,6
1515915625592291612,48,1,10.79,3,1,1,5
1515915625592291775,48,1,25.56,3,1,1,5
1515915625592291988,48,1,15.9,3,1,1,5
1515915625592293242,48,1,397.48,3,1,4,8
1515915625592295037,43,1,51.68,3,1,2,6
1515915625592297326,33,4,1880.1,4,3,4,11
1515915625592300183,48,1,165.81,3,1,3,7
1515915625592300438,48,1,9.35,3,1,1,5
1515915625592304053,26,5,2007.9299999999998,4,4,4,12
1515915625592304145,48,2,339.8,3,2,4,9
1515915625592304263,48,1,292.83,3,1,4,8
1515915625592304353,16,7,2423.62,4,4,4,12
1515915625592305188,48,1,415.54,3,1,4,8
1515915625592306310,48,1,397.48,3,1,4,8
1515915625592307476,48,1,32.22,3,1,1,5
1515915625592307667,48,1,44.13,3,1,2,6
1515915625592309037,48,3,824.88,3,3,4,10
1515915625592310051,48,1,198.38,3,1,3,7
1515915625592315845,48,5,2434.05,3,4,4,11
1515915625592329100,20,1,18.73,4,1,1,6
1515915625592329822,40,3,96.66,3,3,3,9
1515915625592332743,48,1,423.49,3,1,4,8
1515915625592335270,48,1,397.48,3,1,4,8
1515915625592335789,48,2,139.74,3,2,3,8
1515915625592348342,7,1,399.48,4,1,4,9
1515915625592348497,48,1,188.06,3,1,3,7
1515915625592349279,48,1,40.67,3,1,2,6
1515915625592349831,48,2,29.72,3,2,1,6
1515915625592350244,48,1,210.68,3,1,3,7
1515915625592350879,48,1,599.6,3,1,4,8
1515915625592351918,48,1,21.43,3,1,1,5
1515915625592353726,48,1,397.48,3,1,4,8
1515915625592358543,48,2,794.96,3,2,4,9
1515915625592360304,48,1,23.37,3,1,1,5
1515915625592361706,43,2,155.46,3,2,3,8
1515915625592362174,48,2,29.72,3,2,1,6
1515915625592362908,39,4,220.64,3,3,3,9
1515915625592366431,48,1,1.57,3,1,1,5
1515915625592368940,48,1,18.41,3,1,1,5
1515915625592371268,48,1,47.21,3,1,2,6
1515915625592371408,45,2,1039.12,3,2,4,9
1515915625592371531,42,2,784.95,3,2,4,9
1515915625592372123,48,2,640.98,3,2,4,9
1515915625592375250,36,6,1363.1599999999999,3,4,4,11
1515915625592375670,48,3,791.49,3,3,4,10
1515915625592376139,22,2,661.87,4,2,4,10
1515915625592377138,7,1,55.16,4,1,2,7
1515915625592379321,47,5,592.8499999999999,3,4,4,11
1515915625592379422,28,1,64.48,4,1,2,7
1515915625592379475,47,3,221.43,3,3,3,9
1515915625592380855,48,2,72.7,3,2,2,7
1515915625592381117,27,1,461.52,4,1,4,9
1515915625592383149,48,2,59.14,3,2,2,7
1515915625592383159,48,1,64.48,3,1,2,6
1515915625592383369,48,1,294.41,3,1,4,8
1515915625592384785,48,1,572.57,3,1,4,8
1515915625592385003,48,1,294.41,3,1,4,8
1515915625592385604,48,1,397.48,3,1,4,8
1515915625592387061,46,1,450.67,3,1,4,8
1515915625592388895,48,4,1072.68,3,3,4,10
1515915625592390066,48,6,184.9,3,4,3,10
1515915625592390226,47,2,431.22,3,2,4,9
1515915625592394290,24,3,355.71,4,3,4,11
1515915625592394793,48,2,111.74,3,2,3,8
1515915625592396140,38,2,41.58,3,2,2,7
1515915625592398619,48,1,126.68,3,1,3,7
1515915625592399066,48,1,162.51,3,1,3,7
1515915625592400407,48,1,9.95,3,1,1,5
1515915625592408854,31,1,373.46,4,1,4,9
1515915625592421253,48,3,243.57,3,3,3,9
1515915625592424452,48,1,25.94,3,1,1,5
1515915625592429453,48,1,609.6,3,1,4,8
1515915625592430038,46,1,277.1,3,1,3,7
1515915625592437230,48,1,38.13,3,1,2,6
1515915625592438351,48,2,1079.14,3,2,4,9
1515915625592438538,48,1,457.51,3,1,4,8
1515915625592438546,48,1,217.57,3,1,3,7
1515915625592439913,48,1,134.33,3,1,3,7
1515915625592440653,48,1,45.24,3,1,2,6
1515915625592441707,48,1,187.29,3,1,3,7
1515915625592443389,48,1,1.57,3,1,1,5
1515915625592446492,48,1,292.83,3,1,4,8
1515915625592447029,35,2,266.06,4,2,3,9
1515915625592447264,48,2,343.8,3,2,4,9
1515915625592448006,28,4,1171.32,4,3,4,11
1515915625592448889,26,1,52.83,4,1,2,7
1515915625592451133,48,1,13.65,3,1,1,5
1515915625592453561,48,1,397.48,3,1,4,8
1515915625592453869,48,1,416.56,3,1,4,8
1515915625592456632,48,3,130.53,3,3,3,9
1515915625592458939,48,1,82.97,3,1,2,6
1515915625592465582,47,6,136.74,3,4,3,10
1515915625592466504,48,1,397.48,3,1,4,8
1515915625592467449,48,1,201.33,3,1,3,7
1515915625592468522,48,1,177.95,3,1,3,7
1515915625592468820,48,1,103.83,3,1,3,7
1515915625592468935,48,2,49.84,3,2,2,7
1515915625592469110,48,1,38.83,3,1,2,6
1515915625592469420,48,1,29.57,3,1,1,5
1515915625592469584,48,1,103.83,3,1,3,7
1515915625592471382,48,1,294.41,3,1,4,8
1515915625592474964,48,3,254.67000000000002,3,3,3,9
1515915625592477987,1,13,2812.12,4,4,4,12
1515915625592479309,48,1,11.98,3,1,1,5
1515915625592485281,48,1,17.3,3,1,1,5
1515915625592485430,48,1,11.54,3,1,1,5
1515915625592485774,48,1,397.48,3,1,4,8
1515915625592489475,48,1,189.17,3,1,3,7
1515915625592492588,48,2,64.76,3,2,2,7
1515915625592492985,35,2,235.5,4,2,3,9
1515915625592493276,34,1,399.48,4,1,4,9
1515915625592495050,48,1,67.51,3,1,2,6
1515915625592497368,47,1,444.51,3,1,4,8
1515915625592501235,4,1,569.59,4,1,4,9
1515915625592501934,47,1,48.84,3,1,2,6
1515915625592505260,47,1,169.9,3,1,3,7
1515915625592510315,29,1,298.76,4,1,4,9
1515915625592520520,47,1,73.81,3,1,2,6
1515915625592521782,47,2,40.35,3,2,2,7
1515915625592523557,47,3,345.0,3,3,4,10
1515915625592526146,47,1,292.83,3,1,4,8
1515915625592529421,47,1,102.11,3,1,3,7
1515915625592529623,47,1,236.08,3,1,3,7
1515915625592531779,47,2,246.7,3,2,3,8
1515915625592540913,47,2,46.74,3,2,2,7
1515915625592541340,47,1,14.08,3,1,1,5
1515915625592542475,47,1,18.7,3,1,1,5
1515915625592545512,47,1,26.98,3,1,1,5
1515915625592556068,47,1,70.17,3,1,2,6
1515915625592557564,39,1,105.87,3,1,3,7
1515915625592560988,47,1,92.43,3,1,3,7
1515915625592574913,47,1,87.56,3,1,2,6
1515915625592575439,47,1,215.24,3,1,3,7
1515915625592576104,47,1,397.48,3,1,4,8
1515915625592576399,47,1,49.52,3,1,2,6
1515915625592579286,47,1,214.1,3,1,3,7
1515915625592579611,47,2,59.04,3,2,2,7
1515915625592580648,47,2,254.16,3,2,3,8
1515915625592581341,3,4,404.77,4,3,4,11
1515915625592581972,47,1,214.1,3,1,3,7
1515915625592584070,47,1,231.24,3,1,3,7
1515915625592592835,45,1,33.17,3,1,2,6
1515915625592598404,47,1,213.11,3,1,3,7
1515915625592599344,47,1,21.21,3,1,1,5
1515915625592599356,47,1,599.6,3,1,4,8
1515915625592599733,47,1,482.52,3,1,4,8
1515915625592599819,47,1,41.9,3,1,2,6
1515915625592607699,47,1,26.19,3,1,1,5
1515915625592608422,47,1,171.9,3,1,3,7
1515915625592609755,47,1,205.25,3,1,3,7
1515915625592611734,47,2,234.98,3,2,3,8
1515915625592612760,47,8,663.76,3,4,4,11
1515915625592614790,43,2,1313.26,3,2,4,9
1515915625592615921,47,1,482.52,3,1,4,8
1515915625592616872,47,1,163.52,3,1,3,7
1515915625592617501,47,1,292.83,3,1,4,8
1515915625592623412,45,5,2153.4300000000003,3,4,4,11
1515915625592624782,47,1,23.02,3,1,1,5
1515915625592626700,47,1,9.35,3,1,1,5
1515915625592629227,47,2,39.04,3,2,2,7
1515915625592629315,47,1,486.81,3,1,4,8
1515915625592630664,47,1,397.48,3,1,4,8
1515915625592634141,42,2,873.05,3,2,4,9
1515915625592646696,47,1,214.1,3,1,3,7
1515915625592649737,47,1,466.52,3,1,4,8
1515915625592650142,41,3,70.14,3,3,2,8
1515915625592658911,47,2,391.85,3,2,4,9
1515915625592667673,47,1,214.1,3,1,3,7
1515915625592667800,47,1,136.05,3,1,3,7
1515915625592673289,45,4,1341.21,3,3,4,10
1515915625592673388,47,1,71.75,3,1,2,6
1515915625592674820,47,2,105.74,3,2,3,8
1515915625592680338,47,2,103.36,3,2,3,8
1515915625592684342,43,5,105.1,3,4,3,10
1515915625592685196,47,2,247.58,3,2,3,8
1515915625592689576,47,1,202.67,3,1,3,7
1515915625592689761,47,1,23.48,3,1,1,5
1515915625592690068,47,1,214.1,3,1,3,7
1515915625592690083,47,10,134.10000000000002,3,4,3,10
1515915625592690408,47,1,124.13,3,1,3,7
1515915625592693810,47,2,84.52000000000001,3,2,2,7
1515915625592695343,47,2,307.66,3,2,4,9
1515915625592697990,47,2,111.74,3,2,3,8
1515915625592699781,38,1,31.97,3,1,1,5
1515915625592701378,47,3,128.91,3,3,3,9
1515915625592702376,47,1,37.17,3,1,2,6
1515915625592702955,47,1,61.05,3,1,2,6
1515915625592703498,47,1,204.79,3,1,3,7
1515915625592708680,47,1,373.46,3,1,4,8
1515915625592710600,11,1,294.41,4,1,4,9
1515915625592710836,47,1,127.48,3,1,3,7
1515915625592713260,1,1,199.37,4,1,3,8
1515915625592714254,47,2,240.79,3,2,3,8
1515915625592714939,47,2,428.2,3,2,4,9
1515915625592715535,34,1,897.79,4,1,4,9
1515915625592727506,47,1,3.86,3,1,1,5
1515915625592732695,47,2,390.44,3,2,4,9
1515915625592736099,47,2,70.2,3,2,2,7
1515915625592736572,47,1,202.67,3,1,3,7
1515915625592737751,42,1,202.67,3,1,3,7
1515915625592737838,43,1,292.83,3,1,4,8
1515915625592738093,47,2,74.28,3,2,2,7
1515915625592744708,47,3,492.99,3,3,4,10
1515915625592745006,26,1,312.43,4,1,4,9
1515915625592745241,22,5,1345.73,4,4,4,12
1515915625592748830,47,1,897.79,3,1,4,8
1515915625592749876,47,1,226.84,3,1,3,7
1515915625592751593,47,1,29.57,3,1,1,5
1515915625592753773,47,1,127.08,3,1,3,7
1515915625592754419,47,1,21.43,3,1,1,5
1515915625592765356,47,1,27.32,3,1,1,5
1515915625592769287,46,2,138.7,3,2,3,8
1515915625592770978,47,1,482.52,3,1,4,8
1515915625592771593,41,1,140.63,3,1,3,7
1515915625592773809,47,1,154.32,3,1,3,7
1515915625592779431,47,1,124.13,3,1,3,7
1515915625592782562,47,1,38.1,3,1,2,6
1515915625592784118,42,1,438.51,3,1,4,8
1515915625592785572,47,1,17.14,3,1,1,5
1515915625592785894,47,1,55.16,3,1,2,6
1515915625592786589,47,1,569.59,3,1,4,8
1515915625592787634,47,1,21.11,3,1,1,5
1515915625592788198,47,2,105.74,3,2,3,8
1515915625592788328,47,1,36.14,3,1,2,6
1515915625592790336,47,1,60.4,3,1,2,6
1515915625592793173,47,1,22.22,3,1,1,5
1515915625592793408,47,1,2.92,3,1,1,5
1515915625592801126,47,1,13.86,3,1,1,5
1515915625592806169,47,1,294.41,3,1,4,8
1515915625592809768,47,2,246.49,3,2,3,8
1515915625592812797,26,1,479.52,4,1,4,9
1515915625592813280,47,1,11.75,3,1,1,5
1515915625592814424,46,2,205.4,3,2,3,8
1515915625592815904,47,7,2240.52,3,4,4,11
1515915625592815965,47,1,202.67,3,1,3,7
1515915625592825132,47,2,164.1,3,2,3,8
1515915625592829398,47,2,27.700000000000003,3,2,1,6
1515915625592830003,47,1,60.83,3,1,2,6
1515915625592835855,45,3,644.5699999999999,3,3,4,10
1515915625592836090,6,1,82.33,4,1,2,7
1515915625592837479,47,1,185.6,3,1,3,7
1515915625592845798,47,1,13.79,3,1,1,5
1515915625592848804,47,2,203.8,3,2,3,8
1515915625592850226,47,1,482.52,3,1,4,8
1515915625592851760,47,2,1039.0900000000001,3,2,4,9
1515915625592852369,47,1,397.48,3,1,4,8
1515915625592853015,47,1,50.51,3,1,2,6
1515915625592853610,47,1,199.37,3,1,3,7
1515915625592861404,43,5,414.85,3,4,4,11
1515915625592863469,47,1,397.48,3,1,4,8
1515915625592865455,46,2,106.66,3,2,3,8
1515915625592866193,46,1,15.52,3,1,1,5
1515915625592866462,47,1,107.16,3,1,3,7
1515915625592868688,47,1,22.86,3,1,1,5
1515915625592870824,47,1,32.22,3,1,1,5
1515915625592877665,47,1,11.9,3,1,1,5
1515915625592879836,47,1,466.52,3,1,4,8
1515915625592879930,47,1,397.48,3,1,4,8
1515915625592880793,47,1,43.65,3,1,2,6
1515915625592880877,47,1,415.54,3,1,4,8
1515915625592888857,46,3,61.89,3,3,2,8
1515915625592898840,46,2,405.34,3,2,4,9
1515915625592902441,46,2,105.8,3,2,3,8
1515915625592903114,46,1,519.56,3,1,4,8
1515915625592904652,46,1,416.56,3,1,4,8
1515915625592905718,46,3,145.23,3,3,3,9
1515915625592906671,44,1,65.08,3,1,2,6
1515915625592907172,46,2,973.62,3,2,4,9
1515915625592909104,46,1,15.08,3,1,1,5
1515915625592913189,46,1,15.87,3,1,1,5
1515915625592918777,46,1,339.16,3,1,4,8
1515915625592921074,46,1,294.41,3,1,4,8
1515915625592921640,46,1,202.67,3,1,3,7
1515915625592927695,46,2,66.66,3,2,2,7
1515915625592928888,46,1,429.51,3,1,4,8
1515915625592929962,10,3,998.71,4,3,4,11
1515915625592929984,46,7,1418.6899999999998,3,4,4,11
1515915625592930016,46,2,1155.2,3,2,4,9
1515915625592931895,46,2,585.66,3,2,4,9
1515915625592933064,46,2,405.34,3,2,4,9
1515915625592934479,46,1,432.3,3,1,4,8
1515915625592934553,41,2,151.54000000000002,3,2,3,8
1515915625592935137,46,1,204.29,3,1,3,7
1515915625592935231,46,2,102.66,3,2,3,8
1515915625592938277,46,2,495.5,3,2,4,9
1515915625592941047,26,2,77.66,4,2,2,8
1515915625592941368,46,2,105.66,3,2,3,8
1515915625592943224,46,1,175.83,3,1,3,7
1515915625592951020,46,1,32.22,3,1,1,5
1515915625592952803,46,1,51.9,3,1,2,6
1515915625592952912,46,1,399.48,3,1,4,8
1515915625592953270,46,6,1241.5,3,4,4,11
1515915625592953959,46,1,122.86,3,1,3,7
1515915625592956931,46,1,183.71,3,1,3,7
1515915625592961269,46,1,457.51,3,1,4,8
1515915625592964307,46,5,903.9499999999999,3,4,4,11
1515915625592964754,46,6,2345.78,3,4,4,11
1515915625592967042,27,2,105.08,4,2,3,9
1515915625592969244,46,1,32.06,3,1,1,5
1515915625592969534,46,1,548.37,3,1,4,8
1515915625592970863,46,2,740.92,3,2,4,9
1515915625592972918,46,2,765.0,3,2,4,9
1515915625592974338,46,1,370.46,3,1,4,8
1515915625592975028,46,2,66.16,3,2,2,7
1515915625592975078,46,1,10.87,3,1,1,5
1515915625592975732,46,1,164.33,3,1,3,7
1515915625592976766,46,1,15.56,3,1,1,5
1515915625592979760,46,1,16.24,3,1,1,5
1515915625592982988,46,2,118.18,3,2,3,8
1515915625592986254,46,1,292.83,3,1,4,8
1515915625592987611,46,1,17.9,3,1,1,5
1515915625592988682,46,2,78.12,3,2,2,7
1515915625592989232,46,1,214.1,3,1,3,7
1515915625592991249,46,1,29.22,3,1,1,5
1515915625592992938,46,1,82.97,3,1,2,6
1515915625592993272,46,1,18.73,3,1,1,5
1515915625592994656,46,1,44.03,3,1,2,6
1515915625592994743,46,3,129.32999999999998,3,3,3,9
1515915625592996354,29,10,208.32,4,4,3,11
1515915625593000528,46,1,44.57,3,1,2,6
1515915625593003571,46,2,25.08,3,2,1,6
1515915625593005932,46,1,187.29,3,1,3,7
1515915625593008964,46,1,26.19,3,1,1,5
1515915625593009450,46,1,482.52,3,1,4,8
1515915625593011192,44,1,15.56,3,1,1,5
1515915625593011719,46,1,19.87,3,1,1,5
1515915625593011839,46,1,294.41,3,1,4,8
1515915625593013238,46,2,37.88,3,2,2,7
1515915625593015838,46,1,212.06,3,1,3,7
1515915625593019070,46,1,179.78,3,1,3,7
1515915625593023113,46,1,656.63,3,1,4,8
1515915625593024801,46,1,205.32,3,1,3,7
1515915625593027425,41,1,10.6,3,1,1,5
1515915625593033221,45,3,1578.69,3,3,4,10
1515915625593038708,46,3,28.509999999999998,3,3,1,7
1515915625593041651,46,2,35.46,3,2,2,7
1515915625593045477,45,1,89.22,3,1,2,6
1515915625593045731,46,2,3.14,3,2,1,6
1515915625593049863,46,1,24.48,3,1,1,5
1515915625593050189,46,1,204.29,3,1,3,7
1515915625593054027,29,2,588.82,4,2,4,10
1515915625593056048,46,1,27.89,3,1,1,5
1515915625593056147,46,2,375.56,3,2,4,9
1515915625593059202,19,1,10.17,4,1,1,6
1515915625593059208,46,1,80.03,3,1,2,6
1515915625593059815,46,2,889.02,3,2,4,9
1515915625593063421,46,1,202.67,3,1,3,7
1515915625593063649,46,1,292.83,3,1,4,8
1515915625593071485,46,3,1161.85,3,3,4,10
1515915625593071536,31,3,1189.18,4,3,4,11
1515915625593072306,46,2,404.64,3,2,4,9
1515915625593074655,46,1,292.83,3,1,4,8
1515915625593077609,43,1,294.41,3,1,4,8
1515915625593079186,46,1,519.56,3,1,4,8
1515915625593080514,35,1,171.9,4,1,3,8
1515915625593084076,46,1,75.71,3,1,2,6
1515915625593086042,42,1,212.06,3,1,3,7
1515915625593088300,46,4,1839.07,3,3,4,10
1515915625593088391,33,3,89.67,4,3,2,9
1515915625593098627,46,2,973.62,3,2,4,9
1515915625593106289,46,1,29.33,3,1,1,5
1515915625593107103,44,1,202.67,3,1,3,7
1515915625593107516,46,2,1169.18,3,2,4,9
1515915625593110632,46,1,292.83,3,1,4,8
1515915625593111001,46,1,64.29,3,1,2,6
1515915625593112001,46,1,31.43,3,1,1,5
1515915625593112015,5,3,380.49,4,3,4,11
1515915625593113778,46,2,175.12,3,2,3,8
1515915625593115896,44,4,128.88,3,3,3,9
1515915625593116150,46,1,486.81,3,1,4,8
1515915625593117426,46,1,32.86,3,1,2,6
1515915625593125128,21,1,52.87,4,1,2,7
1515915625593126228,46,1,37.17,3,1,2,6
1515915625593134715,46,1,43.65,3,1,2,6
1515915625593135409,25,1,149.7,4,1,3,8
1515915625593137283,37,3,925.41,3,3,4,10
1515915625593137325,37,4,943.74,3,3,4,10
1515915625593138070,46,1,26.19,3,1,1,5
1515915625593140628,46,2,119.66,3,2,3,8
1515915625593144205,46,1,256.94,3,1,3,7
1515915625593145194,46,1,94.1,3,1,3,7
1515915625593145360,46,1,24.13,3,1,1,5
1515915625593147719,22,7,1433.53,4,4,4,12
1515915625593149042,46,1,539.57,3,1,4,8
1515915625593151655,46,1,205.25,3,1,3,7
1515915625593152486,46,3,266.19,3,3,3,9
1515915625593152967,45,4,74.28,3,3,2,8
1515915625593156015,46,1,16.19,3,1,1,5
1515915625593156199,46,1,486.81,3,1,4,8
1515915625593157550,46,1,23.22,3,1,1,5
1515915625593158622,46,1,314.68,3,1,4,8
1515915625593168806,46,1,292.83,3,1,4,8
1515915625593169397,45,2,165.94,3,2,3,8
1515915625593177809,46,1,36.79,3,1,2,6
1515915625593179412,44,2,746.92,3,2,4,9
1515915625593179695,45,3,51.06,3,3,2,8
1515915625593182624,15,3,71.42999999999999,4,3,2,9
1515915625593183763,44,1,23.57,3,1,1,5
1515915625593184167,46,1,15.08,3,1,1,5
1515915625593185695,46,1,32.22,3,1,1,5
1515915625593191052,46,1,539.57,3,1,4,8
1515915625593193537,46,3,793.16,3,3,4,10
1515915625593195851,46,1,294.41,3,1,4,8
1515915625593200275,45,1,127.08,3,1,3,7
1515915625593205170,46,1,292.83,3,1,4,8
1515915625593205633,46,1,104.86,3,1,3,7
1515915625593207791,46,1,104.86,3,1,3,7
1515915625593210074,46,3,314.58,3,3,4,10
1515915625593213721,46,3,1253.2199999999998,3,3,4,10
1515915625593219039,46,2,253.36,3,2,3,8
1515915625593219500,46,2,166.19,3,2,3,8
1515915625593220412,38,1,257.87,3,1,3,7
1515915625593221511,46,1,77.73,3,1,2,6
1515915625593221954,18,1,200.35,4,1,3,8
1515915625593222106,46,1,77.73,3,1,2,6
1515915625593222520,46,1,37.3,3,1,2,6
1515915625593224631,46,4,1460.72,3,3,4,10
1515915625593226532,46,1,415.54,3,1,4,8
1515915625593227105,46,1,15.87,3,1,1,5
1515915625593228994,45,2,37.93,3,2,2,7
1515915625593231282,26,2,588.82,4,2,4,10
1515915625593235529,46,1,214.1,3,1,3,7
1515915625593239686,46,2,794.96,3,2,4,9
1515915625593242589,46,6,191.73999999999998,3,4,3,10
1515915625593242839,46,1,274.4,3,1,3,7
1515915625593245552,46,4,745.48,3,3,4,10
1515915625593256681,45,1,287.4,3,1,3,7
1515915625593260388,45,1,16.19,3,1,1,5
1515915625593262379,45,1,218.98,3,1,3,7
1515915625593262649,45,1,218.98,3,1,3,7
1515915625593266048,45,3,642.3,3,3,4,10
1515915625593267687,45,1,137.4,3,1,3,7
1515915625593273816,45,1,572.57,3,1,4,8
1515915625593279433,45,1,466.52,3,1,4,8
1515915625593280708,31,2,405.34,4,2,4,10
1515915625593283558,45,3,1652.98,3,3,4,10
1515915625593284338,45,1,444.51,3,1,4,8
1515915625593284895,42,2,272.1,3,2,3,8
1515915625593291874,45,1,40.41,3,1,2,6
1515915625593295380,36,2,112.54,3,2,3,8
1515915625593296412,38,4,1798.04,3,3,4,10
1515915625593298687,45,2,151.52,3,2,3,8
1515915625593301527,45,1,548.37,3,1,4,8
1515915625593306984,45,1,251.4,3,1,3,7
1515915625593307473,45,1,66.98,3,1,2,6
1515915625593311522,44,1,449.51,3,1,4,8
1515915625593313050,43,2,1326.56,3,2,4,9
1515915625593317625,45,1,486.81,3,1,4,8
1515915625593319560,45,2,794.96,3,2,4,9
1515915625593321556,45,1,397.48,3,1,4,8
1515915625593325624,45,6,254.45999999999998,3,4,3,10
1515915625593325839,45,1,28.1,3,1,1,5
1515915625593327371,34,2,19.68,4,2,1,7
1515915625593329071,40,2,204.22,3,2,3,8
1515915625593329269,45,1,294.41,3,1,4,8
1515915625593329873,45,1,85.33,3,1,2,6
1515915625593336516,45,1,10.16,3,1,1,5
1515915625593338446,45,2,42.86,3,2,2,7
1515915625593338939,41,1,53.9,3,1,2,6
1515915625593340096,45,2,83.36,3,2,2,7
1515915625593340399,45,1,48.84,3,1,2,6
1515915625593340730,45,1,25.4,3,1,1,5
1515915625593341008,45,2,57.46,3,2,2,7
1515915625593342739,45,1,418.48,3,1,4,8
1515915625593349527,45,1,20.95,3,1,1,5
1515915625593352394,43,3,182.49,3,3,3,9
1515915625593354203,45,2,32.86,3,2,2,7
1515915625593357528,41,5,842.24,3,4,4,11
1515915625593359444,45,1,63.33,3,1,2,6
1515915625593360560,45,4,60.4,3,3,2,8
1515915625593360605,45,1,68.43,3,1,2,6
1515915625593361174,45,1,94.86,3,1,3,7
1515915625593363333,45,1,236.67,3,1,3,7
1515915625593365292,45,1,466.52,3,1,4,8
1515915625593366632,45,2,248.26,3,2,3,8
1515915625593371061,45,1,9.35,3,1,1,5
1515915625593374295,45,1,43.57,3,1,2,6
1515915625593374900,45,2,991.0799999999999,3,2,4,9
1515915625593375031,45,1,20.79,3,1,1,5
1515915625593376080,23,1,15.4,4,1,1,6
1515915625593376693,40,1,771.73,3,1,4,8
1515915625593377271,45,2,33.05,3,2,2,7
1515915625593382625,45,1,328.62,3,1,4,8
1515915625593387051,45,1,11.75,3,1,1,5
1515915625593387138,45,6,130.26,3,4,3,10
1515915625593390005,45,1,32.97,3,1,2,6
1515915625593395368,45,1,292.83,3,1,4,8
1515915625593397045,45,1,397.48,3,1,4,8
1515915625593399984,45,1,41.94,3,1,2,6
1515915625593401902,36,1,397.48,3,1,4,8
1515915625593403834,44,1,397.48,3,1,4,8
1515915625593405265,45,1,183.49,3,1,3,7
1515915625593405525,45,1,31.68,3,1,1,5
1515915625593409187,37,1,43.03,3,1,2,6
1515915625593409247,45,1,257.87,3,1,3,7
1515915625593410110,45,1,29.52,3,1,1,5
1515915625593414501,45,1,15.08,3,1,1,5
1515915625593421898,45,1,229.38,3,1,3,7
1515915625593422838,45,5,114.3,3,4,3,10
1515915625593424350,45,2,139.76,3,2,3,8
1515915625593426964,45,4,115.56,3,3,3,9
1515915625593430052,45,2,81.34,3,2,2,7
1515915625593430554,13,4,2211.42,4,3,4,11
1515915625593431026,22,2,253.36,4,2,3,9
1515915625593431764,45,1,6.51,3,1,1,5
1515915625593435883,45,1,9.81,3,1,1,5
1515915625593441709,11,1,60.54,4,1,2,7
1515915625593443686,45,1,205.25,3,1,3,7
1515915625593444746,16,1,202.67,4,1,3,8
1515915625593447991,45,3,1236.44,3,3,4,10
1515915625593456431,44,1,33.17,3,1,2,6
1515915625593458134,45,1,600.6,3,1,4,8
1515915625593459780,43,1,37.59,3,1,2,6
1515915625593462336,45,1,22.41,3,1,1,5
1515915625593462688,45,1,288.02,3,1,4,8
1515915625593466442,45,2,42.62,3,2,2,7
1515915625593467809,45,1,577.6,3,1,4,8
1515915625593468380,44,4,70.92,3,3,2,8
1515915625593469762,45,1,19.52,3,1,1,5
1515915625593470058,45,2,277.83,3,2,3,8
1515915625593470352,45,1,13.76,3,1,1,5
1515915625593473389,45,1,251.4,3,1,3,7
1515915625593474741,45,2,41.42,3,2,2,7
1515915625593474885,45,1,25.08,3,1,1,5
1515915625593475328,45,1,137.63,3,1,3,7
1515915625593476264,45,2,102.66,3,2,3,8
1515915625593479426,41,2,973.62,3,2,4,9
1515915625593481657,45,1,397.48,3,1,4,8
1515915625593481884,45,2,199.02,3,2,3,8
1515915625593482302,45,2,29.56,3,2,1,6
1515915625593482584,45,1,36.35,3,1,2,6
1515915625593483569,45,1,14.78,3,1,1,5
1515915625593483918,45,5,202.2,3,4,3,10
1515915625593483944,45,2,199.02,3,2,3,8
1515915625593486399,44,3,65.42999999999999,3,3,2,8
1515915625593493216,44,3,402.24,3,3,4,10
1515915625593493363,45,2,31.74,3,2,1,6
1515915625593494239,45,1,163.52,3,1,3,7
1515915625593496239,45,1,107.16,3,1,3,7
1515915625593498265,45,1,57.46,3,1,2,6
1515915625593498889,45,1,397.48,3,1,4,8
1515915625593503522,45,1,292.83,3,1,4,8
1515915625593507252,44,2,1199.2,3,2,4,9
1515915625593508369,45,1,292.83,3,1,4,8
1515915625593509248,43,3,1087.79,3,3,4,10
1515915625593513134,18,5,830.81,4,4,4,12
1515915625593517961,45,1,294.41,3,1,4,8
1515915625593518109,19,1,1275.02,4,1,4,9
1515915625593522357,35,2,629.64,4,2,4,10
1515915625593523117,45,1,15.4,3,1,1,5
1515915625593528272,45,1,148.37,3,1,3,7
1515915625593531565,45,2,1086.41,3,2,4,9
1515915625593532297,45,1,34.44,3,1,2,6
1515915625593534475,45,1,501.54,3,1,4,8
1515915625593540049,45,1,274.4,3,1,3,7
1515915625593541688,44,4,1579.33,3,3,4,10
1515915625593547083,45,1,453.86,3,1,4,8
1515915625593548605,45,2,455.07,3,2,4,9
1515915625593549091,45,1,202.67,3,1,3,7
1515915625593549193,45,1,70.6,3,1,2,6
1515915625593549790,44,2,176.48,3,2,3,8
1515915625593549839,45,1,74.06,3,1,2,6
1515915625593550089,45,2,279.99,3,2,3,8
1515915625593551446,45,1,490.54,3,1,4,8
1515915625593551769,45,1,42.9,3,1,2,6
1515915625593558627,45,1,13.48,3,1,1,5
1515915625593559890,45,1,486.81,3,1,4,8
1515915625593560540,45,2,1224.22,3,2,4,9
1515915625593563274,45,1,397.48,3,1,4,8
1515915625593564649,45,1,50.9,3,1,2,6
1515915625593565376,42,2,192.74,3,2,3,8
1515915625593574271,12,2,151.52,4,2,3,9
1515915625593574304,42,1,58.6,3,1,2,6
1515915625593576803,45,1,357.46,3,1,4,8
1515915625593577596,13,7,106.47,4,4,3,11
1515915625593580792,35,10,1160.5,4,4,4,12
1515915625593584260,21,1,87.56,4,1,2,7
1515915625593587711,13,1,78.3,4,1,2,7
1515915625593601495,44,2,65.34,3,2,2,7
1515915625593603786,44,3,264.71999999999997,3,3,3,9
1515915625593611779,44,1,274.78,3,1,3,7
1515915625593614997,35,3,679.6,4,3,4,11
1515915625593616072,44,1,214.1,3,1,3,7
1515915625593618955,44,1,397.48,3,1,4,8
1515915625593628225,44,2,38.74,3,2,2,7
1515915625593629909,44,1,19.37,3,1,1,5
1515915625593636727,44,1,449.51,3,1,4,8
1515915625593637821,44,1,46.98,3,1,2,6
1515915625593639000,44,1,82.97,3,1,2,6
1515915625593640616,44,3,59.04,3,3,2,8
1515915625593644662,44,1,22.4,3,1,1,5
1515915625593645604,44,2,227.62,3,2,3,8
1515915625593651970,28,4,1718.04,4,3,4,11
1515915625593652868,44,1,126.68,3,1,3,7
1515915625593655328,44,1,19.37,3,1,1,5
1515915625593663587,44,1,193.63,3,1,3,7
1515915625593664950,44,2,405.34,3,2,4,9
1515915625593668590,44,1,399.48,3,1,4,8
1515915625593670424,44,1,31.41,3,1,1,5
1515915625593672538,44,1,214.1,3,1,3,7
1515915625593673412,44,1,107.16,3,1,3,7
1515915625593681976,43,2,1329.26,3,2,4,9
1515915625593688071,44,1,199.37,3,1,3,7
1515915625593692303,44,1,294.41,3,1,4,8
1515915625593692994,34,1,17.3,4,1,1,6
1515915625593697075,40,1,202.67,3,1,3,7
1515915625593698561,44,1,214.1,3,1,3,7
1515915625593705818,44,1,122.86,3,1,3,7
1515915625593706077,33,2,238.44,4,2,3,9
1515915625593706639,44,4,664.08,3,3,4,10
1515915625593707442,44,1,349.46,3,1,4,8
1515915625593708135,44,1,56.27,3,1,2,6
1515915625593708884,44,1,672.63,3,1,4,8
1515915625593709491,44,2,20.32,3,2,1,6
1515915625593712099,44,1,40.79,3,1,2,6
1515915625593712742,38,1,48.41,3,1,2,6
1515915625593712969,44,1,13.81,3,1,1,5
1515915625593713801,44,1,397.48,3,1,4,8
1515915625593717140,44,2,237.14,3,2,3,8
1515915625593717407,4,2,1201.2,4,2,4,10
1515915625593717769,44,1,600.6,3,1,4,8
1515915625593722412,44,1,21.43,3,1,1,5
1515915625593725571,44,3,841.6299999999999,3,3,4,10
1515915625593726483,44,1,9.35,3,1,1,5
1515915625593729634,42,1,187.29,3,1,3,7
1515915625593730405,44,1,214.9,3,1,3,7
1515915625593731874,44,1,26.46,3,1,1,5
1515915625593742157,44,1,27.48,3,1,1,5
1515915625593745341,44,2,503.84,3,2,4,9
1515915625593746847,44,1,105.13,3,1,3,7
1515915625593746981,44,2,52.06,3,2,2,7
1515915625593747473,1,2,794.96,4,2,4,10
1515915625593750225,44,1,149.05,3,1,3,7
1515915625593751679,42,2,262.9,3,2,3,8
1515915625593759327,43,3,751.14,3,3,4,10
1515915625593759674,44,1,23.9,3,1,1,5
1515915625593763368,44,1,140.02,3,1,3,7
1515915625593763453,44,1,457.51,3,1,4,8
1515915625593763590,38,2,907.72,3,2,4,9
1515915625593768400,24,1,224.76,4,1,3,8
1515915625593770070,44,1,72.79,3,1,2,6
1515915625593770495,43,2,629.94,3,2,4,9
1515915625593773866,39,2,23.24,3,2,1,6
1515915625593777010,44,1,43.57,3,1,2,6
1515915625593779175,44,1,14.19,3,1,1,5
1515915625593779263,44,1,584.59,3,1,4,8
1515915625593779538,43,3,34.11,3,3,2,8
1515915625593784035,44,2,831.08,3,2,4,9
1515915625593784353,44,2,585.66,3,2,4,9
1515915625593784733,44,2,175.35,3,2,3,8
1515915625593786068,44,1,177.95,3,1,3,7
1515915625593789209,22,1,18.46,4,1,1,6
1515915625593792502,44,1,31.32,3,1,1,5
1515915625593795919,44,4,935.2399999999999,3,3,4,10
1515915625593805197,44,1,519.56,3,1,4,8
1515915625593807495,43,2,96.54,3,2,3,8
1515915625593808825,30,4,1171.32,4,3,4,11
1515915625593809375,44,1,153.05,3,1,3,7
1515915625593809508,11,1,11.65,4,1,1,6
1515915625593809546,44,1,153.05,3,1,3,7
1515915625593810609,5,1,82.97,4,1,2,7
1515915625593814552,44,3,754.2,3,3,4,10
1515915625593822188,44,1,13.48,3,1,1,5
1515915625593826564,44,3,1148.82,3,3,4,10
1515915625593827911,44,1,223.17,3,1,3,7
1515915625593828954,33,1,60.0,4,1,2,7
1515915625593829949,44,2,46.96,3,2,2,7
1515915625593832637,44,1,479.51,3,1,4,8
1515915625593833027,44,3,1384.58,3,3,4,10
1515915625593843908,44,1,449.51,3,1,4,8
1515915625593844154,44,1,397.48,3,1,4,8
1515915625593844529,44,1,15.68,3,1,1,5
1515915625593845191,44,2,815.02,3,2,4,9
1515915625593845536,42,3,552.0,3,3,4,10
1515915625593847091,44,1,44.13,3,1,2,6
1515915625593850015,43,12,1062.4,3,4,4,11
1515915625593853678,44,1,70.16,3,1,2,6
1515915625593857874,44,1,13.86,3,1,1,5
1515915625593859772,43,2,307.66,3,2,4,9
1515915625593860061,44,4,159.0,3,3,3,9
1515915625593861220,44,1,32.38,3,1,2,6
1515915625593861434,40,2,964.0500000000001,3,2,4,9
1515915625593865132,43,6,9.42,3,4,1,8
1515915625593866829,44,1,51.68,3,1,2,6
1515915625593866971,44,1,397.48,3,1,4,8
1515915625593870760,44,2,120.42,3,2,3,8
1515915625593872254,44,1,64.48,3,1,2,6
1515915625593873732,44,2,913.02,3,2,4,9
1515915625593874353,40,2,112.54,3,2,3,8
1515915625593874622,44,1,292.83,3,1,4,8
1515915625593884718,44,1,226.84,3,1,3,7
1515915625593889125,44,1,60.83,3,1,2,6
1515915625593891411,44,1,399.48,3,1,4,8
1515915625593893016,11,1,379.48,4,1,4,9
1515915625593893305,44,1,9.84,3,1,1,5
1515915625593894698,44,2,1039.12,3,2,4,9
1515915625593894859,44,1,519.56,3,1,4,8
1515915625593896759,44,1,139.52,3,1,3,7
1515915625593904264,44,4,339.56,3,3,4,10
1515915625593904855,44,1,32.25,3,1,2,6
1515915625593910785,44,1,292.83,3,1,4,8
1515915625593911025,44,1,268.17,3,1,3,7
1515915625593911356,44,1,203.29,3,1,3,7
1515915625593912000,44,1,45.24,3,1,2,6
1515915625593912209,44,2,29.18,3,2,1,6
1515915625593914038,44,1,73.24,3,1,2,6
1515915625593914250,44,2,306.1,3,2,4,9
1515915625593914301,44,4,77.68,3,3,2,8
1515915625593917397,44,1,153.05,3,1,3,7
1515915625593919835,44,2,143.5,3,2,3,8
1515915625593920300,44,1,188.06,3,1,3,7
1515915625593921082,41,2,201.5,3,2,3,8
1515915625593921271,44,1,113.17,3,1,3,7
1515915625593930056,44,1,110.95,3,1,3,7
1515915625593939700,41,1,220.52,3,1,3,7
1515915625593948004,16,3,627.96,4,3,4,11
1515915625593957181,44,1,214.1,3,1,3,7
1515915625593959166,43,1,399.46,3,1,4,8
1515915625593963512,43,4,2378.24,3,3,4,10
1515915625593976475,43,6,198.96,3,4,3,10
1515915625593987181,43,1,218.98,3,1,3,7
1515915625593987706,43,1,36.14,3,1,2,6
1515915625593990740,43,1,26.19,3,1,1,5
1515915625593993561,43,2,232.38,3,2,3,8
1515915625593994453,43,1,226.84,3,1,3,7
1515915625593994806,43,1,292.83,3,1,4,8
1515915625593995925,43,1,16.19,3,1,1,5
1515915625593998572,23,3,689.34,4,3,4,11
1515915625594004954,43,1,16.35,3,1,1,5
1515915625594005080,43,1,20.71,3,1,1,5
1515915625594005201,40,24,2132.5699999999997,3,4,4,11
1515915625594013095,43,1,294.41,3,1,4,8
1515915625594013369,43,1,9.81,3,1,1,5
1515915625594014998,43,1,46.67,3,1,2,6
1515915625594015236,42,2,1021.08,3,2,4,9
1515915625594019750,43,1,349.46,3,1,4,8
1515915625594020916,38,2,227.47,3,2,3,8
1515915625594025922,43,1,43.83,3,1,2,6
1515915625594028000,43,1,32.22,3,1,1,5
1515915625594032307,43,4,151.88,3,3,3,9
1515915625594035163,43,1,466.52,3,1,4,8
1515915625594042825,43,1,897.79,3,1,4,8
1515915625594043862,43,4,590.48,3,3,4,10
1515915625594045353,38,3,267.65999999999997,3,3,3,9
1515915625594046916,43,2,57.78,3,2,2,7
1515915625594048805,43,1,179.54,3,1,3,7
1515915625594050074,43,4,200.44,3,3,3,9
1515915625594052124,28,2,605.77,4,2,4,10
1515915625594052406,43,3,254.67000000000002,3,3,3,9
1515915625594052866,43,1,32.22,3,1,1,5
1515915625594060092,39,2,165.94,3,2,3,8
1515915625594061973,42,1,187.29,3,1,3,7
1515915625594063160,43,1,16.35,3,1,1,5
1515915625594064953,43,2,973.62,3,2,4,9
1515915625594065574,43,2,20.86,3,2,1,6
1515915625594068093,43,1,290.63,3,1,4,8
1515915625594069448,43,2,585.66,3,2,4,9
1515915625594069495,43,1,572.57,3,1,4,8
1515915625594070701,43,1,294.41,3,1,4,8
1515915625594072590,43,1,572.57,3,1,4,8
1515915625594073718,43,1,64.48,3,1,2,6
1515915625594075221,43,1,16.19,3,1,1,5
1515915625594081550,43,2,841.26,3,2,4,9
1515915625594094917,43,1,36.67,3,1,2,6
1515915625594098248,43,1,448.51,3,1,4,8
1515915625594103529,43,1,466.52,3,1,4,8
1515915625594105084,43,1,397.48,3,1,4,8
1515915625594105344,38,1,577.6,3,1,4,8
1515915625594107636,43,1,29.22,3,1,1,5
1515915625594107859,43,2,794.96,3,2,4,9
1515915625594108522,43,1,444.51,3,1,4,8
1515915625594110472,43,2,226.76,3,2,3,8
1515915625594117636,43,1,309.41,3,1,4,8
1515915625594118491,43,3,1717.71,3,3,4,10
1515915625594119179,43,1,23.81,3,1,1,5
1515915625594122289,43,1,486.81,3,1,4,8
1515915625594123128,43,2,32.8,3,2,2,7
1515915625594123380,35,2,207.66,4,2,3,9
1515915625594128517,43,1,292.83,3,1,4,8
1515915625594132436,42,1,277.1,3,1,3,7
1515915625594135713,43,1,399.48,3,1,4,8
1515915625594136039,43,1,55.87,3,1,2,6
1515915625594142340,43,1,95.95,3,1,3,7
1515915625594149506,43,1,98.37,3,1,3,7
1515915625594152469,43,1,292.83,3,1,4,8
1515915625594153254,43,1,492.52,3,1,4,8
1515915625594155753,43,9,3991.5299999999997,3,4,4,11
1515915625594163209,42,2,794.96,3,2,4,9
1515915625594163807,43,1,40.48,3,1,2,6
1515915625594166021,43,2,691.8900000000001,3,2,4,9
1515915625594168742,43,1,77.73,3,1,2,6
1515915625594170285,43,3,889.1999999999999,3,3,4,10
1515915625594170528,37,1,397.48,3,1,4,8
1515915625594171338,43,1,449.51,3,1,4,8
1515915625594172385,43,2,728.92,3,2,4,9
1515915625594174999,43,1,17.81,3,1,1,5
1515915625594179891,43,2,215.08,3,2,3,8
1515915625594179997,41,4,1641.95,3,3,4,10
1515915625594180211,43,3,42.61,3,3,2,8
1515915625594188803,43,9,1175.65,3,4,4,11
1515915625594190983,2,1,294.41,4,1,4,9
1515915625594191532,9,1,215.06,4,1,3,8
1515915625594194636,43,4,393.48,3,3,4,10
1515915625594197225,43,1,43.11,3,1,2,6
1515915625594197430,42,2,605.26,3,2,4,9
1515915625594197484,10,2,64.44,4,2,2,8
1515915625594199132,43,1,110.95,3,1,3,7
1515915625594201079,43,1,274.4,3,1,3,7
1515915625594201678,43,1,631.62,3,1,4,8
1515915625594203872,37,2,568.92,3,2,4,9
1515915625594205651,43,1,1.57,3,1,1,5
1515915625594206193,43,1,50.6,3,1,2,6
1515915625594212082,43,1,11.9,3,1,1,5
1515915625594212246,43,1,397.48,3,1,4,8
1515915625594212947,43,1,274.4,3,1,3,7
1515915625594213831,42,3,878.49,3,3,4,10
1515915625594216743,38,1,51.33,3,1,2,6
1515915625594218884,43,1,33.97,3,1,2,6
1515915625594221497,32,2,32.38,4,2,2,8
1515915625594222542,31,1,539.57,4,1,4,9
1515915625594225478,43,1,397.48,3,1,4,8
1515915625594228572,43,1,397.48,3,1,4,8
1515915625594235696,43,3,279.23,3,3,3,9
1515915625594237291,43,1,292.83,3,1,4,8
1515915625594239545,41,2,585.66,3,2,4,9
1515915625594242553,31,1,10.43,4,1,1,6
1515915625594246603,42,1,373.46,3,1,4,8
1515915625594247318,43,1,166.02,3,1,3,7
1515915625594252913,39,1,203.02,3,1,3,7
1515915625594253937,43,1,167.0,3,1,3,7
1515915625594257274,43,1,441.49,3,1,4,8
1515915625594257542,19,1,399.48,4,1,4,9
1515915625594260104,43,1,10.0,3,1,1,5
1515915625594261549,43,2,568.92,3,2,4,9
1515915625594262400,43,2,515.74,3,2,4,9
1515915625594263669,42,3,60.480000000000004,3,3,2,8
1515915625594264786,31,1,187.29,4,1,3,8
1515915625594266325,43,1,10.62,3,1,1,5
1515915625594270419,12,3,376.20000000000005,4,3,4,11
1515915625594274837,33,2,194.7,4,2,3,9
1515915625594280587,43,1,56.27,3,1,2,6
1515915625594281884,43,1,599.6,3,1,4,8
1515915625594286016,43,1,12.46,3,1,1,5
1515915625594286380,24,2,585.66,4,2,4,10
1515915625594290858,43,1,82.76,3,1,2,6
1515915625594292939,43,1,3.98,3,1,1,5
1515915625594296318,43,1,397.48,3,1,4,8
1515915625594298458,43,1,213.17,3,1,3,7
1515915625594300170,43,2,405.34,3,2,4,9
1515915625594303782,42,1,46.98,3,1,2,6
1515915625594304365,42,1,797.71,3,1,4,8
1515915625594313246,42,7,131.9,3,4,3,10
1515915625594313804,43,1,25.73,3,1,1,5
1515915625594315730,43,1,16.44,3,1,1,5
1515915625594316980,43,2,398.74,3,2,4,9
1515915625594317621,43,1,32.22,3,1,1,5
1515915625594320158,36,3,341.43,3,3,4,10
1515915625594321149,42,1,14.22,3,1,1,5
1515915625594327180,42,1,226.84,3,1,3,7
1515915625594336648,42,1,397.48,3,1,4,8
1515915625594339046,20,1,168.92,4,1,3,8
1515915625594340161,42,2,7.14,3,2,1,6
1515915625594342502,42,1,669.63,3,1,4,8
1515915625594342515,42,2,1677.49,3,2,4,9
1515915625594345588,42,2,899.02,3,2,4,9
1515915625594345655,42,2,465.5,3,2,4,9
1515915625594346622,42,1,33.3,3,1,2,6
1515915625594347684,42,1,24.6,3,1,1,5
1515915625594350212,42,1,61.27,3,1,2,6
1515915625594350232,40,1,51.75,3,1,2,6
1515915625594353876,42,2,585.66,3,2,4,9
1515915625594355178,42,1,292.83,3,1,4,8
1515915625594355199,42,2,63.74,3,2,2,7
1515915625594358271,40,2,155.46,3,2,3,8
1515915625594361398,42,1,294.41,3,1,4,8
1515915625594361743,42,1,20.48,3,1,1,5
1515915625594363712,42,1,259.94,3,1,3,7
1515915625594372643,42,1,16.35,3,1,1,5
1515915625594373523,42,1,107.6,3,1,3,7
1515915625594375954,42,2,402.66,3,2,4,9
1515915625594377821,39,4,1397.84,3,3,4,10
1515915625594380102,42,2,332.06,3,2,4,9
1515915625594383471,42,3,572.1899999999999,3,3,4,10
1515915625594384178,42,1,11.83,3,1,1,5
1515915625594385750,10,1,34.44,4,1,2,7
1515915625594385904,42,1,1.57,3,1,1,5
1515915625594391676,42,1,45.3,3,1,2,6
1515915625594395441,42,1,42.98,3,1,2,6
1515915625594395919,40,2,624.32,3,2,4,9
1515915625594396192,42,1,214.1,3,1,3,7
1515915625594400257,33,2,1184.16,4,2,4,10
1515915625594401864,42,2,43.0,3,2,2,7
1515915625594408667,42,1,292.83,3,1,4,8
1515915625594409490,41,1,113.81,3,1,3,7
1515915625594411104,41,1,276.71,3,1,3,7
1515915625594412517,42,1,214.1,3,1,3,7
1515915625594413507,33,3,567.51,4,3,4,11
1515915625594416992,42,1,10.62,3,1,1,5
1515915625594419141,42,1,26.9,3,1,1,5
1515915625594419582,35,1,496.67,4,1,4,9
1515915625594421877,42,1,35.08,3,1,2,6
1515915625594422878,42,1,78.14,3,1,2,6
1515915625594424278,42,1,250.38,3,1,3,7
1515915625594425260,36,1,33.29,3,1,2,6
1515915625594425516,42,1,449.51,3,1,4,8
1515915625594431997,41,1,259.38,3,1,3,7
1515915625594432068,42,2,588.82,3,2,4,9
1515915625594432567,42,1,250.38,3,1,3,7
1515915625594433853,29,1,214.1,4,1,3,8
1515915625594434011,42,1,34.43,3,1,2,6
1515915625594436007,42,1,118.57,3,1,3,7
1515915625594436522,42,1,121.78,3,1,3,7
1515915625594438378,42,2,597.24,3,2,4,9
1515915625594438827,42,1,72.38,3,1,2,6
1515915625594440145,42,1,201.33,3,1,3,7
1515915625594441009,42,1,399.48,3,1,4,8
1515915625594444358,42,1,314.41,3,1,4,8
1515915625594445735,42,1,203.02,3,1,3,7
1515915625594446110,42,1,9.81,3,1,1,5
1515915625594449201,42,4,1770.04,3,3,4,10
1515915625594451595,39,1,519.56,3,1,4,8
1515915625594455627,42,1,435.7,3,1,4,8
1515915625594456337,42,1,44.76,3,1,2,6
1515915625594464490,33,9,434.43,4,4,4,12
1515915625594464552,42,1,78.89,3,1,2,6
1515915625594468234,42,1,259.38,3,1,3,7
1515915625594473118,42,2,53.66,3,2,2,7
1515915625594474713,42,2,501.24,3,2,4,9
1515915625594474813,5,3,34.86,4,3,2,9
1515915625594475859,20,2,506.76,4,2,4,10
1515915625594476447,42,2,585.66,3,2,4,9
1515915625594478681,42,1,65.08,3,1,2,6
1515915625594481040,42,1,294.41,3,1,4,8
1515915625594481525,42,1,4.29,3,1,1,5
1515915625594482620,18,1,251.4,4,1,3,8
1515915625594497232,42,1,126.68,3,1,3,7
1515915625594497927,42,1,256.22,3,1,3,7
1515915625594504191,42,4,158.98,3,3,3,9
1515915625594505228,42,1,187.29,3,1,3,7
1515915625594512103,42,4,1589.92,3,3,4,10
1515915625594513254,42,2,585.66,3,2,4,9
1515915625594514150,42,1,56.98,3,1,2,6
1515915625594514288,42,1,136.05,3,1,3,7
1515915625594516511,41,2,304.54,3,2,4,9
1515915625594519014,42,1,312.43,3,1,4,8
1515915625594519194,42,1,77.37,3,1,2,6
1515915625594520084,42,1,21.43,3,1,1,5
1515915625594520647,33,1,397.48,4,1,4,9
1515915625594521240,39,1,61.27,3,1,2,6
1515915625594527420,42,1,86.56,3,1,2,6
1515915625594529800,42,1,21.32,3,1,1,5
1515915625594533011,42,1,64.48,3,1,2,6
1515915625594534251,28,1,16.19,4,1,1,6
1515915625594534276,42,1,15.1,3,1,1,5
1515915625594534291,42,1,113.02,3,1,3,7
1515915625594537210,42,1,30.83,3,1,1,5
1515915625594537917,42,2,49.24,3,2,2,7
1515915625594538019,42,1,15.25,3,1,1,5
1515915625594538126,40,2,282.02,3,2,3,8
1515915625594540314,41,1,140.86,3,1,3,7
1515915625594542723,35,2,342.68,4,2,4,10
1515915625594543274,29,2,886.29,4,2,4,10
1515915625594543482,42,1,600.6,3,1,4,8
1515915625594545733,42,3,254.85000000000002,3,3,3,9
1515915625594546177,42,2,169.9,3,2,3,8
1515915625594547405,42,1,146.3,3,1,3,7
1515915625594547540,41,3,121.71000000000001,3,3,3,9
1515915625594554134,22,2,846.99,4,2,4,10
1515915625594555216,35,1,897.79,4,1,4,9
1515915625594557999,42,4,257.92,3,3,3,9
1515915625594558024,42,1,51.33,3,1,2,6
1515915625594560001,8,7,2526.17,4,4,4,12
1515915625594563959,41,1,9.95,3,1,1,5
1515915625594564315,41,3,154.77,3,3,3,9
1515915625594564935,42,4,1031.48,3,3,4,10
1515915625594568648,26,1,202.67,4,1,3,8
1515915625594569038,42,2,1095.94,3,2,4,9
1515915625594570666,42,7,153.44,3,4,3,10
1515915625594572040,42,2,1252.22,3,2,4,9
1515915625594572276,42,1,23.62,3,1,1,5
1515915625594572795,41,1,201.33,3,1,3,7
1515915625594579070,31,3,567.51,4,3,4,11
1515915625594581842,41,2,194.28,3,2,3,8
1515915625594586655,42,1,198.38,3,1,3,7
1515915625594589687,42,2,1039.12,3,2,4,9
1515915625594590115,37,3,760.14,3,3,4,10
1515915625594591044,42,1,203.3,3,1,3,7
1515915625594592000,42,1,656.63,3,1,4,8
1515915625594596618,42,2,694.78,3,2,4,9
1515915625594600406,42,1,897.79,3,1,4,8
1515915625594601662,42,4,339.56,3,3,4,10
1515915625594602905,42,3,1096.23,3,3,4,10
1515915625594614288,42,1,140.02,3,1,3,7
1515915625594620012,42,1,373.46,3,1,4,8
1515915625594621401,35,1,1.57,4,1,1,6
1515915625594623940,42,2,242.58,3,2,3,8
1515915625594624625,40,1,60.83,3,1,2,6
1515915625594625689,42,2,518.76,3,2,4,9
1515915625594628156,42,1,87.05,3,1,2,6
1515915625594628637,42,1,20.32,3,1,1,5
1515915625594629105,42,3,132.14999999999998,3,3,3,9
1515915625594632342,40,1,118.57,3,1,3,7
1515915625594632421,42,1,41.59,3,1,2,6
1515915625594632857,12,3,182.49,4,3,3,10
1515915625594634337,42,2,343.8,3,2,4,9
1515915625594635684,35,2,118.64,4,2,3,9
1515915625594637668,7,1,349.46,4,1,4,9
1515915625594642321,42,1,482.52,3,1,4,8
1515915625594650480,41,3,2627.33,3,3,4,10
1515915625594650481,42,2,49.84,3,2,2,7
1515915625594653171,42,2,419.35,3,2,4,9
1515915625594653924,42,1,214.1,3,1,3,7
1515915625594654053,42,2,794.96,3,2,4,9
1515915625594657282,42,2,417.73,3,2,4,9
1515915625594658290,42,2,147.5,3,2,3,8
1515915625594658475,42,1,201.33,3,1,3,7
1515915625594660460,42,1,19.76,3,1,1,5
1515915625594664494,42,1,9.35,3,1,1,5
1515915625594665888,42,4,353.28,3,3,4,10
1515915625594669819,42,1,9.84,3,1,1,5
1515915625594670044,42,1,9.37,3,1,1,5
1515915625594678635,3,2,52.34,4,2,2,8
1515915625594680340,42,1,9.79,3,1,1,5
1515915625594681931,42,1,40.9,3,1,2,6
1515915625594682730,42,1,13.16,3,1,1,5
1515915625594683910,42,1,202.67,3,1,3,7
1515915625594685343,41,1,65.4,3,1,2,6
1515915625594685514,42,1,263.52,3,1,3,7
1515915625594685885,42,1,32.22,3,1,1,5
1515915625594697366,28,3,2159.01,4,3,4,11
1515915625594699273,19,4,877.58,4,3,4,11
1515915625594702245,41,1,294.41,3,1,4,8
1515915625594703765,41,1,109.84,3,1,3,7
1515915625594712884,41,1,292.83,3,1,4,8
1515915625594715558,41,2,20.26,3,2,1,6
1515915625594718218,32,1,99.92,4,1,3,8
1515915625594720103,41,1,42.21,3,1,2,6
1515915625594720476,30,4,491.44,4,3,4,11
1515915625594722213,41,4,41.72,3,3,2,8
1515915625594726685,41,1,202.67,3,1,3,7
1515915625594727562,41,1,60.83,3,1,2,6
1515915625594727630,40,2,1079.14,3,2,4,9
1515915625594730338,41,1,19.33,3,1,1,5
1515915625594733576,40,1,87.56,3,1,2,6
1515915625594736154,34,3,1447.56,4,3,4,11
1515915625594737441,41,2,36.04,3,2,2,7
1515915625594744696,41,1,292.83,3,1,4,8
1515915625594747265,41,1,22.22,3,1,1,5
1515915625594749564,41,1,33.08,3,1,2,6
1515915625594750290,41,1,32.97,3,1,2,6
1515915625594750390,41,6,76.2,3,4,2,9
1515915625594750736,41,1,94.46,3,1,3,7
1515915625594751391,41,1,94.46,3,1,3,7
1515915625594754444,41,2,634.45,3,2,4,9
1515915625594757124,41,6,642.56,3,4,4,11
1515915625594758118,32,1,25.1,4,1,1,6
1515915625594758459,41,5,25.7,3,4,1,8
1515915625594759113,41,1,42.06,3,1,2,6
1515915625594759531,41,1,140.86,3,1,3,7
1515915625594759803,27,5,162.7,4,4,3,11
1515915625594763157,41,1,3.21,3,1,1,5
1515915625594764231,41,1,94.46,3,1,3,7
1515915625594765089,41,1,797.71,3,1,4,8
1515915625594766667,41,1,202.67,3,1,3,7
1515915625594766910,18,1,519.56,4,1,4,9
1515915625594770733,18,2,428.2,4,2,4,10
1515915625594773029,41,2,154.64,3,2,3,8
1515915625594775998,41,1,600.6,3,1,4,8
1515915625594779182,41,1,97.14,3,1,3,7
1515915625594781940,41,8,171.44,3,4,3,10
1515915625594782103,41,1,103.83,3,1,3,7
1515915625594783278,41,1,103.83,3,1,3,7
1515915625594783511,41,2,30.8,3,2,1,6
1515915625594787298,41,2,128.96,3,2,3,8
1515915625594787448,41,1,65.4,3,1,2,6
1515915625594788545,41,1,34.62,3,1,2,6
1515915625594790255,40,3,803.46,3,3,4,10
1515915625594795682,30,2,587.24,4,2,4,10
1515915625594795929,27,3,129.32999999999998,4,3,3,10
1515915625594798362,40,8,2021.95,3,4,4,11
1515915625594799957,41,1,13.89,3,1,1,5
1515915625594803276,41,1,292.83,3,1,4,8
1515915625594804739,41,1,55.16,3,1,2,6
1515915625594809056,41,4,1108.56,3,3,4,10
1515915625594809970,41,2,798.96,3,2,4,9
1515915625594815034,39,1,14.08,3,1,1,5
1515915625594815247,39,1,46.98,3,1,2,6
1515915625594819435,41,1,35.87,3,1,2,6
1515915625594821333,40,6,681.58,3,4,4,11
1515915625594823578,41,1,48.73,3,1,2,6
1515915625594823897,41,1,15.24,3,1,1,5
1515915625594827679,41,1,77.73,3,1,2,6
1515915625594827749,21,6,403.79999999999995,4,4,4,12
1515915625594829919,39,2,106.12,3,2,3,8
1515915625594830632,41,1,51.68,3,1,2,6
1515915625594834877,40,3,1706.01,3,3,4,10
1515915625594835172,41,1,30.38,3,1,1,5
1515915625594844483,41,1,268.17,3,1,3,7
1515915625594846378,41,3,196.20000000000002,3,3,3,9
1515915625594851397,41,1,486.81,3,1,4,8
1515915625594855921,41,1,214.1,3,1,3,7
1515915625594857363,6,8,2423.87,4,4,4,12
1515915625594859441,41,1,65.71,3,1,2,6
1515915625594861244,41,2,691.8900000000001,3,2,4,9
1515915625594865117,10,4,253.49,4,3,3,10
1515915625594867500,41,1,214.1,3,1,3,7
1515915625594869976,41,1,22.51,3,1,1,5
1515915625594874486,41,3,878.49,3,3,4,10
1515915625594874600,41,1,292.83,3,1,4,8
1515915625594874837,41,1,879.78,3,1,4,8
1515915625594874849,41,1,515.56,3,1,4,8
1515915625594879852,33,2,62.54,4,2,2,8
1515915625594881245,41,3,3210.91,3,3,4,10
1515915625594883544,41,1,382.94,3,1,4,8
1515915625594885918,41,4,331.68,3,3,4,10
1515915625594886427,41,1,99.92,3,1,3,7
1515915625594888047,36,3,101.91,3,3,3,9
1515915625594888075,41,2,421.58,3,2,4,9
1515915625594889077,8,5,2057.42,4,4,4,12
1515915625594889360,41,1,577.6,3,1,4,8
1515915625594889487,41,1,9.35,3,1,1,5
1515915625594889519,41,1,397.48,3,1,4,8
1515915625594895062,41,2,111.2,3,2,3,8
1515915625594904317,41,1,214.1,3,1,3,7
1515915625594905100,41,1,99.51,3,1,3,7
1515915625594905576,41,1,448.51,3,1,4,8
1515915625594906380,41,1,187.29,3,1,3,7
1515915625594907425,41,3,1369.53,3,3,4,10
1515915625594908911,41,1,294.41,3,1,4,8
1515915625594912473,41,2,41.66,3,2,2,7
1515915625594913862,41,1,548.37,3,1,4,8
1515915625594915231,41,2,64.76,3,2,2,7
1515915625594917666,41,1,93.43,3,1,3,7
1515915625594918678,41,1,140.86,3,1,3,7
1515915625594919003,41,1,10.16,3,1,1,5
1515915625594923029,39,1,609.6,3,1,4,8
1515915625594925799,41,1,277.1,3,1,3,7
1515915625594927022,41,1,31.67,3,1,1,5
1515915625594929860,41,1,449.51,3,1,4,8
1515915625594931465,14,1,166.02,4,1,3,8
1515915625594932191,41,4,917.52,3,3,4,10
1515915625594932439,41,1,21.21,3,1,1,5
1515915625594932510,41,1,154.32,3,1,3,7
1515915625594932790,41,1,64.48,3,1,2,6
1515915625594934137,39,3,386.28,3,3,4,10
1515915625594935263,40,2,690.88,3,2,4,9
1515915625594935368,41,1,292.83,3,1,4,8
1515915625594936563,40,3,85.24000000000001,3,3,2,8
1515915625594937582,41,1,486.81,3,1,4,8
1515915625594939567,41,1,292.83,3,1,4,8
1515915625594943508,41,1,486.81,3,1,4,8
1515915625594944171,40,2,27.72,3,2,1,6
1515915625594945586,41,2,182.44,3,2,3,8
1515915625594946439,34,4,55.16,4,3,2,9
1515915625594950712,25,1,9.79,4,1,1,6
1515915625594951612,41,1,399.48,3,1,4,8
1515915625594953422,41,1,229.38,3,1,3,7
1515915625594953917,41,1,337.44,3,1,4,8
1515915625594955539,41,1,126.68,3,1,3,7
1515915625594957983,39,1,397.48,3,1,4,8
1515915625594959467,23,1,519.56,4,1,4,9
1515915625594961292,41,1,294.41,3,1,4,8
1515915625594961571,41,1,51.21,3,1,2,6
1515915625594962410,41,1,53.9,3,1,2,6
1515915625594963805,41,1,382.94,3,1,4,8
1515915625594963862,41,1,218.98,3,1,3,7
1515915625594964172,41,1,397.48,3,1,4,8
1515915625594970893,41,4,960.44,3,3,4,10
1515915625594972562,41,1,9.35,3,1,1,5
1515915625594972773,41,1,202.67,3,1,3,7
1515915625594974547,41,2,742.3399999999999,3,2,4,9
1515915625594975294,39,2,178.44,3,2,3,8
1515915625594976072,9,1,73.81,4,1,2,7
1515915625594978115,41,3,96.66,3,3,3,9
1515915625594981332,41,1,479.51,3,1,4,8
1515915625594981589,40,1,16.19,3,1,1,5
1515915625594984793,41,1,49.21,3,1,2,6
1515915625594985355,41,1,20.19,3,1,1,5
1515915625594987220,41,2,405.96,3,2,4,9
1515915625594990791,11,2,603.24,4,2,4,10
1515915625594991219,41,1,373.46,3,1,4,8
1515915625594991392,35,2,1029.12,4,2,4,10
1515915625594995370,41,1,490.54,3,1,4,8
1515915625594999516,41,7,454.28000000000003,3,4,4,11
1515915625594999619,40,2,591.4,3,2,4,9
1515915625595003147,2,7,479.4,4,4,4,12
1515915625595007753,41,2,18.7,3,2,1,6
1515915625595008134,41,1,180.79,3,1,3,7
1515915625595008831,41,2,563.81,3,2,4,9
1515915625595009199,41,1,397.48,3,1,4,8
1515915625595011009,41,1,471.52,3,1,4,8
1515915625595014120,39,1,292.83,3,1,4,8
1515915625595014994,39,2,68.26,3,2,2,7
1515915625595018580,41,2,899.02,3,2,4,9
1515915625595023435,41,3,280.11,3,3,3,9
1515915625595023608,41,1,127.08,3,1,3,7
1515915625595024145,41,3,224.52,3,3,3,9
1515915625595025646,2,3,491.74,4,3,4,11
1515915625595029362,41,2,608.82,3,2,4,9
1515915625595029552,39,2,899.02,3,2,4,9
1515915625595030922,40,7,1228.82,3,4,4,11
1515915625595033553,41,3,69.81,3,3,2,8
1515915625595034171,40,10,1290.21,3,4,4,11
1515915625595034619,41,2,794.96,3,2,4,9
1515915625595036006,41,1,371.46,3,1,4,8
1515915625595036961,41,1,34.38,3,1,2,6
1515915625595043906,41,1,27.32,3,1,1,5
1515915625595048597,40,3,823.1999999999999,3,3,4,10
1515915625595051428,40,1,214.1,3,1,3,7
1515915625595052353,40,2,172.96,3,2,3,8
1515915625595053600,40,1,572.57,3,1,4,8
1515915625595056607,40,1,397.48,3,1,4,8
1515915625595057217,40,1,600.6,3,1,4,8
1515915625595057275,40,3,1598.68,3,3,4,10
1515915625595058261,40,1,656.63,3,1,4,8
1515915625595062162,30,2,1109.14,4,2,4,10
1515915625595069350,39,2,428.2,3,2,4,9
1515915625595069930,40,2,64.44,3,2,2,7
1515915625595070182,40,1,14.95,3,1,1,5
1515915625595071725,40,1,97.35,3,1,3,7
1515915625595075217,6,21,4794.84,4,4,4,12
1515915625595078036,40,1,274.4,3,1,3,7
1515915625595083086,40,1,55.75,3,1,2,6
1515915625595085616,40,1,19.49,3,1,1,5
1515915625595088209,40,1,61.29,3,1,2,6
1515915625595088507,40,2,165.78,3,2,3,8
1515915625595089836,40,1,16.33,3,1,1,5
1515915625595090259,40,2,31.74,3,2,1,6
1515915625595094854,40,2,94.82,3,2,3,8
1515915625595094931,40,1,295.7,3,1,4,8
1515915625595097332,39,3,364.20000000000005,3,3,4,10
1515915625595098395,38,1,471.52,3,1,4,8
1515915625595099374,40,1,27.14,3,1,1,5
1515915625595101365,40,3,97.14000000000001,3,3,3,9
1515915625595104562,40,1,294.41,3,1,4,8
1515915625595106459,40,10,654.05,3,4,4,11
1515915625595110877,40,3,1307.1,3,3,4,10
1515915625595111006,40,1,397.48,3,1,4,8
1515915625595111213,40,5,2597.7999999999997,3,4,4,11
1515915625595116472,40,1,77.73,3,1,2,6
1515915625595118631,40,1,149.32,3,1,3,7
1515915625595119252,40,1,22.32,3,1,1,5
1515915625595120883,40,1,253.38,3,1,3,7
1515915625595122069,40,1,373.46,3,1,4,8
1515915625595126729,40,1,25.4,3,1,1,5
1515915625595127615,40,2,28.16,3,2,1,6
1515915625595129203,40,1,48.84,3,1,2,6
1515915625595130905,37,3,608.01,3,3,4,10
1515915625595131159,40,8,894.3399999999999,3,4,4,11
1515915625595133506,40,2,37.4,3,2,2,7
1515915625595133716,40,1,16.98,3,1,1,5
1515915625595133844,40,1,28.89,3,1,1,5
1515915625595134606,27,1,466.52,4,1,4,9
1515915625595135994,40,7,752.66,3,4,4,11
1515915625595137766,40,2,512.44,3,2,4,9
1515915625595139679,40,1,39.37,3,1,2,6
1515915625595139692,40,3,39.06,3,3,2,8
1515915625595140823,39,2,981.08,3,2,4,9
1515915625595141953,40,5,53.02,3,4,2,9
1515915625595142907,40,1,220.95,3,1,3,7
1515915625595145426,40,4,331.88,3,3,4,10
1515915625595146055,40,1,74.83,3,1,2,6
1515915625595156463,40,1,60.83,3,1,2,6
1515915625595158838,40,1,479.51,3,1,4,8
1515915625595160201,40,1,40.48,3,1,2,6
1515915625595162686,11,1,15.4,4,1,1,6
1515915625595162880,40,6,985.98,3,4,4,11
1515915625595164249,40,1,60.83,3,1,2,6
1515915625595164386,40,1,299.41,3,1,4,8
1515915625595167072,40,1,40.63,3,1,2,6
1515915625595168395,40,1,69.35,3,1,2,6
1515915625595168505,40,1,21.81,3,1,1,5
1515915625595168867,39,2,818.74,3,2,4,9
1515915625595169354,40,1,399.48,3,1,4,8
1515915625595169585,40,1,294.41,3,1,4,8
1515915625595171598,40,2,34.52,3,2,2,7
1515915625595176434,40,1,373.46,3,1,4,8
1515915625595177404,40,1,163.52,3,1,3,7
1515915625595178605,40,1,23.33,3,1,1,5
1515915625595178607,40,1,30.48,3,1,1,5
1515915625595178653,36,8,995.59,3,4,4,11
1515915625595187160,40,1,231.24,3,1,3,7
1515915625595189599,40,1,397.48,3,1,4,8
1515915625595191327,40,1,86.67,3,1,2,6
1515915625595194635,40,1,292.83,3,1,4,8
1515915625595194934,40,1,300.17,3,1,4,8
1515915625595195453,40,2,643.87,3,2,4,9
1515915625595198551,40,1,404.49,3,1,4,8
1515915625595200520,40,1,397.48,3,1,4,8
1515915625595201174,40,1,171.9,3,1,3,7
1515915625595201833,40,2,253.36,3,2,3,8
1515915625595203272,40,15,271.5,3,4,3,10
1515915625595205262,40,2,24.76,3,2,1,6
1515915625595205393,40,2,428.2,3,2,4,9
1515915625595206100,40,2,58.26,3,2,2,7
1515915625595206528,40,1,257.87,3,1,3,7
1515915625595211068,38,1,23.4,3,1,1,5
1515915625595213036,40,2,30.71,3,2,1,6
1515915625595213151,40,1,304.41,3,1,4,8
1515915625595215424,40,2,30.16,3,2,1,6
1515915625595218248,40,1,171.9,3,1,3,7
1515915625595219974,40,1,205.16,3,1,3,7
1515915625595220053,37,1,656.63,3,1,4,8
1515915625595221308,40,1,29.89,3,1,1,5
1515915625595224288,40,1,466.52,3,1,4,8
1515915625595229031,30,1,399.48,4,1,4,9
1515915625595229533,40,1,65.02,3,1,2,6
1515915625595231416,40,1,15.87,3,1,1,5
1515915625595232115,40,1,149.32,3,1,3,7
1515915625595235342,40,1,415.54,3,1,4,8
1515915625595235457,40,2,508.76,3,2,4,9
1515915625595237608,20,3,391.3,4,3,4,11
1515915625595237828,40,2,61.26,3,2,2,7
1515915625595248981,3,1,466.52,4,1,4,9
1515915625595249091,40,1,52.87,3,1,2,6
1515915625595251857,37,1,292.83,3,1,4,8
1515915625595253875,40,1,164.33,3,1,3,7
1515915625595258502,40,2,506.92999999999995,3,2,4,9
1515915625595259165,40,3,749.6600000000001,3,3,4,10
1515915625595260492,40,1,55.87,3,1,2,6
1515915625595261322,39,1,13.87,3,1,1,5
1515915625595262182,40,1,88.25,3,1,2,6
1515915625595264536,25,2,585.66,4,2,4,10
1515915625595264816,39,2,165.94,3,2,3,8
1515915625595266564,40,1,133.7,3,1,3,7
1515915625595266698,40,1,38.83,3,1,2,6
1515915625595266958,23,2,102.66,4,2,3,9
1515915625595271558,24,3,1773.77,4,3,4,11
1515915625595272994,40,1,397.48,3,1,4,8
1515915625595273307,40,1,214.1,3,1,3,7
1515915625595274302,40,1,102.11,3,1,3,7
1515915625595274824,40,1,113.81,3,1,3,7
1515915625595275575,40,1,102.11,3,1,3,7
1515915625595277791,40,1,418.48,3,1,4,8
1515915625595278749,40,1,16.98,3,1,1,5
1515915625595282051,40,4,205.32,3,3,3,9
1515915625595283684,36,5,1768.72,3,4,4,11
1515915625595285976,40,1,214.1,3,1,3,7
1515915625595288904,40,1,176.17,3,1,3,7
1515915625595289512,40,1,77.78,3,1,2,6
1515915625595289669,40,1,203.02,3,1,3,7
1515915625595291356,40,2,122.78,3,2,3,8
1515915625595292907,40,1,34.6,3,1,2,6
1515915625595293081,40,1,1.57,3,1,1,5
1515915625595293182,21,2,34.34,4,2,2,8
1515915625595294612,40,1,39.9,3,1,2,6
1515915625595294990,40,1,205.25,3,1,3,7
1515915625595302344,40,1,257.87,3,1,3,7
1515915625595303625,40,1,42.68,3,1,2,6
1515915625595307373,40,2,20.16,3,2,1,6
1515915625595307662,40,1,51.68,3,1,2,6
1515915625595307760,40,1,274.4,3,1,3,7
1515915625595308017,40,1,43.19,3,1,2,6
1515915625595310073,40,2,913.02,3,2,4,9
1515915625595317972,15,1,17.73,4,1,1,6
1515915625595319026,40,1,96.37,3,1,3,7
1515915625595322524,40,3,4.71,3,3,1,7
1515915625595327966,40,1,471.52,3,1,4,8
1515915625595328014,38,1,43.81,3,1,2,6
1515915625595331975,40,1,294.41,3,1,4,8
1515915625595333777,40,1,126.68,3,1,3,7
1515915625595334500,40,3,813.1700000000001,3,3,4,10
1515915625595334820,35,1,17.49,4,1,1,6
1515915625595335134,40,1,577.6,3,1,4,8
1515915625595336713,39,3,1330.52,3,3,4,10
1515915625595340561,40,1,292.83,3,1,4,8
1515915625595342057,40,2,134.54,3,2,3,8
1515915625595348647,40,3,91.44,3,3,3,9
1515915625595349624,25,3,364.11,4,3,4,11
1515915625595349786,35,2,221.9,4,2,3,9
1515915625595355999,40,1,418.48,3,1,4,8
1515915625595361611,40,2,54.2,3,2,2,7
1515915625595366843,39,5,1014.75,3,4,4,11
1515915625595367921,39,8,861.44,3,4,4,11
1515915625595372301,39,3,364.28999999999996,3,3,4,10
1515915625595379444,40,3,1076.2,3,3,4,10
1515915625595380071,40,2,33.96,3,2,2,7
1515915625595382282,19,3,647.61,4,3,4,11
1515915625595382972,40,1,29.68,3,1,1,5
1515915625595389229,1,3,603.99,4,3,4,11
1515915625595390489,39,1,284.46,3,1,3,7
1515915625595391320,39,2,253.36,3,2,3,8
1515915625595398474,39,1,77.41,3,1,2,6
1515915625595406811,39,1,119.7,3,1,3,7
1515915625595407760,39,1,548.37,3,1,4,8
1515915625595408631,39,1,15.87,3,1,1,5
1515915625595410993,37,2,794.96,3,2,4,9
1515915625595412189,39,1,170.0,3,1,3,7
1515915625595416813,39,1,62.71,3,1,2,6
1515915625595419606,39,1,449.51,3,1,4,8
1515915625595426733,39,1,5.71,3,1,1,5
1515915625595429205,39,3,64.61,3,3,2,8
1515915625595430714,39,1,292.83,3,1,4,8
1515915625595431666,39,1,25.08,3,1,1,5
1515915625595431997,39,1,30.16,3,1,1,5
1515915625595436642,39,1,72.19,3,1,2,6
1515915625595438214,39,1,230.35,3,1,3,7
1515915625595442111,38,4,1998.1100000000001,3,3,4,10
1515915625595442414,39,1,11.9,3,1,1,5
1515915625595442439,35,6,222.99,4,4,3,11
1515915625595447134,39,2,30.490000000000002,3,2,1,6
1515915625595447411,39,1,294.41,3,1,4,8
1515915625595453095,39,1,435.7,3,1,4,8
1515915625595455518,39,1,486.81,3,1,4,8
1515915625595458788,39,1,587.6,3,1,4,8
1515915625595461285,33,1,11.9,4,1,1,6
1515915625595462726,9,1,12.46,4,1,1,6
1515915625595462784,38,2,1285.24,3,2,4,9
1515915625595464119,39,2,1003.08,3,2,4,9
1515915625595470033,39,1,249.02,3,1,3,7
1515915625595471088,27,3,87.66,4,3,2,9
1515915625595476045,39,4,91.16,3,3,3,9
1515915625595476679,39,1,457.51,3,1,4,8
1515915625595478546,39,1,61.29,3,1,2,6
1515915625595479329,39,1,29.52,3,1,1,5
1515915625595480212,39,1,80.03,3,1,2,6
1515915625595481330,39,2,836.96,3,2,4,9
1515915625595482518,39,10,1124.61,3,4,4,11
1515915625595482628,39,1,155.1,3,1,3,7
1515915625595483116,8,3,341.43,4,3,4,11
1515915625595486412,39,1,35.08,3,1,2,6
1515915625595486703,38,2,103.36,3,2,3,8
1515915625595489477,39,3,777.18,3,3,4,10
1515915625595492449,39,1,9.35,3,1,1,5
1515915625595493699,39,2,36.6,3,2,2,7
1515915625595494338,39,4,1898.1200000000001,3,3,4,10
1515915625595496698,39,1,204.79,3,1,3,7
1515915625595497459,39,1,14.6,3,1,1,5
1515915625595498127,39,1,18.41,3,1,1,5
1515915625595498185,39,1,22.79,3,1,1,5
1515915625595499855,39,2,221.9,3,2,3,8
1515915625595500098,32,1,521.56,4,1,4,9
1515915625595501375,39,2,230.8,3,2,3,8
1515915625595503668,39,1,294.41,3,1,4,8
1515915625595503724,39,1,435.7,3,1,4,8
1515915625595504957,39,1,75.71,3,1,2,6
1515915625595513705,39,1,27.62,3,1,1,5
1515915625595515156,39,1,572.57,3,1,4,8
1515915625595515966,39,1,40.63,3,1,2,6
1515915625595516719,35,3,1912.8600000000001,4,3,4,11
1515915625595518596,39,2,355.52,3,2,4,9
1515915625595519415,39,1,547.97,3,1,4,8
1515915625595525642,39,3,61.89,3,3,2,8
1515915625595528340,39,2,47.62,3,2,2,7
1515915625595533220,38,1,269.4,3,1,3,7
1515915625595534300,39,1,384.48,3,1,4,8
1515915625595536651,39,1,13.86,3,1,1,5
1515915625595541985,39,1,214.1,3,1,3,7
1515915625595542334,39,2,35.8,3,2,2,7
1515915625595543732,39,2,186.86,3,2,3,8
1515915625595544441,20,1,229.68,4,1,3,8
1515915625595548553,39,1,82.97,3,1,2,6
1515915625595548889,33,4,81.84,4,3,2,9
1515915625595556705,39,3,50.34,3,3,2,8
1515915625595557622,39,1,35.11,3,1,2,6
1515915625595558688,33,2,64.44,4,2,2,8
1515915625595561065,11,2,440.66999999999996,4,2,4,10
1515915625595564642,39,3,332.85,3,3,4,10
1515915625595566091,11,1,414.13,4,1,4,9
1515915625595566112,39,1,121.29,3,1,3,7
1515915625595568831,39,3,124.75999999999999,3,3,3,9
1515915625595577827,39,3,64.28999999999999,3,3,2,8
1515915625595580465,39,1,257.87,3,1,3,7
1515915625595580826,39,2,20.96,3,2,1,6
1515915625595582469,39,1,15.1,3,1,1,5
1515915625595585970,39,1,415.54,3,1,4,8
1515915625595593294,39,1,15.1,3,1,1,5
1515915625595594588,39,1,600.6,3,1,4,8
1515915625595594917,39,1,187.29,3,1,3,7
1515915625595601903,34,8,2253.4300000000003,4,4,4,12
1515915625595603265,14,1,36.14,4,1,2,7
1515915625595605521,39,1,32.22,3,1,1,5
1515915625595610801,36,1,36.14,3,1,2,6
1515915625595611144,39,1,202.67,3,1,3,7
1515915625595611349,39,1,314.41,3,1,4,8
1515915625595613668,6,1,140.11,4,1,3,8
1515915625595620530,39,1,229.38,3,1,3,7
1515915625595621347,39,1,202.67,3,1,3,7
1515915625595622843,39,1,33.49,3,1,2,6
1515915625595627461,7,1,331.59,4,1,4,9
1515915625595628432,39,1,32.22,3,1,1,5
1515915625595628938,39,2,375.56,3,2,4,9
1515915625595636242,34,1,73.81,4,1,2,7
1515915625595637319,39,1,10.14,3,1,1,5
1515915625595638577,38,1,86.16,3,1,2,6
1515915625595639567,39,1,603.62,3,1,4,8
1515915625595641462,39,1,14.29,3,1,1,5
1515915625595642953,39,1,9.21,3,1,1,5
1515915625595647196,39,1,44.13,3,1,2,6
1515915625595650588,39,1,464.52,3,1,4,8
1515915625595654066,39,1,27.65,3,1,1,5
1515915625595655172,37,2,5.72,3,2,1,6
1515915625595659004,39,2,933.04,3,2,4,9
1515915625595660081,31,2,1417.35,4,2,4,10
1515915625595660239,19,2,794.96,4,2,4,10
1515915625595663741,39,2,43.8,3,2,2,7
1515915625595664722,32,4,3523.12,4,3,4,11
1515915625595664746,38,6,772.31,3,4,4,11
1515915625595664924,39,2,251.38,3,2,3,8
1515915625595665337,39,1,486.81,3,1,4,8
1515915625595665714,39,1,55.87,3,1,2,6
1515915625595666323,39,1,397.48,3,1,4,8
1515915625595666357,39,1,13.1,3,1,1,5
1515915625595666832,39,1,26.19,3,1,1,5
1515915625595671669,9,1,93.51,4,1,3,8
1515915625595676270,39,1,79.68,3,1,2,6
1515915625595677401,20,1,631.62,4,1,4,9
1515915625595677752,39,1,251.4,3,1,3,7
1515915625595678498,39,2,22.86,3,2,1,6
1515915625595678751,39,1,397.48,3,1,4,8
1515915625595684005,39,1,397.48,3,1,4,8
1515915625595687495,39,1,16.65,3,1,1,5
1515915625595689007,39,1,443.86,3,1,4,8
1515915625595689417,39,3,217.14,3,3,3,9
1515915625595693388,37,3,904.24,3,3,4,10
1515915625595693413,10,2,408.58,4,2,4,10
1515915625595693874,39,1,15.08,3,1,1,5
1515915625595697086,39,2,418.36,3,2,4,9
1515915625595699623,39,1,19.05,3,1,1,5
1515915625595700599,39,1,144.51,3,1,3,7
1515915625595703531,39,1,19.05,3,1,1,5
1515915625595704576,39,1,834.75,3,1,4,8
1515915625595706993,39,4,1681.98,3,3,4,10
1515915625595709600,38,2,61.5,3,2,2,7
1515915625595714784,39,1,263.38,3,1,3,7
1515915625595717357,39,1,292.83,3,1,4,8
1515915625595718377,39,4,758.8199999999999,3,3,4,10
1515915625595718781,39,1,10.16,3,1,1,5
1515915625595729617,38,2,888.02,3,2,4,9
1515915625595733195,36,2,253.36,3,2,3,8
1515915625595733582,18,3,980.4499999999999,4,3,4,11
1515915625595736534,39,2,1462.3600000000001,3,2,4,9
1515915625595738064,37,3,884.26,3,3,4,10
1515915625595742378,38,1,45.24,3,1,2,6
1515915625595745352,16,4,1012.78,4,3,4,11
1515915625595752511,38,1,349.46,3,1,4,8
1515915625595752600,13,1,269.4,4,1,3,8
1515915625595753289,38,3,908.1299999999999,3,3,4,10
1515915625595753385,38,1,30.16,3,1,1,5
1515915625595758438,38,1,294.41,3,1,4,8
1515915625595759468,38,1,259.38,3,1,3,7
1515915625595759509,38,1,251.4,3,1,3,7
1515915625595759910,38,1,11.11,3,1,1,5
1515915625595760467,38,1,253.38,3,1,3,7
1515915625595764199,38,1,349.46,3,1,4,8
1515915625595764464,34,6,1351.99,4,4,4,12
1515915625595771081,38,2,32.88,3,2,2,7
1515915625595772040,38,2,83.8,3,2,2,7
1515915625595774550,38,1,176.17,3,1,3,7
1515915625595775227,38,1,600.6,3,1,4,8
1515915625595782362,38,1,201.33,3,1,3,7
1515915625595783162,28,3,2289.1,4,3,4,11
1515915625595792758,34,2,268.78,4,2,3,9
1515915625595795064,38,1,37.62,3,1,2,6
1515915625595795065,38,1,21.21,3,1,1,5
1515915625595795951,38,4,1018.68,3,3,4,10
1515915625595797068,38,3,1192.44,3,3,4,10
1515915625595797462,36,2,31.74,3,2,1,6
1515915625595799282,38,16,162.64000000000001,3,4,3,10
1515915625595799700,38,1,12.46,3,1,1,5
1515915625595800062,35,10,531.96,4,4,4,12
1515915625595800506,38,3,1168.42,3,3,4,10
1515915625595800659,38,1,204.29,3,1,3,7
1515915625595803291,38,3,1634.74,3,3,4,10
1515915625595811165,38,1,23.9,3,1,1,5
1515915625595811191,38,1,32.22,3,1,1,5
1515915625595811700,38,1,37.46,3,1,2,6
1515915625595813570,38,1,38.83,3,1,2,6
1515915625595814261,38,1,839.75,3,1,4,8
1515915625595814923,38,1,499.54,3,1,4,8
1515915625595816294,38,1,68.1,3,1,2,6
1515915625595818974,8,3,843.21,4,3,4,11
1515915625595819863,38,2,1049.84,3,2,4,9
1515915625595825728,35,1,132.37,4,1,3,8
1515915625595827343,38,3,1381.54,3,3,4,10
1515915625595828493,38,1,397.48,3,1,4,8
1515915625595828805,38,1,399.48,3,1,4,8
1515915625595830287,38,1,202.67,3,1,3,7
1515915625595831374,38,1,31.11,3,1,1,5
1515915625595834779,38,1,13.97,3,1,1,5
1515915625595835973,38,1,49.1,3,1,2,6
1515915625595837203,38,1,43.17,3,1,2,6
1515915625595841031,38,1,100.75,3,1,3,7
1515915625595849717,38,1,27.46,3,1,1,5
1515915625595851403,38,1,13.02,3,1,1,5
1515915625595856953,38,1,12.46,3,1,1,5
1515915625595859660,26,5,173.75,4,4,3,11
1515915625595859763,38,4,2398.4,3,3,4,10
1515915625595859951,28,5,173.75,4,4,3,11
1515915625595860093,38,1,9.37,3,1,1,5
1515915625595861699,38,1,294.41,3,1,4,8
1515915625595862221,38,1,31.59,3,1,1,5
1515915625595864118,38,1,33.49,3,1,2,6
1515915625595868150,38,1,64.14,3,1,2,6
1515915625595870222,38,2,40.0,3,2,2,7
1515915625595875541,38,1,292.83,3,1,4,8
1515915625595875786,38,3,50.489999999999995,3,3,2,8
1515915625595877636,38,2,268.54,3,2,3,8
1515915625595878289,38,3,4.71,3,3,1,7
1515915625595879920,38,2,502.8,3,2,4,9
1515915625595888294,7,6,497.82,4,4,4,12
1515915625595891042,38,1,26.03,3,1,1,5
1515915625595893737,38,5,376.45000000000005,3,4,4,11
1515915625595893777,38,1,15.1,3,1,1,5
1515915625595894963,38,2,497.70000000000005,3,2,4,9
1515915625595895663,38,1,214.1,3,1,3,7
1515915625595897470,38,1,13.02,3,1,1,5
1515915625595899497,38,2,881.0,3,2,4,9
1515915625595902914,33,2,373.3,4,2,4,10
1515915625595906604,38,1,226.84,3,1,3,7
1515915625595907414,38,1,97.35,3,1,3,7
1515915625595908870,38,1,250.48,3,1,3,7
1515915625595910252,38,2,49.52,3,2,2,7
1515915625595912740,38,1,111.92,3,1,3,7
1515915625595913155,38,1,189.17,3,1,3,7
1515915625595915253,32,1,22.86,4,1,1,6
1515915625595915730,38,1,46.67,3,1,2,6
1515915625595919115,38,1,80.95,3,1,2,6
1515915625595919562,38,2,667.87,3,2,4,9
1515915625595919587,38,2,40.44,3,2,2,7
1515915625595920255,37,4,2315.61,3,3,4,10
1515915625595921269,38,2,845.05,3,2,4,9
1515915625595921337,38,1,34.13,3,1,2,6
1515915625595923733,35,4,197.52,4,3,3,10
1515915625595926221,38,1,461.52,3,1,4,8
1515915625595927653,38,1,45.73,3,1,2,6
1515915625595929558,38,1,136.92,3,1,3,7
1515915625595930052,38,1,164.33,3,1,3,7
1515915625595932299,38,2,3.14,3,2,1,6
1515915625595939421,38,1,24.44,3,1,1,5
1515915625595940119,36,2,212.26,3,2,3,8
1515915625595947338,38,1,384.48,3,1,4,8
1515915625595947518,38,1,64.48,3,1,2,6
1515915625595953598,38,1,449.51,3,1,4,8
1515915625595957250,38,2,794.96,3,2,4,9
1515915625595958853,36,2,884.29,3,2,4,9
1515915625595958934,38,2,328.66,3,2,4,9
1515915625595959063,38,2,106.64,3,2,3,8
1515915625595963482,21,2,408.58,4,2,4,10
1515915625595964535,38,1,150.79,3,1,3,7
1515915625595964971,38,1,591.59,3,1,4,8
1515915625595967669,27,2,64.44,4,2,2,8
1515915625595969230,38,2,794.96,3,2,4,9
1515915625595969300,38,1,344.56,3,1,4,8
1515915625595970218,37,2,77.66,3,2,2,7
1515915625595973070,38,1,292.83,3,1,4,8
1515915625595973078,38,3,142.38,3,3,3,9
1515915625595977898,37,1,83.94,3,1,2,6
1515915625595979447,37,6,179.03,3,4,3,10
1515915625595980234,37,2,26.04,3,2,1,6
1515915625595981240,38,1,521.56,3,1,4,8
1515915625595982717,38,1,448.51,3,1,4,8
1515915625595987038,38,1,471.13,3,1,4,8
1515915625595988568,38,1,397.48,3,1,4,8
1515915625595990024,38,3,4.71,3,3,1,7
1515915625595991156,38,1,187.29,3,1,3,7
1515915625595992766,38,2,59.36,3,2,2,7
1515915625595996861,38,1,166.02,3,1,3,7
1515915625595996941,34,3,218.94,4,3,3,10
1515915625595997378,34,1,51.33,4,1,2,7
1515915625595998100,37,2,629.94,3,2,4,9
1515915625595999408,38,2,53.96,3,2,2,7
1515915625595999457,36,4,167.44,3,3,3,9
1515915625595999568,35,1,26.19,4,1,1,6
1515915625596004773,38,1,205.25,3,1,3,7
1515915625596007605,38,1,624.62,3,1,4,8
1515915625596009062,38,1,214.1,3,1,3,7
1515915625596015062,37,1,556.98,3,1,4,8
1515915625596015350,38,1,449.51,3,1,4,8
1515915625596017017,38,1,5.71,3,1,1,5
1515915625596021254,38,2,34.6,3,2,2,7
1515915625596027051,33,2,238.25,4,2,3,9
1515915625596027849,35,2,533.5,4,2,4,10
1515915625596028623,38,1,42.41,3,1,2,6
1515915625596033509,38,1,202.67,3,1,3,7
1515915625596038442,38,1,415.54,3,1,4,8
1515915625596038935,38,1,214.1,3,1,3,7
1515915625596041333,38,1,600.6,3,1,4,8
1515915625596045749,38,9,87.63,3,4,2,9
1515915625596046416,38,1,13.86,3,1,1,5
1515915625596046461,38,3,29.21,3,3,1,7
1515915625596050010,37,1,155.43,3,1,3,7
1515915625596050756,38,2,310.86,3,2,4,9
1515915625596051294,38,1,577.6,3,1,4,8
1515915625596051594,38,1,214.1,3,1,3,7
1515915625596052900,12,2,408.58,4,2,4,10
1515915625596053040,38,1,399.48,3,1,4,8
1515915625596056374,38,1,453.86,3,1,4,8
1515915625596057115,38,1,20.63,3,1,1,5
1515915625596057253,38,2,808.98,3,2,4,9
1515915625596058929,36,2,343.8,3,2,4,9
1515915625596059929,29,3,2393.13,4,3,4,11
1515915625596062121,38,2,1056.4,3,2,4,9
1515915625596062232,34,2,44.44,4,2,2,8
1515915625596063200,38,1,839.75,3,1,4,8
1515915625596071835,15,3,955.9000000000001,4,3,4,11
1515915625596073099,38,1,205.32,3,1,3,7
1515915625596075221,38,1,349.46,3,1,4,8
1515915625596077526,37,1,5.22,3,1,1,5
1515915625596081371,37,4,236.2,3,3,3,9
1515915625596081912,27,1,490.54,4,1,4,9
1515915625596086939,37,1,44.13,3,1,2,6
1515915625596088279,24,3,288.96,4,3,4,11
1515915625596091441,37,1,346.08,3,1,4,8
1515915625596100995,37,1,457.51,3,1,4,8
1515915625596104913,37,1,30.83,3,1,1,5
1515915625596105015,37,5,2242.55,3,4,4,11
1515915625596111400,37,1,106.03,3,1,3,7
1515915625596112503,37,1,39.51,3,1,2,6
1515915625596115080,37,1,15.7,3,1,1,5
1515915625596116826,37,2,20.330000000000002,3,2,1,6
1515915625596118614,37,1,11.13,3,1,1,5
1515915625596121715,37,1,453.86,3,1,4,8
1515915625596121902,37,1,46.67,3,1,2,6
1515915625596123446,37,1,47.14,3,1,2,6
1515915625596124459,36,3,2405.18,3,3,4,10
1515915625596124556,37,1,403.46,3,1,4,8
1515915625596125956,37,1,486.81,3,1,4,8
1515915625596127309,37,2,46.96,3,2,2,7
1515915625596131106,37,2,359.4,3,2,4,9
1515915625596132966,37,1,141.48,3,1,3,7
1515915625596133499,37,1,214.1,3,1,3,7
1515915625596134099,37,1,218.98,3,1,3,7
1515915625596134972,37,1,592.08,3,1,4,8
1515915625596135091,13,1,249.38,4,1,3,8
1515915625596135196,7,2,502.76,4,2,4,10
1515915625596139496,37,1,21.32,3,1,1,5
1515915625596143668,37,1,539.57,3,1,4,8
1515915625596150218,37,2,112.28,3,2,3,8
1515915625596152499,37,1,13.97,3,1,1,5
1515915625596157286,37,1,60.54,3,1,2,6
1515915625596159984,33,2,343.8,4,2,4,10
1515915625596161475,37,1,218.98,3,1,3,7
1515915625596162348,25,4,320.12,4,3,4,11
1515915625596163208,37,1,146.4,3,1,3,7
1515915625596165068,37,2,165.94,3,2,3,8
1515915625596166370,37,2,87.18,3,2,2,7
1515915625596170537,37,2,3.14,3,2,1,6
1515915625596170974,37,1,34.7,3,1,2,6
1515915625596171348,37,15,203.6,3,4,3,10
1515915625596171504,35,2,794.96,4,2,4,10
1515915625596171647,37,1,600.6,3,1,4,8
1515915625596178435,37,1,30.19,3,1,1,5
1515915625596179476,37,3,29.58,3,3,1,7
1515915625596186387,37,1,284.3,3,1,3,7
1515915625596186674,37,1,374.38,3,1,4,8
1515915625596190519,37,1,14.6,3,1,1,5
1515915625596191243,37,1,13.02,3,1,1,5
1515915625596191729,37,1,29.84,3,1,1,5
1515915625596192139,37,1,51.33,3,1,2,6
1515915625596192715,37,1,201.33,3,1,3,7
1515915625596195750,33,1,519.56,4,1,4,9
1515915625596196585,37,1,403.46,3,1,4,8
1515915625596198165,37,1,13.4,3,1,1,5
1515915625596198372,37,1,600.6,3,1,4,8
1515915625596199956,37,9,188.54999999999998,3,4,3,10
1515915625596201190,37,1,28.49,3,1,1,5
1515915625596201781,37,1,26.33,3,1,1,5
1515915625596202457,37,1,25.4,3,1,1,5
1515915625596213063,37,2,22.54,3,2,1,6
1515915625596214481,37,1,253.38,3,1,3,7
1515915625596218826,37,1,482.52,3,1,4,8
1515915625596221540,37,1,57.63,3,1,2,6
1515915625596221831,37,1,274.4,3,1,3,7
1515915625596222123,28,24,8047.99,4,4,4,12
1515915625596222235,30,5,2407.6400000000003,4,4,4,12
1515915625596223510,33,3,883.23,4,3,4,11
1515915625596223978,2,6,789.51,4,4,4,12
1515915625596224699,37,1,1.57,3,1,1,5
1515915625596225536,37,5,1207.88,3,4,4,11
1515915625596226288,37,2,111.74,3,2,3,8
1515915625596231752,37,1,466.52,3,1,4,8
1515915625596232572,37,3,167.60999999999999,3,3,3,9
1515915625596232646,37,1,839.75,3,1,4,8
1515915625596233147,37,2,159.74,3,2,3,8
1515915625596235215,37,1,103.83,3,1,3,7
1515915625596235463,37,3,157.47,3,3,3,9
1515915625596236048,37,1,416.56,3,1,4,8
1515915625596237325,37,1,569.59,3,1,4,8
1515915625596240483,37,1,251.4,3,1,3,7
1515915625596242417,37,1,183.49,3,1,3,7
1515915625596245206,37,1,38.83,3,1,2,6
1515915625596250820,37,1,897.79,3,1,4,8
1515915625596251484,37,3,727.4399999999999,3,3,4,10
1515915625596254142,37,1,592.08,3,1,4,8
1515915625596255033,28,1,52.51,4,1,2,7
1515915625596258737,37,1,274.4,3,1,3,7
1515915625596266519,37,1,399.48,3,1,4,8
1515915625596269058,37,1,69.35,3,1,2,6
1515915625596269694,37,1,569.59,3,1,4,8
1515915625596269715,37,1,539.57,3,1,4,8
1515915625596272991,37,2,568.81,3,2,4,9
1515915625596276720,37,1,22.48,3,1,1,5
1515915625596279694,37,1,294.41,3,1,4,8
1515915625596280701,10,2,60.53,4,2,2,8
1515915625596280791,37,1,397.48,3,1,4,8
1515915625596282052,37,2,428.2,3,2,4,9
1515915625596282353,17,1,187.29,4,1,3,8
1515915625596282394,37,2,512.86,3,2,4,9
1515915625596284005,37,1,171.9,3,1,3,7
1515915625596284227,37,1,171.9,3,1,3,7
1515915625596285707,37,1,519.56,3,1,4,8
1515915625596285803,37,2,409.2,3,2,4,9
1515915625596287838,37,2,77.66,3,2,2,7
1515915625596290936,37,1,49.57,3,1,2,6
1515915625596297365,35,2,405.9,4,2,4,10
1515915625596298233,32,4,199.6,4,3,3,10
1515915625596298594,36,6,5931.08,3,4,4,11
1515915625596300327,15,2,1795.58,4,2,4,10
1515915625596301063,37,1,22.08,3,1,1,5
1515915625596301704,37,1,481.54,3,1,4,8
1515915625596301989,37,1,60.83,3,1,2,6
1515915625596304643,36,1,20.16,3,1,1,5
1515915625596305634,36,2,1919.66,3,2,4,9
1515915625596311157,37,1,53.51,3,1,2,6
1515915625596311497,37,1,313.08,3,1,4,8
1515915625596311607,37,2,698.92,3,2,4,9
1515915625596320067,37,2,374.58,3,2,4,9
1515915625596321829,37,1,656.63,3,1,4,8
1515915625596322966,37,1,23.51,3,1,1,5
1515915625596323061,37,1,449.51,3,1,4,8
1515915625596326236,37,1,486.81,3,1,4,8
1515915625596326541,37,1,292.83,3,1,4,8
1515915625596326785,37,1,26.56,3,1,1,5
1515915625596328775,37,1,9.35,3,1,1,5
1515915625596330014,37,1,397.48,3,1,4,8
1515915625596330097,37,2,32.38,3,2,2,7
1515915625596331602,37,1,54.89,3,1,2,6
1515915625596333361,37,1,399.48,3,1,4,8
1515915625596339678,37,1,50.94,3,1,2,6
1515915625596347903,2,2,55.24,4,2,2,8
1515915625596348340,37,1,61.27,3,1,2,6
1515915625596351130,37,3,308.1,3,3,4,10
1515915625596353881,37,3,87.66,3,3,2,8
1515915625596357380,37,1,229.38,3,1,3,7
1515915625596358495,37,1,29.22,3,1,1,5
1515915625596364895,37,1,486.81,3,1,4,8
1515915625596367848,14,2,1201.2,4,2,4,10
1515915625596367912,37,1,44.13,3,1,2,6
1515915625596368750,37,2,211.74,3,2,3,8
1515915625596370177,37,1,20.95,3,1,1,5
1515915625596374008,36,2,442.89,3,2,4,9
1515915625596379659,30,2,164.82,4,2,3,9
1515915625596388118,37,3,78.57000000000001,3,3,2,8
1515915625596390503,37,1,294.41,3,1,4,8
1515915625596393222,37,1,51.33,3,1,2,6
1515915625596393721,37,1,38.83,3,1,2,6
1515915625596393947,36,1,42.57,3,1,2,6
1515915625596398698,37,1,797.71,3,1,4,8
1515915625596401104,37,2,157.02,3,2,3,8
1515915625596405700,27,2,464.73,4,2,4,10
1515915625596408467,36,1,466.52,3,1,4,8
1515915625596413366,36,1,19.68,3,1,1,5
1515915625596417689,36,1,449.51,3,1,4,8
1515915625596426118,36,1,397.48,3,1,4,8
1515915625596427857,36,1,374.44,3,1,4,8
1515915625596431959,36,1,449.51,3,1,4,8
1515915625596433053,36,1,519.56,3,1,4,8
1515915625596436271,36,1,486.81,3,1,4,8
1515915625596438251,35,1,415.54,4,1,4,9
1515915625596438299,36,1,18.41,3,1,1,5
1515915625596444806,36,2,988.35,3,2,4,9
1515915625596447007,36,2,47.02,3,2,2,7
1515915625596447334,36,1,69.38,3,1,2,6
1515915625596447482,27,2,122.32,4,2,3,9
1515915625596449511,36,1,599.6,3,1,4,8
1515915625596452241,36,1,397.48,3,1,4,8
1515915625596452274,36,1,466.52,3,1,4,8
1515915625596453228,36,1,140.86,3,1,3,7
1515915625596454237,36,2,794.96,3,2,4,9
1515915625596458833,36,2,62.86,3,2,2,7
1515915625596459853,36,2,518.76,3,2,4,9
1515915625596460310,36,1,214.1,3,1,3,7
1515915625596461908,36,2,933.04,3,2,4,9
1515915625596465982,36,8,2835.88,3,4,4,11
1515915625596466473,36,2,40.32,3,2,2,7
1515915625596467522,36,1,44.78,3,1,2,6
1515915625596472152,36,2,965.04,3,2,4,9
1515915625596474771,9,1,187.29,4,1,3,8
1515915625596474809,36,2,965.04,3,2,4,9
1515915625596476559,36,1,104.86,3,1,3,7
1515915625596478293,36,4,116.88,3,3,3,9
1515915625596482712,36,12,1595.03,3,4,4,11
1515915625596483147,36,1,56.67,3,1,2,6
1515915625596484521,36,2,77.66,3,2,2,7
1515915625596493922,36,2,317.14,3,2,4,9
1515915625596496784,36,1,115.27,3,1,3,7
1515915625596496898,36,14,1584.84,3,4,4,11
1515915625596498916,35,3,502.08,4,3,4,11
1515915625596502917,36,1,370.46,3,1,4,8
1515915625596508494,36,1,27.4,3,1,1,5
1515915625596511433,36,1,397.48,3,1,4,8
1515915625596513068,14,1,11.43,4,1,1,6
1515915625596514554,36,1,23.51,3,1,1,5
1515915625596520601,36,1,397.48,3,1,4,8
1515915625596523124,36,1,53.33,3,1,2,6
1515915625596525365,36,1,77.73,3,1,2,6
1515915625596525528,36,1,80.03,3,1,2,6
1515915625596527194,36,1,23.33,3,1,1,5
1515915625596528295,36,1,126.68,3,1,3,7
1515915625596531025,36,1,172.54,3,1,3,7
1515915625596533097,36,1,16.19,3,1,1,5
1515915625596534847,23,45,6286.9800000000005,4,4,4,12
1515915625596535915,15,2,1219.2,4,2,4,10
1515915625596535958,36,4,303.04,3,3,4,10
1515915625596551676,36,1,642.62,3,1,4,8
1515915625596556921,36,3,1168.42,3,3,4,10
1515915625596558249,36,1,449.51,3,1,4,8
1515915625596558521,36,1,397.48,3,1,4,8
1515915625596564238,36,2,312.06,3,2,4,9
1515915625596570510,36,1,202.67,3,1,3,7
1515915625596571004,36,1,43.33,3,1,2,6
1515915625596571191,36,1,27.7,3,1,1,5
1515915625596583095,36,3,126.66,3,3,3,9
1515915625596583982,36,1,656.63,3,1,4,8
1515915625596584735,36,1,15.43,3,1,1,5
1515915625596587485,35,8,2353.7000000000003,4,4,4,12
1515915625596592838,36,1,292.83,3,1,4,8
1515915625596596216,36,2,81.58,3,2,2,7
1515915625596597842,36,1,15.71,3,1,1,5
1515915625596607644,36,1,449.51,3,1,4,8
1515915625596612277,36,1,37.17,3,1,2,6
1515915625596613716,36,2,32.38,3,2,2,7
1515915625596613982,36,2,74.34,3,2,2,7
1515915625596614760,29,3,174.32999999999998,4,3,3,10
1515915625596615103,36,2,74.34,3,2,2,7
1515915625596617470,36,1,26.19,3,1,1,5
1515915625596618505,36,1,486.81,3,1,4,8
1515915625596619226,35,1,15.43,4,1,1,6
1515915625596619605,36,1,26.19,3,1,1,5
1515915625596620284,36,1,218.98,3,1,3,7
1515915625596621177,26,2,422.28,4,2,4,10
1515915625596622147,36,2,746.92,3,2,4,9
1515915625596623536,36,1,214.1,3,1,3,7
1515915625596623799,36,3,608.01,3,3,4,10
1515915625596623917,36,2,30.16,3,2,1,6
1515915625596630294,22,3,1801.77,4,3,4,11
1515915625596633026,36,1,502.52,3,1,4,8
1515915625596636924,36,1,134.46,3,1,3,7
1515915625596639797,36,4,331.88,3,3,4,10
1515915625596641110,32,3,98.58,4,3,3,10
1515915625596643242,36,1,373.46,3,1,4,8
1515915625596644031,36,2,770.94,3,2,4,9
1515915625596645659,36,4,751.12,3,3,4,10
1515915625596646146,36,1,397.48,3,1,4,8
1515915625596647062,35,2,87.74,4,2,2,8
1515915625596652222,22,1,486.81,4,1,4,9
1515915625596654440,36,2,899.02,3,2,4,9
1515915625596658462,36,1,490.54,3,1,4,8
1515915625596660391,36,1,587.6,3,1,4,8
1515915625596664854,35,10,2562.78,4,4,4,12
1515915625596665461,36,1,89.22,3,1,2,6
1515915625596665826,36,1,101.9,3,1,3,7
1515915625596666647,36,1,397.48,3,1,4,8
1515915625596667146,36,1,101.9,3,1,3,7
1515915625596667640,36,1,187.29,3,1,3,7
1515915625596669234,36,3,221.43,3,3,3,9
1515915625596674279,36,1,492.52,3,1,4,8
1515915625596676054,35,4,245.72,4,3,3,10
1515915625596677258,33,3,1087.79,4,3,4,11
1515915625596679405,36,1,466.52,3,1,4,8
1515915625596682608,36,1,466.52,3,1,4,8
1515915625596688994,35,5,535.8,4,4,4,12
1515915625596691281,36,2,46.96,3,2,2,7
1515915625596693402,25,1,397.48,4,1,4,9
1515915625596695362,36,1,27.89,3,1,1,5
1515915625596696672,36,1,104.13,3,1,3,7
1515915625596696810,36,1,16.43,3,1,1,5
1515915625596701195,36,1,482.52,3,1,4,8
1515915625596702089,36,1,82.97,3,1,2,6
1515915625596703281,25,2,965.98,4,2,4,10
1515915625596706576,36,1,206.29,3,1,3,7
1515915625596709920,36,2,88.26,3,2,2,7
1515915625596713513,36,5,614.3,3,4,4,11
1515915625596716341,36,1,129.84,3,1,3,7
1515915625596717778,36,3,2425.17,3,3,4,10
1515915625596718796,36,1,53.9,3,1,2,6
1515915625596720860,34,1,292.83,4,1,4,9
1515915625596722631,30,1,466.52,4,1,4,9
1515915625596726221,36,3,447.15000000000003,3,3,4,10
1515915625596727442,36,3,194.67000000000002,3,3,3,9
1515915625596729714,36,1,11.65,3,1,1,5
1515915625596732674,36,1,94.41,3,1,3,7
1515915625596732795,36,1,265.05,3,1,3,7
1515915625596734407,35,2,327.04,4,2,4,10
1515915625596734979,36,1,509.54,3,1,4,8
1515915625596738734,36,1,466.52,3,1,4,8
1515915625596747402,36,1,55.16,3,1,2,6
1515915625596749373,1,1,656.63,4,1,4,9
1515915625596752338,36,1,51.33,3,1,2,6
1515915625596757263,36,1,34.44,3,1,2,6
1515915625596760708,35,1,211.59,4,1,3,8
1515915625596782521,35,1,292.83,4,1,4,9
1515915625596785242,35,1,371.89,4,1,4,9
1515915625596786683,31,1,449.51,4,1,4,9
1515915625596788533,32,2,63.72,4,2,2,8
1515915625596789201,35,1,226.84,4,1,3,8
1515915625596791647,35,2,64.44,4,2,2,8
1515915625596797144,35,2,47.62,4,2,2,8
1515915625596802474,35,1,14.51,4,1,1,6
1515915625596805897,35,1,250.38,4,1,3,8
1515915625596806778,35,2,257.62,4,2,3,9
1515915625596808505,35,1,26.46,4,1,1,6
1515915625596809223,35,2,67.3,4,2,2,8
1515915625596812426,35,2,748.76,4,2,4,10
1515915625596813123,35,1,519.56,4,1,4,9
1515915625596816211,35,1,11.98,4,1,1,6
1515915625596816263,35,2,29.72,4,2,1,7
1515915625596824141,35,1,292.83,4,1,4,9
1515915625596830311,35,1,32.38,4,1,2,7
1515915625596830801,35,6,414.48,4,4,4,12
1515915625596831289,35,3,332.5,4,3,4,11
1515915625596833804,35,2,337.98,4,2,4,10
1515915625596834450,35,1,15.92,4,1,1,6
1515915625596857187,35,2,705.3199999999999,4,2,4,10
1515915625596858354,35,1,214.1,4,1,3,8
1515915625596859902,35,2,1201.2,4,2,4,10
1515915625596872425,35,1,38.83,4,1,2,7
1515915625596877172,26,2,94.98,4,2,3,9
1515915625596878845,35,1,15.1,4,1,1,6
1515915625596884615,35,1,15.1,4,1,1,6
1515915625596887332,35,1,251.4,4,1,3,8
1515915625596889731,35,1,1.57,4,1,1,6
1515915625596896684,35,2,69.3,4,2,2,8
1515915625596902432,35,1,23.33,4,1,1,6
1515915625596904885,35,1,214.1,4,1,3,8
1515915625596905268,35,1,202.67,4,1,3,8
1515915625596905290,35,6,185.06,4,4,3,11
1515915625596906228,35,1,97.57,4,1,3,8
1515915625596906644,24,6,3502.61,4,4,4,12
1515915625596908095,35,3,262.53000000000003,4,3,3,10
1515915625596909769,35,1,399.48,4,1,4,9
1515915625596912169,29,3,1106.36,4,3,4,11
1515915625596914472,35,1,43.02,4,1,2,7
1515915625596915685,35,4,159.0,4,3,3,10
1515915625596916889,35,1,12.51,4,1,1,6
1515915625596917477,35,1,268.59,4,1,3,8
1515915625596917789,35,1,171.9,4,1,3,8
1515915625596917797,35,1,18.25,4,1,1,6
1515915625596918122,35,1,600.6,4,1,4,9
1515915625596921673,35,1,12.25,4,1,1,6
1515915625596929194,35,1,21.21,4,1,1,6
1515915625596935396,27,5,457.34000000000003,4,4,4,12
1515915625596937490,35,2,105.88,4,2,3,9
1515915625596938621,35,1,9.35,4,1,1,6
1515915625596939344,35,1,214.1,4,1,3,8
1515915625596941058,35,1,466.52,4,1,4,9
1515915625596943347,34,4,829.5899999999999,4,3,4,11
1515915625596943889,35,3,652.38,4,3,4,11
1515915625596945396,35,1,415.54,4,1,4,9
1515915625596946507,35,3,63.63,4,3,2,9
1515915625596949288,35,1,26.19,4,1,1,6
1515915625596949957,31,1,331.59,4,1,4,9
1515915625596951891,35,2,89.14,4,2,2,8
1515915625596956147,17,2,110.7,4,2,3,9
1515915625596956207,35,2,111.74,4,2,3,9
1515915625596957325,27,1,35.62,4,1,2,7
1515915625596959763,35,1,36.24,4,1,2,7
1515915625596962480,35,3,65.97999999999999,4,3,2,9
1515915625596963660,35,1,136.05,4,1,3,8
1515915625596964097,35,1,418.48,4,1,4,9
1515915625596964451,26,4,119.56,4,3,3,10
1515915625596968873,35,1,50.63,4,1,2,7
1515915625596973766,35,1,10.71,4,1,1,6
1515915625596975171,35,1,14.6,4,1,1,6
1515915625596976241,35,1,397.48,4,1,4,9
1515915625596978122,35,1,592.08,4,1,4,9
1515915625596980997,35,1,9.86,4,1,1,6
1515915625596981320,35,2,45.74,4,2,2,8
1515915625596981978,35,1,17.4,4,1,1,6
1515915625596986276,35,2,101.26,4,2,3,9
1515915625596988294,35,1,569.67,4,1,4,9
1515915625596990467,35,1,38.83,4,1,2,7
1515915625596990960,35,1,40.63,4,1,2,7
1515915625596994580,35,1,15.94,4,1,1,6
1515915625596996956,35,1,397.48,4,1,4,9
1515915625596997505,35,1,397.48,4,1,4,9
1515915625596997945,35,1,486.81,4,1,4,9
1515915625596998136,35,1,9.35,4,1,1,6
1515915625596998528,35,1,12.46,4,1,1,6
1515915625596999168,35,1,592.08,4,1,4,9
1515915625596999971,35,2,1184.16,4,2,4,10
1515915625597001555,35,3,306.33,4,3,4,11
1515915625597005081,35,1,41.27,4,1,2,7
1515915625597007440,34,2,405.34,4,2,4,10
1515915625597015954,35,2,58.44,4,2,2,8
1515915625597016963,35,1,51.33,4,1,2,7
1515915625597017186,35,4,193.2,4,3,3,10
1515915625597017946,35,1,202.67,4,1,3,8
1515915625597018827,35,1,609.6,4,1,4,9
1515915625597019056,34,1,278.41,4,1,3,8
1515915625597019422,35,1,171.9,4,1,3,8
1515915625597020407,32,3,1192.44,4,3,4,11
1515915625597022716,33,1,202.67,4,1,3,8
1515915625597022845,35,1,336.57,4,1,4,9
1515915625597023653,35,3,1523.94,4,3,4,11
1515915625597023830,35,1,600.6,4,1,4,9
1515915625597024336,35,1,209.17,4,1,3,8
1515915625597026505,35,1,48.3,4,1,2,7
1515915625597034221,35,4,331.88,4,3,4,11
1515915625597034319,35,1,26.19,4,1,1,6
1515915625597038183,35,1,10.21,4,1,1,6
1515915625597038860,35,1,523.65,4,1,4,9
1515915625597045785,35,1,414.13,4,1,4,9
1515915625597047329,35,1,284.46,4,1,3,8
1515915625597049372,31,1,1240.0,4,1,4,9
1515915625597050476,35,1,13.76,4,1,1,6
1515915625597055184,35,2,0.74,4,2,1,7
1515915625597058036,35,1,158.57,4,1,3,8
1515915625597058839,23,1,31.11,4,1,1,6
1515915625597061793,35,1,34.44,4,1,2,7
1515915625597063442,33,5,424.45,4,4,4,12
1515915625597066987,35,1,125.3,4,1,3,8
1515915625597067422,35,2,254.16,4,2,3,9
1515915625597067526,35,2,86.22,4,2,2,8
1515915625597069282,35,1,257.87,4,1,3,8
1515915625597070065,35,1,397.48,4,1,4,9
1515915625597072059,35,2,64.44,4,2,2,8
1515915625597074589,34,3,809.51,4,3,4,11
1515915625597074590,35,3,355.71,4,3,4,11
1515915625597075502,35,1,397.48,4,1,4,9
1515915625597076459,34,2,691.8900000000001,4,2,4,10
1515915625597076916,35,3,539.8199999999999,4,3,4,11
1515915625597081120,35,2,213.66,4,2,3,9
1515915625597081410,35,1,133.7,4,1,3,8
1515915625597081564,35,1,250.38,4,1,3,8
1515915625597081615,35,2,85.96,4,2,2,8
1515915625597083597,35,4,516.6,4,3,4,11
1515915625597092892,35,3,1847.83,4,3,4,11
1515915625597095161,26,1,144.51,4,1,3,8
1515915625597095568,35,1,371.46,4,1,4,9
1515915625597099442,32,2,742.92,4,2,4,10
1515915625597100452,35,1,631.62,4,1,4,9
1515915625597100823,35,1,486.81,4,1,4,9
1515915625597101565,35,1,82.41,4,1,2,7
1515915625597104012,35,2,498.8,4,2,4,10
1515915625597105314,35,2,1079.14,4,2,4,10
1515915625597108709,24,1,118.21,4,1,3,8
1515915625597113101,35,1,162.51,4,1,3,8
1515915625597116001,35,1,24.6,4,1,1,6
1515915625597116376,35,1,2.86,4,1,1,6
1515915625597118159,35,1,21.43,4,1,1,6
1515915625597124692,35,1,78.89,4,1,2,7
1515915625597125498,35,3,100.94999999999999,4,3,3,10
1515915625597129033,35,1,31.75,4,1,1,6
1515915625597131230,35,1,587.6,4,1,4,9
1515915625597133279,34,2,64.44,4,2,2,8
1515915625597133872,8,1,38.56,4,1,2,7
1515915625597134269,35,1,336.57,4,1,4,9
1515915625597141045,35,1,29.68,4,1,1,6
1515915625597143386,35,2,90.8,4,2,3,9
1515915625597148971,35,1,449.51,4,1,4,9
1515915625597149558,35,3,10.290000000000001,4,3,1,8
1515915625597150699,8,13,1780.24,4,4,4,12
1515915625597154850,35,1,581.4,4,1,4,9
1515915625597164427,34,1,302.71,4,1,4,9
1515915625597167436,34,3,878.49,4,3,4,11
1515915625597168888,34,1,187.29,4,1,3,8
1515915625597170679,34,1,523.65,4,1,4,9
1515915625597173575,34,1,397.48,4,1,4,9
1515915625597175559,14,3,470.18999999999994,4,3,4,11
1515915625597179225,34,1,441.49,4,1,4,9
1515915625597188970,34,3,45.72,4,3,2,9
1515915625597191574,33,2,544.4300000000001,4,2,4,10
1515915625597199339,22,1,35.87,4,1,2,7
1515915625597202081,34,1,169.57,4,1,3,8
1515915625597202392,34,3,45.24,4,3,2,9
1515915625597203193,34,1,24.6,4,1,1,6
1515915625597203461,34,1,74.95,4,1,2,7
1515915625597206536,34,3,183.48,4,3,3,10
1515915625597207722,34,1,229.68,4,1,3,8
1515915625597209697,24,1,71.38,4,1,2,7
1515915625597213277,34,1,17.7,4,1,1,6
1515915625597214140,34,11,2177.34,4,4,4,12
1515915625597214541,34,2,651.9,4,2,4,10
1515915625597221516,34,1,84.92,4,1,2,7
1515915625597225588,34,10,614.3,4,4,4,12
1515915625597226937,34,1,32.22,4,1,1,6
1515915625597229118,34,1,486.81,4,1,4,9
1515915625597232508,34,1,819.75,4,1,4,9
1515915625597232779,34,1,600.6,4,1,4,9
1515915625597234242,34,1,20.16,4,1,1,6
1515915625597239092,29,2,479.89,4,2,4,10
1515915625597240431,34,1,72.98,4,1,2,7
1515915625597245091,34,1,118.57,4,1,3,8
1515915625597248843,34,4,81.7,4,3,2,9
1515915625597251744,33,1,128.79,4,1,3,8
1515915625597252289,34,1,156.73,4,1,3,8
1515915625597252924,34,2,49.84,4,2,2,8
1515915625597254566,25,2,140.32,4,2,3,9
1515915625597255229,34,1,8.43,4,1,1,6
1515915625597261448,34,1,24.92,4,1,1,6
1515915625597263630,34,1,49.14,4,1,2,7
1515915625597264054,34,1,9.57,4,1,1,6
1515915625597264928,34,1,15.08,4,1,1,6
1515915625597268746,30,2,924.01,4,2,4,10
1515915625597269341,34,3,84.30000000000001,4,3,2,9
1515915625597270537,34,2,21.56,4,2,1,7
1515915625597270809,34,1,1.57,4,1,1,6
1515915625597274297,34,1,30.95,4,1,1,6
1515915625597279254,34,2,22.86,4,2,1,7
1515915625597282290,34,1,140.11,4,1,3,8
1515915625597287807,34,1,73.83,4,1,2,7
1515915625597287968,16,2,679.02,4,2,4,10
1515915625597288182,34,1,609.6,4,1,4,9
1515915625597289259,34,2,63.74,4,2,2,8
1515915625597293251,33,4,2217.28,4,3,4,11
1515915625597293283,34,4,484.76,4,3,4,11
1515915625597293527,34,1,48.73,4,1,2,7
1515915625597294922,34,1,214.1,4,1,3,8
1515915625597295595,34,3,465.33000000000004,4,3,4,11
1515915625597297809,34,1,26.63,4,1,1,6
1515915625597300373,34,1,58.25,4,1,2,7
1515915625597301111,34,1,16.7,4,1,1,6
1515915625597304137,34,1,12.38,4,1,1,6
1515915625597304587,34,2,64.44,4,2,2,8
1515915625597307935,34,1,45.24,4,1,2,7
1515915625597308319,34,4,51.099999999999994,4,3,2,9
1515915625597313115,34,1,33.02,4,1,2,7
1515915625597318628,34,2,588.81,4,2,4,10
1515915625597322244,34,1,51.68,4,1,2,7
1515915625597325691,28,4,141.0,4,3,3,10
1515915625597333236,34,2,172.5,4,2,3,9
1515915625597335246,34,2,214.32,4,2,3,9
1515915625597337471,34,1,21.75,4,1,1,6
1515915625597341384,34,1,113.75,4,1,3,8
1515915625597341752,34,1,449.51,4,1,4,9
1515915625597341787,34,1,397.48,4,1,4,9
1515915625597345912,34,1,82.97,4,1,2,7
1515915625597346656,34,1,58.16,4,1,2,7
1515915625597350360,34,3,1048.3799999999999,4,3,4,11
1515915625597358905,34,1,39.46,4,1,2,7
1515915625597362436,34,1,284.46,4,1,3,8
1515915625597363299,34,2,1201.2,4,2,4,10
1515915625597368771,31,2,121.08,4,2,3,9
1515915625597373411,34,1,466.52,4,1,4,9
1515915625597373943,34,1,37.94,4,1,2,7
1515915625597378855,34,4,393.0,4,3,4,11
1515915625597380925,34,1,539.57,4,1,4,9
1515915625597381947,34,3,1732.8000000000002,4,3,4,11
1515915625597382217,34,1,26.19,4,1,1,6
1515915625597383788,34,1,599.6,4,1,4,9
1515915625597384491,34,1,55.6,4,1,2,7
1515915625597384619,34,1,14.95,4,1,1,6
1515915625597388900,34,1,42.98,4,1,2,7
1515915625597390950,34,2,50.16,4,2,2,8
1515915625597392373,33,2,111.3,4,2,3,9
1515915625597392442,34,1,10.63,4,1,1,6
1515915625597392686,34,1,38.83,4,1,2,7
1515915625597394397,34,1,45.56,4,1,2,7
1515915625597394960,1,1,144.51,4,1,3,8
1515915625597396581,34,2,1203.22,4,2,4,10
1515915625597398588,34,1,167.98,4,1,3,8
1515915625597401433,33,1,78.71,4,1,2,7
1515915625597401454,34,1,33.19,4,1,2,7
1515915625597405745,34,1,292.83,4,1,4,9
1515915625597408234,34,3,248.91,4,3,3,10
1515915625597409388,34,2,60.88,4,2,2,8
1515915625597411255,33,1,55.87,4,1,2,7
1515915625597411294,34,3,173.03,4,3,3,10
1515915625597412406,34,2,64.45,4,2,2,8
1515915625597415509,34,1,47.06,4,1,2,7
1515915625597416757,34,1,397.48,4,1,4,9
1515915625597417473,34,1,104.86,4,1,3,8
1515915625597419217,29,2,1191.19,4,2,4,10
1515915625597419463,34,1,202.67,4,1,3,8
1515915625597420166,34,1,127.08,4,1,3,8
1515915625597421269,34,2,73.46,4,2,2,8
1515915625597423810,34,2,542.21,4,2,4,10
1515915625597424517,34,1,30.54,4,1,1,6
1515915625597425149,34,1,548.37,4,1,4,9
1515915625597426289,34,1,32.22,4,1,1,6
1515915625597427274,34,1,449.51,4,1,4,9
1515915625597428134,34,1,397.48,4,1,4,9
1515915625597435839,34,1,399.48,4,1,4,9
1515915625597436459,33,4,1466.8400000000001,4,3,4,11
1515915625597438112,34,2,225.2,4,2,3,9
1515915625597440101,34,1,55.87,4,1,2,7
1515915625597440206,34,1,81.27,4,1,2,7
1515915625597441848,34,1,47.14,4,1,2,7
1515915625597445403,34,2,899.02,4,2,4,10
1515915625597445885,34,2,973.42,4,2,4,10
1515915625597452586,34,1,12.38,4,1,1,6
1515915625597453061,34,1,26.19,4,1,1,6
1515915625597454356,32,1,292.83,4,1,4,9
1515915625597459117,25,2,794.96,4,2,4,10
1515915625597460830,34,1,9.35,4,1,1,6
1515915625597462297,33,1,257.87,4,1,3,8
1515915625597463173,34,1,9.35,4,1,1,6
1515915625597467910,34,1,26.46,4,1,1,6
1515915625597472619,33,2,740.92,4,2,4,10
1515915625597472789,34,1,27.62,4,1,1,6
1515915625597474603,31,1,397.48,4,1,4,9
1515915625597476255,34,1,201.33,4,1,3,8
1515915625597477564,34,1,274.4,4,1,3,8
1515915625597484915,34,1,187.29,4,1,3,8
1515915625597487587,34,1,32.22,4,1,1,6
1515915625597497005,34,1,28.46,4,1,1,6
1515915625597502075,34,1,251.4,4,1,3,8
1515915625597503180,28,3,29.52,4,3,1,8
1515915625597507813,15,1,295.41,4,1,4,9
1515915625597508619,1,1,57.62,4,1,2,7
1515915625597514098,33,1,18.57,4,1,1,6
1515915625597520507,33,1,214.1,4,1,3,8
1515915625597525814,33,1,292.83,4,1,4,9
1515915625597531547,33,2,85.96,4,2,2,8
1515915625597532001,33,1,32.19,4,1,1,6
1515915625597542892,33,1,93.14,4,1,3,8
1515915625597543190,33,1,897.79,4,1,4,9
1515915625597544402,33,2,26.0,4,2,1,7
1515915625597546161,32,4,260.56,4,3,3,10
1515915625597547654,33,1,201.33,4,1,3,8
1515915625597549297,7,1,609.6,4,1,4,9
1515915625597550759,33,2,965.04,4,2,4,10
1515915625597551348,33,8,652.32,4,4,4,12
1515915625597554243,9,1,310.73,4,1,4,9
1515915625597556690,33,1,88.25,4,1,2,7
1515915625597557776,33,1,269.4,4,1,3,8
1515915625597558352,33,2,96.6,4,2,3,9
1515915625597559629,33,1,28.1,4,1,1,6
1515915625597560074,33,1,17.22,4,1,1,6
1515915625597560808,33,1,23.84,4,1,1,6
1515915625597566209,33,2,35.46,4,2,2,8
1515915625597566365,33,1,15.71,4,1,1,6
1515915625597569686,33,2,71.42,4,2,2,8
1515915625597570829,33,1,38.83,4,1,2,7
1515915625597571985,33,2,19.84,4,2,1,7
1515915625597577089,33,1,102.11,4,1,3,8
1515915625597579935,33,2,794.96,4,2,4,10
1515915625597581983,33,1,11.56,4,1,1,6
1515915625597582791,33,1,834.75,4,1,4,9
1515915625597586202,33,1,600.6,4,1,4,9
1515915625597591062,33,1,81.54,4,1,2,7
1515915625597591546,33,1,1.57,4,1,1,6
1515915625597591973,33,1,214.1,4,1,3,8
1515915625597592376,33,5,1030.95,4,4,4,12
1515915625597597231,33,3,261.48,4,3,3,10
1515915625597597610,31,4,78.08,4,3,2,9
1515915625597597744,33,1,18.41,4,1,1,6
1515915625597599575,33,1,397.48,4,1,4,9
1515915625597600797,33,1,14.35,4,1,1,6
1515915625597602802,32,1,47.13,4,1,2,7
1515915625597603729,33,1,28.86,4,1,1,6
1515915625597605033,33,3,42.87,4,3,2,9
1515915625597607022,33,1,15.08,4,1,1,6
1515915625597608075,33,1,63.98,4,1,2,7
1515915625597612742,25,1,40.95,4,1,2,7
1515915625597614698,33,2,128.96,4,2,3,9
1515915625597614794,33,2,128.96,4,2,3,9
1515915625597615155,33,1,38.1,4,1,2,7
1515915625597615223,32,2,472.0,4,2,4,10
1515915625597615999,33,2,310.2,4,2,4,10
1515915625597617013,33,1,204.29,4,1,3,8
1515915625597620219,32,2,44.16,4,2,2,8
1515915625597621180,33,8,146.98,4,4,3,11
1515915625597622464,33,1,78.3,4,1,2,7
1515915625597630930,32,3,754.2,4,3,4,11
1515915625597636365,31,1,210.68,4,1,3,8
1515915625597637554,33,1,24.68,4,1,1,6
1515915625597639536,33,1,53.95,4,1,2,7
1515915625597639949,33,1,48.84,4,1,2,7
1515915625597640062,32,1,64.6,4,1,2,7
1515915625597642117,33,1,23.0,4,1,1,6
1515915625597642428,33,1,46.92,4,1,2,7
1515915625597650163,4,2,691.8900000000001,4,2,4,10
1515915625597652817,31,2,485.72,4,2,4,10
1515915625597655978,33,3,773.61,4,3,4,11
1515915625597664482,33,1,397.48,4,1,4,9
1515915625597665400,20,5,155.79000000000002,4,4,3,11
1515915625597667476,33,1,60.54,4,1,2,7
1515915625597671543,33,1,20.62,4,1,1,6
1515915625597673331,33,1,11.98,4,1,1,6
1515915625597675274,33,1,63.33,4,1,2,7
1515915625597675767,33,2,155.46,4,2,3,9
1515915625597676552,33,1,16.67,4,1,1,6
1515915625597677209,33,1,200.35,4,1,3,8
1515915625597679007,33,2,143.66,4,2,3,9
1515915625597679913,33,1,71.83,4,1,2,7
1515915625597685000,33,1,93.63,4,1,3,8
1515915625597685436,32,1,102.11,4,1,3,8
1515915625597690319,33,1,204.29,4,1,3,8
1515915625597701000,33,1,20.46,4,1,1,6
1515915625597703474,33,1,418.48,4,1,4,9
1515915625597711317,33,1,16.97,4,1,1,6
1515915625597715675,23,2,798.96,4,2,4,10
1515915625597718552,28,3,98.63,4,3,3,10
1515915625597725628,33,1,415.54,4,1,4,9
1515915625597726435,9,2,407.91999999999996,4,2,4,10
1515915625597727437,33,1,31.27,4,1,1,6
1515915625597728464,33,1,24.6,4,1,1,6
1515915625597729017,33,3,973.0500000000001,4,3,4,11
1515915625597729630,33,2,508.51,4,2,4,10
1515915625597729792,25,3,96.75,4,3,3,10
1515915625597730798,33,1,897.79,4,1,4,9
1515915625597732056,33,1,292.83,4,1,4,9
1515915625597732478,33,1,40.57,4,1,2,7
1515915625597732956,33,1,164.33,4,1,3,8
1515915625597732995,33,1,600.6,4,1,4,9
1515915625597733403,33,3,983.14,4,3,4,11
1515915625597735939,33,3,233.19,4,3,3,10
1515915625597737704,30,4,563.44,4,3,4,11
1515915625597740113,33,2,63.5,4,2,2,8
1515915625597741158,33,1,25.4,4,1,1,6
1515915625597744983,15,3,850.97,4,3,4,11
1515915625597748778,31,4,68.56,4,3,2,9
1515915625597758876,29,2,13.58,4,2,1,7
1515915625597759321,33,6,1157.16,4,4,4,12
1515915625597762055,33,1,77.73,4,1,2,7
1515915625597763389,33,2,454.6,4,2,4,10
1515915625597765632,33,2,1155.2,4,2,4,10
1515915625597767018,33,1,128.79,4,1,3,8
1515915625597768445,32,1,77.73,4,1,2,7
1515915625597769235,33,1,471.52,4,1,4,9
1515915625597776790,33,1,11.86,4,1,1,6
1515915625597777163,33,2,55.24,4,2,2,8
1515915625597778072,33,2,1679.5,4,2,4,10
1515915625597778851,33,1,839.75,4,1,4,9
1515915625597779320,33,1,32.22,4,1,1,6
1515915625597780853,33,2,155.46,4,2,3,9
1515915625597788586,33,1,201.33,4,1,3,8
1515915625597790050,33,1,466.52,4,1,4,9
1515915625597791610,32,1,259.94,4,1,3,8
1515915625597794611,33,2,214.32,4,2,3,9
1515915625597795000,33,2,62.22,4,2,2,8
1515915625597795348,33,1,599.6,4,1,4,9
1515915625597797607,33,1,10.48,4,1,1,6
1515915625597798458,33,1,43.65,4,1,2,7
1515915625597798744,33,1,32.81,4,1,2,7
1515915625597800571,33,3,58.11,4,3,2,9
1515915625597800858,32,1,22.7,4,1,1,6
1515915625597806190,33,1,43.11,4,1,2,7
1515915625597806212,33,2,86.22,4,2,2,8
1515915625597807539,26,1,418.48,4,1,4,9
1515915625597807757,22,2,155.04,4,2,3,9
1515915625597810272,33,1,26.46,4,1,1,6
1515915625597816146,33,1,43.65,4,1,2,7
1515915625597816798,33,1,43.11,4,1,2,7
1515915625597818096,33,1,16.19,4,1,1,6
1515915625597820287,10,3,205.69,4,3,3,10
1515915625597821597,29,1,259.94,4,1,3,8
1515915625597823015,33,1,397.48,4,1,4,9
1515915625597829154,33,1,482.52,4,1,4,9
1515915625597830620,33,1,188.06,4,1,3,8
1515915625597831616,33,3,263.65,4,3,3,10
1515915625597831645,33,4,114.28,4,3,3,10
1515915625597833461,26,5,1363.43,4,4,4,12
1515915625597834165,33,1,397.48,4,1,4,9
1515915625597836667,33,1,12.22,4,1,1,6
1515915625597837864,33,1,171.9,4,1,3,8
1515915625597847139,32,3,709.9000000000001,4,3,4,11
1515915625597851175,33,1,577.6,4,1,4,9
1515915625597851669,32,1,210.68,4,1,3,8
1515915625597858547,32,2,54.92,4,2,2,8
1515915625597859172,32,1,115.4,4,1,3,8
1515915625597874542,32,1,56.35,4,1,2,7
1515915625597874635,32,1,656.63,4,1,4,9
1515915625597880889,32,2,1249.24,4,2,4,10
1515915625597883585,32,1,10.59,4,1,1,6
1515915625597884964,32,1,16.19,4,1,1,6
1515915625597890727,31,1,292.83,4,1,4,9
1515915625597891089,32,1,278.41,4,1,3,8
1515915625597892513,32,1,577.6,4,1,4,9
1515915625597898241,32,1,31.27,4,1,1,6
1515915625597898502,32,2,112.54,4,2,3,9
1515915625597898715,32,1,435.7,4,1,4,9
1515915625597901984,32,1,466.52,4,1,4,9
1515915625597902656,32,3,465.29999999999995,4,3,4,11
1515915625597911647,12,3,2070.82,4,3,4,11
1515915625597911798,32,1,31.11,4,1,1,6
1515915625597915971,32,2,87.62,4,2,2,8
1515915625597922526,32,2,103.8,4,2,3,9
1515915625597926166,32,2,1345.26,4,2,4,10
1515915625597928310,31,1,127.08,4,1,3,8
1515915625597928817,31,1,43.11,4,1,2,7
1515915625597931263,32,1,15.08,4,1,1,6
1515915625597931809,32,2,164.28,4,2,3,9
1515915625597932798,32,1,214.1,4,1,3,8
1515915625597934356,32,1,246.59,4,1,3,8
1515915625597939121,32,1,29.22,4,1,1,6
1515915625597942174,20,3,596.45,4,3,4,11
1515915625597942601,32,2,420.38,4,2,4,10
1515915625597942889,32,1,80.06,4,1,2,7
1515915625597944922,32,1,98.37,4,1,3,8
1515915625597946058,32,1,53.17,4,1,2,7
1515915625597946213,32,1,51.17,4,1,2,7
1515915625597946916,32,1,404.49,4,1,4,9
1515915625597950086,32,2,409.58,4,2,4,10
1515915625597952706,30,3,1067.18,4,3,4,11
1515915625597953333,32,1,572.57,4,1,4,9
1515915625597953412,32,1,12.83,4,1,1,6
1515915625597954569,32,1,12.83,4,1,1,6
1515915625597957657,32,3,51.0,4,3,2,9
1515915625597959484,28,1,220.95,4,1,3,8
1515915625597963422,32,4,228.24,4,3,3,10
1515915625597963488,32,1,284.46,4,1,3,8
1515915625597964017,32,1,202.67,4,1,3,8
1515915625597967023,32,1,9.81,4,1,1,6
1515915625597968209,3,2,165.94,4,2,3,9
1515915625597970426,32,1,59.68,4,1,2,7
1515915625597973068,32,2,38.74,4,2,2,8
1515915625597975423,31,2,1197.2,4,2,4,10
1515915625597978284,32,6,624.14,4,4,4,12
1515915625597979318,32,1,11.65,4,1,1,6
1515915625597979973,32,3,492.99,4,3,4,11
1515915625597980687,32,2,195.3,4,2,3,9
1515915625597980885,32,1,466.52,4,1,4,9
1515915625597983456,32,1,397.48,4,1,4,9
1515915625597983661,32,2,355.9,4,2,4,10
1515915625597986273,18,2,135.94,4,2,3,9
1515915625597987808,32,1,11.65,4,1,1,6
1515915625597988373,32,2,730.82,4,2,4,10
1515915625597993692,32,1,22.43,4,1,1,6
1515915625597998736,32,2,62.22,4,2,2,8
1515915625598001712,32,1,17.49,4,1,1,6
1515915625598003709,32,2,585.66,4,2,4,10
1515915625598007365,32,1,797.71,4,1,4,9
1515915625598010427,13,1,294.41,4,1,4,9
1515915625598011900,32,1,314.68,4,1,4,9
1515915625598012651,32,1,218.98,4,1,3,8
1515915625598013900,32,1,43.11,4,1,2,7
1515915625598014639,32,3,64.77,4,3,2,9
1515915625598015999,32,1,115.4,4,1,3,8
1515915625598016113,32,1,294.41,4,1,4,9
1515915625598016759,32,2,27.58,4,2,1,7
1515915625598019524,32,2,52.38,4,2,2,8
1515915625598019927,32,1,28.1,4,1,1,6
1515915625598020477,32,2,147.66,4,2,3,9
1515915625598021712,32,1,586.54,4,1,4,9
1515915625598023651,32,1,26.19,4,1,1,6
1515915625598023730,32,1,26.19,4,1,1,6
1515915625598024995,32,1,16.19,4,1,1,6
1515915625598025847,32,1,214.1,4,1,3,8
1515915625598029238,32,1,292.83,4,1,4,9
1515915625598030639,9,21,2304.76,4,4,4,12
1515915625598031300,32,1,322.57,4,1,4,9
1515915625598032491,21,5,1072.4,4,4,4,12
1515915625598033369,32,2,128.26,4,2,3,9
1515915625598034247,32,2,43.18,4,2,2,8
1515915625598040265,32,2,64.44,4,2,2,8
1515915625598051308,32,1,80.03,4,1,2,7
1515915625598051983,32,1,89.22,4,1,2,7
1515915625598052095,20,2,289.02,4,2,4,10
1515915625598053871,32,1,19.84,4,1,1,6
1515915625598059637,28,2,500.76,4,2,4,10
1515915625598061310,32,1,34.44,4,1,2,7
1515915625598063350,31,2,71.74,4,2,2,8
1515915625598066986,32,1,656.63,4,1,4,9
1515915625598068089,29,3,154.11,4,3,3,10
1515915625598068391,32,2,174.92,4,2,3,9
1515915625598069419,32,6,2875.21,4,4,4,12
1515915625598071893,29,2,86.22,4,2,2,8
1515915625598072342,13,2,116.2,4,2,3,9
1515915625598072844,27,2,80.0,4,2,2,8
1515915625598073945,32,1,21.43,4,1,1,6
1515915625598074631,32,1,15.24,4,1,1,6
1515915625598075692,27,2,42.22,4,2,2,8
1515915625598076196,32,1,104.6,4,1,3,8
1515915625598077500,32,2,37.14,4,2,2,8
1515915625598085515,32,2,458.76,4,2,4,10
1515915625598086259,32,1,55.24,4,1,2,7
1515915625598086438,32,1,72.86,4,1,2,7
1515915625598087015,32,2,241.12,4,2,3,9
1515915625598087717,32,1,9.35,4,1,1,6
1515915625598090183,32,2,385.72,4,2,4,10
1515915625598091093,32,3,1394.56,4,3,4,11
1515915625598094014,31,2,176.38,4,2,3,9
1515915625598095737,32,1,43.11,4,1,2,7
1515915625598096320,32,1,15.08,4,1,1,6
1515915625598096661,32,1,11.71,4,1,1,6
1515915625598104677,32,1,600.6,4,1,4,9
1515915625598104744,32,1,19.68,4,1,1,6
1515915625598106545,32,3,269.54,4,3,3,10
1515915625598107724,32,2,111.74,4,2,3,9
1515915625598109238,32,2,1440.35,4,2,4,10
1515915625598109479,23,7,1162.1000000000001,4,4,4,12
1515915625598112161,32,1,32.86,4,1,2,7
1515915625598112390,32,2,253.36,4,2,3,9
1515915625598116407,25,2,254.16,4,2,3,9
1515915625598118466,32,3,69.99,4,3,2,9
1515915625598120016,6,2,467.48,4,2,4,10
1515915625598120089,32,2,151.42,4,2,3,9
1515915625598120205,32,1,540.14,4,1,4,9
1515915625598122429,27,5,1407.01,4,4,4,12
1515915625598124442,32,1,397.48,4,1,4,9
1515915625598125061,32,1,32.51,4,1,2,7
1515915625598126671,32,1,106.43,4,1,3,8
1515915625598128425,31,3,115.22999999999999,4,3,3,10
1515915625598132869,32,3,823.1999999999999,4,3,4,11
1515915625598139375,32,2,289.02,4,2,4,10
1515915625598139811,32,1,24.6,4,1,1,6
1515915625598140595,32,1,130.0,4,1,3,8
1515915625598140988,32,1,31.11,4,1,1,6
1515915625598144810,30,1,444.51,4,1,4,9
1515915625598148297,32,1,43.11,4,1,2,7
1515915625598150506,32,2,30.98,4,2,1,7
1515915625598152544,32,1,152.08,4,1,3,8
1515915625598152566,27,5,368.93,4,4,4,12
1515915625598160919,32,1,48.27,4,1,2,7
1515915625598166081,8,3,1307.1,4,3,4,11
1515915625598169228,32,1,13.33,4,1,1,6
1515915625598169660,32,1,27.89,4,1,1,6
1515915625598172981,32,1,88.25,4,1,2,7
1515915625598176287,23,4,87.24,4,3,2,9
1515915625598176554,32,2,222.44,4,2,3,9
1515915625598177612,32,1,292.83,4,1,4,9
1515915625598182992,32,1,519.56,4,1,4,9
1515915625598186329,32,2,102.66,4,2,3,9
1515915625598196450,32,1,202.67,4,1,3,8
1515915625598199632,32,1,29.37,4,1,1,6
1515915625598201411,31,1,294.41,4,1,4,9
1515915625598207619,31,3,1303.8000000000002,4,3,4,11
1515915625598210308,30,10,4412.95,4,4,4,12
1515915625598214700,31,3,108.42,4,3,3,10
1515915625598215841,31,1,370.46,4,1,4,9
1515915625598216695,31,10,1205.28,4,4,4,12
1515915625598219238,31,3,248.91,4,3,3,10
1515915625598223459,31,1,50.7,4,1,2,7
1515915625598226048,31,1,23.33,4,1,1,6
1515915625598228555,31,1,303.43,4,1,4,9
1515915625598228645,31,1,15.08,4,1,1,6
1515915625598237046,31,1,11.75,4,1,1,6
1515915625598240738,31,1,21.11,4,1,1,6
1515915625598242228,31,1,17.14,4,1,1,6
1515915625598243583,31,1,58.25,4,1,2,7
1515915625598246053,31,2,32.38,4,2,2,8
1515915625598255190,31,1,18.57,4,1,1,6
1515915625598260864,31,2,496.12,4,2,4,10
1515915625598261230,31,2,61.42,4,2,2,8
1515915625598261397,31,1,11.83,4,1,1,6
1515915625598262543,21,2,380.06,4,2,4,10
1515915625598264861,31,3,1412.58,4,3,4,11
1515915625598267725,31,1,31.71,4,1,1,6
1515915625598269818,31,1,26.17,4,1,1,6
1515915625598273982,31,1,292.83,4,1,4,9
1515915625598278338,12,1,156.21,4,1,3,8
1515915625598279820,31,1,23.35,4,1,1,6
1515915625598283076,31,1,38.44,4,1,2,7
1515915625598290013,31,2,30.16,4,2,1,7
1515915625598291327,31,1,16.35,4,1,1,6
1515915625598292805,31,1,66.3,4,1,2,7
1515915625598293128,26,2,585.66,4,2,4,10
1515915625598293193,31,4,1185.53,4,3,4,11
1515915625598295050,31,1,15.24,4,1,1,6
1515915625598299084,31,1,23.62,4,1,1,6
1515915625598301883,31,2,165.94,4,2,3,9
1515915625598302355,31,1,72.52,4,1,2,7
1515915625598306341,31,3,39.06,4,3,2,9
1515915625598306393,31,1,20.79,4,1,1,6
1515915625598308897,3,4,1655.94,4,3,4,11
1515915625598310486,31,2,21.68,4,2,1,7
1515915625598312016,31,4,155.88,4,3,3,10
1515915625598312215,31,1,69.14,4,1,2,7
1515915625598313908,31,1,1.57,4,1,1,6
1515915625598315431,31,1,129.7,4,1,3,8
1515915625598315700,26,3,216.57,4,3,3,10
1515915625598316393,31,1,10.05,4,1,1,6
1515915625598316699,31,1,303.43,4,1,4,9
1515915625598319166,31,1,85.97,4,1,2,7
1515915625598328031,31,2,841.26,4,2,4,10
1515915625598330266,31,2,585.66,4,2,4,10
1515915625598331462,31,4,70.48,4,3,2,9
1515915625598335006,31,3,78.57000000000001,4,3,2,9
1515915625598335613,31,1,13.97,4,1,1,6
1515915625598335702,31,1,51.33,4,1,2,7
1515915625598336900,31,2,41.58,4,2,2,8
1515915625598341093,31,2,46.66,4,2,2,8
1515915625598347656,31,5,92.05,4,4,3,11
1515915625598348026,30,1,22.22,4,1,1,6
1515915625598351298,31,1,397.48,4,1,4,9
1515915625598355233,31,1,292.83,4,1,4,9
1515915625598357273,31,1,401.75,4,1,4,9
1515915625598359711,31,1,68.89,4,1,2,7
1515915625598361723,31,1,13.25,4,1,1,6
1515915625598362405,31,1,31.59,4,1,1,6
1515915625598363378,31,1,21.11,4,1,1,6
1515915625598364948,31,1,507.94,4,1,4,9
1515915625598366521,30,2,434.03999999999996,4,2,4,10
1515915625598367029,26,4,967.47,4,3,4,11
1515915625598381875,31,1,90.63,4,1,2,7
1515915625598386885,28,2,227.74,4,2,3,9
1515915625598389562,31,2,24.86,4,2,1,7
1515915625598394317,31,1,15.87,4,1,1,6
1515915625598395182,31,1,32.22,4,1,1,6
1515915625598404400,31,1,656.63,4,1,4,9
1515915625598405577,5,2,981.08,4,2,4,10
1515915625598408026,24,3,399.09000000000003,4,3,4,11
1515915625598410882,31,1,486.81,4,1,4,9
1515915625598411419,16,2,506.76,4,2,4,10
1515915625598413085,31,2,21.58,4,2,1,7
1515915625598414965,31,1,312.43,4,1,4,9
1515915625598416406,31,1,214.1,4,1,3,8
1515915625598417028,30,1,187.29,4,1,3,8
1515915625598417572,31,1,397.48,4,1,4,9
1515915625598421031,31,1,22.41,4,1,1,6
1515915625598423104,31,6,127.26,4,4,3,11
1515915625598424637,16,3,1801.77,4,3,4,11
1515915625598426552,31,1,29.22,4,1,1,6
1515915625598429782,30,1,397.48,4,1,4,9
1515915625598432193,31,2,101.26,4,2,3,9
1515915625598435462,31,1,19.05,4,1,1,6
1515915625598437767,31,1,13.86,4,1,1,6
1515915625598437785,31,1,20.0,4,1,1,6
1515915625598439664,31,1,435.73,4,1,4,9
1515915625598439689,31,3,47.7,4,3,2,9
1515915625598439871,31,1,215.06,4,1,3,8
1515915625598444324,17,1,25.08,4,1,1,6
1515915625598444797,31,2,42.04,4,2,2,8
1515915625598446581,26,3,37.64,4,3,2,9
1515915625598451287,31,1,18.56,4,1,1,6
1515915625598454294,29,1,797.71,4,1,4,9
1515915625598455415,31,1,292.83,4,1,4,9
1515915625598457833,30,2,846.99,4,2,4,10
1515915625598463481,31,1,19.05,4,1,1,6
1515915625598463813,31,1,292.83,4,1,4,9
1515915625598464154,31,2,64.44,4,2,2,8
1515915625598464300,31,1,214.1,4,1,3,8
1515915625598466737,31,1,397.48,4,1,4,9
1515915625598476130,31,3,2080.4700000000003,4,3,4,11
1515915625598478713,30,3,254.67000000000002,4,3,3,10
1515915625598480151,31,1,214.1,4,1,3,8
1515915625598482833,31,1,28.57,4,1,1,6
1515915625598488368,31,1,56.35,4,1,2,7
1515915625598491115,31,1,163.52,4,1,3,8
1515915625598492248,23,1,173.86,4,1,3,8
1515915625598496654,31,2,135.24,4,2,3,9
1515915625598497754,31,2,588.82,4,2,4,10
1515915625598499799,28,3,595.86,4,3,4,11
1515915625598501037,13,1,839.75,4,1,4,9
1515915625598501163,30,1,47.56,4,1,2,7
1515915625598501607,31,1,16.83,4,1,1,6
1515915625598501669,31,2,71.36,4,2,2,8
1515915625598502308,30,1,263.52,4,1,3,8
1515915625598502374,22,3,534.66,4,3,4,11
1515915625598503096,25,5,1176.28,4,4,4,12
1515915625598509738,31,2,794.96,4,2,4,10
1515915625598512339,31,2,933.04,4,2,4,10
1515915625598513765,30,1,58.25,4,1,2,7
1515915625598513780,31,1,397.48,4,1,4,9
1515915625598518358,31,1,307.43,4,1,4,9
1515915625598520750,30,8,110.64,4,4,3,11
1515915625598522821,31,3,127.71000000000001,4,3,3,10
1515915625598523524,31,1,55.0,4,1,2,7
1515915625598525058,31,1,214.1,4,1,3,8
1515915625598527403,31,1,14.52,4,1,1,6
1515915625598536300,5,4,1168.3899999999999,4,3,4,11
1515915625598538119,31,1,183.49,4,1,3,8
1515915625598538231,22,1,23.9,4,1,1,6
1515915625598545150,24,8,3674.52,4,4,4,12
1515915625598546231,30,2,1313.26,4,2,4,10
1515915625598550095,30,2,588.82,4,2,4,10
1515915625598562268,30,1,82.97,4,1,2,7
1515915625598563239,15,1,75.76,4,1,2,7
1515915625598564596,30,1,18.1,4,1,1,6
1515915625598567526,30,1,478.75,4,1,4,9
1515915625598569653,27,1,53.46,4,1,2,7
1515915625598570188,30,1,22.79,4,1,1,6
1515915625598570396,30,1,32.38,4,1,2,7
1515915625598571386,22,1,34.44,4,1,2,7
1515915625598571537,30,2,128.96,4,2,3,9
1515915625598572543,23,1,32.38,4,1,2,7
1515915625598576790,30,2,585.66,4,2,4,10
1515915625598584736,30,1,204.29,4,1,3,8
1515915625598585186,30,1,32.22,4,1,1,6
1515915625598586533,30,4,171.92,4,3,3,10
1515915625598594485,30,2,27.22,4,2,1,7
1515915625598594964,30,3,462.53999999999996,4,3,4,11
1515915625598597573,30,1,97.46,4,1,3,8
1515915625598601011,30,1,210.9,4,1,3,8
1515915625598603565,30,1,897.79,4,1,4,9
1515915625598606323,30,1,16.83,4,1,1,6
1515915625598609435,30,2,42.22,4,2,2,8
1515915625598612126,30,1,17.73,4,1,1,6
1515915625598612650,30,1,47.84,4,1,2,7
1515915625598613652,30,1,14.6,4,1,1,6
1515915625598615668,30,1,33.97,4,1,2,7
1515915625598615671,30,1,163.52,4,1,3,8
1515915625598621073,29,2,75.56,4,2,2,8
1515915625598624106,21,5,161.1,4,4,3,11
1515915625598625074,30,1,66.63,4,1,2,7
1515915625598627916,30,2,32.38,4,2,2,8
1515915625598628728,30,6,1216.02,4,4,4,12
1515915625598629975,30,1,414.13,4,1,4,9
1515915625598631499,30,1,15.08,4,1,1,6
1515915625598634044,30,1,25.71,4,1,1,6
1515915625598634410,30,1,15.08,4,1,1,6
1515915625598635866,30,4,776.4,4,3,4,11
1515915625598638911,30,1,397.48,4,1,4,9
1515915625598645460,30,1,28.62,4,1,1,6
1515915625598646997,30,1,449.51,4,1,4,9
1515915625598648037,30,1,19.68,4,1,1,6
1515915625598648132,30,1,200.35,4,1,3,8
1515915625598656492,28,1,10.21,4,1,1,6
1515915625598659259,30,1,24.6,4,1,1,6
1515915625598660944,30,1,490.54,4,1,4,9
1515915625598661935,30,2,1059.38,4,2,4,10
1515915625598665576,30,2,36.2,4,2,2,8
1515915625598670523,30,1,294.41,4,1,4,9
1515915625598680254,30,1,415.54,4,1,4,9
1515915625598681974,30,1,37.3,4,1,2,7
1515915625598682185,30,1,322.57,4,1,4,9
1515915625598683349,30,1,75.76,4,1,2,7
1515915625598685163,30,5,614.3,4,4,4,12
1515915625598686032,30,1,15.68,4,1,1,6
1515915625598686485,30,1,87.05,4,1,2,7
1515915625598690639,30,1,29.84,4,1,1,6
1515915625598694919,30,1,20.56,4,1,1,6
1515915625598695948,30,1,23.48,4,1,1,6
1515915625598698284,30,1,123.35,4,1,3,8
1515915625598702238,27,1,15.71,4,1,1,6
1515915625598704562,30,1,135.87,4,1,3,8
1515915625598705105,30,2,116.5,4,2,3,9
1515915625598707345,30,1,33.65,4,1,2,7
1515915625598710251,30,1,298.76,4,1,4,9
1515915625598711039,30,1,486.81,4,1,4,9
1515915625598713584,30,4,128.88,4,3,3,10
1515915625598715486,30,1,397.48,4,1,4,9
1515915625598716672,30,1,43.11,4,1,2,7
1515915625598717076,27,1,32.22,4,1,1,6
1515915625598718184,30,1,251.4,4,1,3,8
1515915625598718354,30,1,157.14,4,1,3,8
1515915625598718828,28,1,292.83,4,1,4,9
1515915625598720179,30,1,202.67,4,1,3,8
1515915625598721584,30,1,103.83,4,1,3,8
1515915625598724547,30,1,23.48,4,1,1,6
1515915625598727061,30,1,12.22,4,1,1,6
1515915625598731932,26,1,15.68,4,1,1,6
1515915625598732234,30,1,24.11,4,1,1,6
1515915625598734163,30,1,32.22,4,1,1,6
1515915625598746184,30,4,225.4,4,3,3,10
1515915625598752320,30,1,55.16,4,1,2,7
1515915625598753122,30,1,471.52,4,1,4,9
1515915625598754945,30,1,22.68,4,1,1,6
1515915625598758679,30,2,66.66,4,2,2,8
1515915625598761463,30,1,177.95,4,1,3,8
1515915625598763209,30,2,554.2,4,2,4,10
1515915625598766083,30,2,536.34,4,2,4,10
1515915625598767236,30,1,257.87,4,1,3,8
1515915625598770345,30,1,4.14,4,1,1,6
1515915625598771362,30,1,56.27,4,1,2,7
1515915625598774204,29,7,869.0,4,4,4,12
1515915625598774643,30,1,229.38,4,1,3,8
1515915625598776788,30,3,66.66,4,3,2,9
1515915625598777098,30,2,74.34,4,2,2,8
1515915625598779854,30,1,87.16,4,1,2,7
1515915625598780085,25,1,28.41,4,1,1,6
1515915625598785688,30,5,3768.49,4,4,4,12
1515915625598786771,30,2,102.66,4,2,3,9
1515915625598787120,30,2,614.86,4,2,4,10
1515915625598790153,30,1,171.9,4,1,3,8
1515915625598792859,30,7,867.94,4,4,4,12
1515915625598793209,30,2,410.5,4,2,4,10
1515915625598794139,30,1,18.57,4,1,1,6
1515915625598799157,30,1,205.25,4,1,3,8
1515915625598806881,7,1,259.38,4,1,3,8
1515915625598807921,30,2,959.02,4,2,4,10
1515915625598809614,30,1,73.81,4,1,2,7
1515915625598810692,30,1,16.83,4,1,1,6
1515915625598810757,5,2,1012.0999999999999,4,2,4,10
1515915625598815786,30,1,292.83,4,1,4,9
1515915625598819950,2,3,340.14,4,3,4,11
1515915625598820213,30,1,11.17,4,1,1,6
1515915625598825403,30,1,216.05,4,1,3,8
1515915625598835449,30,1,298.76,4,1,4,9
1515915625598839518,30,2,140.32,4,2,3,9
1515915625598840366,30,2,453.68,4,2,4,10
1515915625598850304,7,8,865.23,4,4,4,12
1515915625598850597,30,3,94.93,4,3,3,10
1515915625598853641,21,1,159.1,4,1,3,8
1515915625598858353,30,1,9.75,4,1,1,6
1515915625598867226,30,1,397.48,4,1,4,9
1515915625598868019,30,2,305.02,4,2,4,10
1515915625598869179,19,1,294.41,4,1,4,9
1515915625598878090,30,1,202.67,4,1,3,8
1515915625598882522,30,1,397.48,4,1,4,9
1515915625598888616,18,1,99.92,4,1,3,8
1515915625598888944,13,2,62.22,4,2,2,8
1515915625598896732,29,1,345.44,4,1,4,9
1515915625598897279,29,1,31.27,4,1,1,6
1515915625598903360,29,4,1400.22,4,3,4,11
1515915625598904642,29,2,93.9,4,2,3,9
1515915625598908685,29,1,16.98,4,1,1,6
1515915625598914853,29,4,2014.1599999999999,4,3,4,11
1515915625598915724,29,7,3347.69,4,4,4,12
1515915625598916269,29,1,126.68,4,1,3,8
1515915625598916786,29,1,204.29,4,1,3,8
1515915625598918667,29,1,839.75,4,1,4,9
1515915625598920009,29,1,187.29,4,1,3,8
1515915625598928676,26,3,1275.49,4,3,4,11
1515915625598930864,29,4,2513.46,4,3,4,11
1515915625598931145,23,5,633.4000000000001,4,4,4,12
1515915625598931197,29,1,72.38,4,1,2,7
1515915625598932991,29,2,63.18,4,2,2,8
1515915625598933402,29,1,72.38,4,1,2,7
1515915625598936603,17,1,166.02,4,1,3,8
1515915625598937825,28,2,572.9200000000001,4,2,4,10
1515915625598945248,29,1,191.52,4,1,3,8
1515915625598956445,28,1,16.19,4,1,1,6
1515915625598959770,27,3,43.8,4,3,2,9
1515915625598960738,29,1,519.56,4,1,4,9
1515915625598960910,29,1,115.1,4,1,3,8
1515915625598961144,29,1,839.75,4,1,4,9
1515915625598961499,29,1,24.89,4,1,1,6
1515915625598968334,29,2,588.82,4,2,4,10
1515915625598970859,20,1,183.67,4,1,3,8
1515915625598974086,29,1,214.1,4,1,3,8
1515915625598974764,27,10,344.4,4,4,4,12
1515915625598976150,29,1,294.41,4,1,4,9
1515915625598976451,29,1,33.97,4,1,2,7
1515915625598977227,11,2,29.2,4,2,1,7
1515915625598978059,29,4,84.84,4,3,2,9
1515915625598979216,29,1,34.76,4,1,2,7
1515915625598979833,29,1,26.83,4,1,1,6
1515915625598981934,29,1,27.21,4,1,1,6
1515915625598984634,24,1,46.67,4,1,2,7
1515915625598986727,23,1,56.51,4,1,2,7
1515915625598992101,29,1,26.83,4,1,1,6
1515915625598992205,29,1,13.86,4,1,1,6
1515915625598994763,29,1,24.76,4,1,1,6
1515915625598994844,29,1,42.98,4,1,2,7
1515915625598998360,29,1,539.57,4,1,4,9
1515915625599000539,15,1,17.71,4,1,1,6
1515915625599001605,29,2,254.16,4,2,3,9
1515915625599004692,29,4,1798.44,4,3,4,11
1515915625599010558,29,12,1591.38,4,4,4,12
1515915625599012969,29,1,548.37,4,1,4,9
1515915625599016345,29,3,28.049999999999997,4,3,1,8
1515915625599016358,29,1,15.4,4,1,1,6
1515915625599018405,29,1,140.86,4,1,3,8
1515915625599019347,28,1,57.13,4,1,2,7
1515915625599031742,29,1,38.1,4,1,2,7
1515915625599037234,29,1,32.38,4,1,2,7
1515915625599043213,29,2,155.46,4,2,3,9
1515915625599045647,29,1,16.33,4,1,1,6
1515915625599052925,29,1,10.16,4,1,1,6
1515915625599055322,29,1,21.21,4,1,1,6
1515915625599056785,29,1,75.29,4,1,2,7
1515915625599062390,11,2,99.22,4,2,3,9
1515915625599064879,29,1,449.51,4,1,4,9
1515915625599071666,29,1,577.6,4,1,4,9
1515915625599075961,29,1,68.05,4,1,2,7
1515915625599076121,29,1,519.56,4,1,4,9
1515915625599083367,2,3,833.21,4,3,4,11
1515915625599097311,29,1,44.86,4,1,2,7
1515915625599098433,29,1,25.33,4,1,1,6
1515915625599099929,29,1,82.97,4,1,2,7
1515915625599100740,29,2,128.73,4,2,3,9
1515915625599102435,21,2,71.08,4,2,2,8
1515915625599108373,29,1,17.62,4,1,1,6
1515915625599111910,29,3,1717.71,4,3,4,11
1515915625599113574,29,1,572.57,4,1,4,9
1515915625599113999,5,1,12.08,4,1,1,6
1515915625599117171,29,1,327.43,4,1,4,9
1515915625599118870,4,2,158.42,4,2,3,9
1515915625599121454,29,2,53.52,4,2,2,8
1515915625599124428,27,3,168.42000000000002,4,3,3,10
1515915625599127028,28,1,77.73,4,1,2,7
1515915625599128292,5,2,93.34,4,2,3,9
1515915625599130599,29,3,642.3,4,3,4,11
1515915625599133003,26,4,174.28,4,3,3,10
1515915625599134792,29,1,29.22,4,1,1,6
1515915625599137754,29,1,115.08,4,1,3,8
1515915625599137792,29,2,588.82,4,2,4,10
1515915625599138683,28,3,195.39,4,3,3,10
1515915625599139410,29,1,115.08,4,1,3,8
1515915625599140465,29,1,239.19,4,1,3,8
1515915625599156028,29,1,21.43,4,1,1,6
1515915625599156795,29,1,20.65,4,1,1,6
1515915625599159523,25,1,839.75,4,1,4,9
1515915625599159581,25,2,1155.2,4,2,4,10
1515915625599160402,29,2,58.96,4,2,2,8
1515915625599171655,26,2,440.94,4,2,4,10
1515915625599173446,29,1,42.98,4,1,2,7
1515915625599180482,29,2,281.72,4,2,3,9
1515915625599183836,29,2,21.36,4,2,1,7
1515915625599185343,29,2,58.44,4,2,2,8
1515915625599189416,29,1,18.29,4,1,1,6
1515915625599190728,29,1,309.41,4,1,4,9
1515915625599191747,8,5,180.7,4,4,3,11
1515915625599191749,29,1,1.57,4,1,1,6
1515915625599192190,18,1,839.75,4,1,4,9
1515915625599198975,29,1,55.87,4,1,2,7
1515915625599202047,29,2,92.25,4,2,3,9
1515915625599202052,29,2,291.6,4,2,4,10
1515915625599205268,29,1,163.48,4,1,3,8
1515915625599209784,29,1,10.84,4,1,1,6
1515915625599213784,29,1,10.43,4,1,1,6
1515915625599216403,29,2,393.84000000000003,4,2,4,10
1515915625599216405,29,1,17.3,4,1,1,6
1515915625599217031,28,1,672.63,4,1,4,9
1515915625599217349,29,1,415.54,4,1,4,9
1515915625599217691,29,2,310.2,4,2,4,10
1515915625599223770,29,1,19.68,4,1,1,6
1515915625599226363,24,2,84.97,4,2,2,8
1515915625599228396,29,1,155.1,4,1,3,8
1515915625599230841,19,4,1469.54,4,3,4,11
1515915625599231249,29,1,16.98,4,1,1,6
1515915625599234010,29,1,55.4,4,1,2,7
1515915625599238926,29,2,170.49,4,2,3,9
1515915625599240418,19,2,981.08,4,2,4,10
1515915625599246343,29,1,600.6,4,1,4,9
1515915625599248306,29,2,30.16,4,2,1,7
1515915625599252746,28,1,242.54,4,1,3,8
1515915625599259109,28,1,150.29,4,1,3,8
1515915625599262407,27,1,73.81,4,1,2,7
1515915625599271339,20,1,399.48,4,1,4,9
1515915625599275885,28,1,435.7,4,1,4,9
1515915625599279300,28,2,20.42,4,2,1,7
1515915625599282236,28,1,13.81,4,1,1,6
1515915625599283422,28,3,201.89999999999998,4,3,3,10
1515915625599286011,28,1,15.24,4,1,1,6
1515915625599286095,28,1,217.57,4,1,3,8
1515915625599288359,21,1,13.81,4,1,1,6
1515915625599288565,27,1,26.98,4,1,1,6
1515915625599294542,28,1,0.9,4,1,1,6
1515915625599296299,28,1,17.02,4,1,1,6
1515915625599297582,28,3,707.9100000000001,4,3,4,11
1515915625599299795,28,2,59.8,4,2,2,8
1515915625599302567,28,3,1154.04,4,3,4,11
1515915625599302947,28,2,70.16,4,2,2,8
1515915625599303346,28,1,22.22,4,1,1,6
1515915625599304220,28,3,64.28999999999999,4,3,2,9
1515915625599304804,28,1,20.0,4,1,1,6
1515915625599308237,28,1,300.17,4,1,4,9
1515915625599312229,28,1,9.35,4,1,1,6
1515915625599313296,28,1,32.22,4,1,1,6
1515915625599315551,27,1,12.27,4,1,1,6
1515915625599323926,28,1,68.57,4,1,2,7
1515915625599325561,28,1,35.08,4,1,2,7
1515915625599326251,12,1,34.44,4,1,2,7
1515915625599327281,28,1,29.84,4,1,1,6
1515915625599333033,28,1,21.9,4,1,1,6
1515915625599334517,28,1,23.22,4,1,1,6
1515915625599335166,25,1,199.37,4,1,3,8
1515915625599337201,28,1,29.22,4,1,1,6
1515915625599338698,28,1,41.27,4,1,2,7
1515915625599345161,28,1,382.94,4,1,4,9
1515915625599346899,28,1,201.52,4,1,3,8
1515915625599347380,28,1,284.46,4,1,3,8
1515915625599349525,28,1,23.4,4,1,1,6
1515915625599350227,28,1,897.79,4,1,4,9
1515915625599351614,28,1,397.48,4,1,4,9
1515915625599352916,28,1,897.79,4,1,4,9
1515915625599353763,28,1,490.54,4,1,4,9
1515915625599358860,28,1,27.62,4,1,1,6
1515915625599362208,28,1,58.57,4,1,2,7
1515915625599362740,28,1,501.54,4,1,4,9
1515915625599362747,28,2,151.46,4,2,3,9
1515915625599364323,27,2,608.82,4,2,4,10
1515915625599371408,28,4,53.96,4,3,2,9
1515915625599372047,28,1,14.52,4,1,1,6
1515915625599380751,28,2,155.46,4,2,3,9
1515915625599382914,28,2,82.75999999999999,4,2,2,8
1515915625599385876,28,1,449.51,4,1,4,9
1515915625599389264,28,6,133.98,4,4,3,11
1515915625599390044,28,1,292.83,4,1,4,9
1515915625599391075,28,1,52.49,4,1,2,7
1515915625599391232,28,1,69.35,4,1,2,7
1515915625599393391,19,1,51.68,4,1,2,7
1515915625599393447,28,8,317.5,4,4,4,12
1515915625599395238,28,1,16.19,4,1,1,6
1515915625599398692,28,1,52.49,4,1,2,7
1515915625599404841,28,1,9.35,4,1,1,6
1515915625599405728,26,2,426.08,4,2,4,10
1515915625599409597,28,1,71.75,4,1,2,7
1515915625599419996,28,1,28.73,4,1,1,6
1515915625599421251,28,1,1.57,4,1,1,6
1515915625599422793,27,3,617.67,4,3,4,11
1515915625599424895,28,1,38.83,4,1,2,7
1515915625599425010,28,1,59.9,4,1,2,7
1515915625599428059,28,1,19.94,4,1,1,6
1515915625599431670,28,1,105.87,4,1,3,8
1515915625599434728,24,1,486.81,4,1,4,9
1515915625599437399,28,1,217.57,4,1,3,8
1515915625599439206,28,2,47.8,4,2,2,8
1515915625599440095,28,1,68.37,4,1,2,7
1515915625599442215,28,1,397.48,4,1,4,9
1515915625599442753,28,1,32.86,4,1,2,7
1515915625599443876,27,1,214.9,4,1,3,8
1515915625599443991,28,1,32.06,4,1,1,6
1515915625599444111,28,5,173.5,4,4,3,11
1515915625599450605,28,2,647.34,4,2,4,10
1515915625599457517,28,1,19.05,4,1,1,6
1515915625599458928,22,1,373.46,4,1,4,9
1515915625599459292,28,1,13.81,4,1,1,6
1515915625599463119,28,1,44.76,4,1,2,7
1515915625599464633,28,1,115.4,4,1,3,8
1515915625599466087,28,1,1.57,4,1,1,6
1515915625599469985,28,1,397.48,4,1,4,9
1515915625599471778,27,3,99.14999999999999,4,3,3,10
1515915625599474215,27,2,428.2,4,2,4,10
1515915625599478214,28,1,397.48,4,1,4,9
1515915625599479851,21,2,29.32,4,2,1,7
1515915625599482958,28,1,214.1,4,1,3,8
1515915625599483128,28,1,84.95,4,1,2,7
1515915625599487662,27,2,3108.88,4,2,4,10
1515915625599491534,28,1,214.1,4,1,3,8
1515915625599491555,28,1,292.83,4,1,4,9
1515915625599491887,26,7,1430.03,4,4,4,12
1515915625599492079,28,1,642.62,4,1,4,9
1515915625599492117,28,1,449.51,4,1,4,9
1515915625599492352,28,1,197.46,4,1,3,8
1515915625599492580,28,4,207.0,4,3,3,10
1515915625599503521,28,1,6.68,4,1,1,6
1515915625599508287,28,1,10.16,4,1,1,6
1515915625599510032,28,1,204.1,4,1,3,8
1515915625599510259,19,2,85.68,4,2,2,8
1515915625599511386,28,1,123.65,4,1,3,8
1515915625599513950,28,2,473.48,4,2,4,10
1515915625599514671,28,6,806.76,4,4,4,12
1515915625599515620,28,1,32.22,4,1,1,6
1515915625599515908,28,1,397.48,4,1,4,9
1515915625599518104,28,1,16.92,4,1,1,6
1515915625599518493,28,2,80.88,4,2,2,8
1515915625599522445,28,1,249.38,4,1,3,8
1515915625599522710,22,2,70.8,4,2,2,8
1515915625599532587,28,1,490.54,4,1,4,9
1515915625599533674,28,1,397.48,4,1,4,9
1515915625599536903,27,1,839.75,4,1,4,9
1515915625599537920,28,3,254.37,4,3,3,10
1515915625599541148,28,1,32.22,4,1,1,6
1515915625599541415,26,2,186.86,4,2,3,9
1515915625599554229,28,1,435.7,4,1,4,9
1515915625599559692,6,1,44.13,4,1,2,7
1515915625599561257,23,1,38.83,4,1,2,7
1515915625599561482,28,2,322.6,4,2,4,10
1515915625599562841,28,1,415.54,4,1,4,9
1515915625599567277,28,3,116.49,4,3,3,10
1515915625599568131,27,1,214.1,4,1,3,8
1515915625599569279,28,1,38.83,4,1,2,7
1515915625599569386,28,1,268.17,4,1,3,8
1515915625599570650,28,1,15.25,4,1,1,6
1515915625599571895,28,1,292.83,4,1,4,9
1515915625599573171,28,4,51.74,4,3,2,9
1515915625599576245,28,2,437.96,4,2,4,10
1515915625599577683,28,1,178.22,4,1,3,8
1515915625599577965,28,1,204.1,4,1,3,8
1515915625599579251,27,2,102.42,4,2,3,9
1515915625599579508,28,1,178.22,4,1,3,8
1515915625599583118,27,2,585.66,4,2,4,10
1515915625599584334,28,1,399.48,4,1,4,9
1515915625599584431,28,1,292.83,4,1,4,9
1515915625599590340,28,7,1647.93,4,4,4,12
1515915625599591334,28,2,22.34,4,2,1,7
1515915625599594423,26,2,1193.68,4,2,4,10
1515915625599594736,26,2,281.72,4,2,3,9
1515915625599599454,28,1,415.54,4,1,4,9
1515915625599599943,28,1,397.48,4,1,4,9
1515915625599609892,23,1,82.33,4,1,2,7
1515915625599610367,24,1,63.98,4,1,2,7
1515915625599614020,27,1,45.24,4,1,2,7
1515915625599619755,27,1,193.25,4,1,3,8
1515915625599624354,27,1,298.76,4,1,4,9
1515915625599625859,27,2,85.96,4,2,2,8
1515915625599629949,27,1,43.87,4,1,2,7
1515915625599632354,27,2,871.0,4,2,4,10
1515915625599634008,27,4,217.16,4,3,3,10
1515915625599634258,3,39,3930.72,4,4,4,12
1515915625599638938,27,2,72.28,4,2,2,8
1515915625599638961,27,1,59.62,4,1,2,7
1515915625599644043,27,1,69.46,4,1,2,7
1515915625599647424,27,1,255.03,4,1,3,8
1515915625599649144,27,1,15.52,4,1,1,6
1515915625599651233,27,2,585.66,4,2,4,10
1515915625599651349,27,1,13.41,4,1,1,6
1515915625599652495,27,3,613.17,4,3,4,11
1515915625599653017,27,1,1.57,4,1,1,6
1515915625599657688,27,1,59.46,4,1,2,7
1515915625599658370,23,1,25.4,4,1,1,6
1515915625599658966,25,1,10.32,4,1,1,6
1515915625599659727,27,1,78.14,4,1,2,7
1515915625599661013,27,1,15.08,4,1,1,6
1515915625599665447,27,1,38.83,4,1,2,7
1515915625599666561,27,1,86.16,4,1,2,7
1515915625599673386,27,1,38.83,4,1,2,7
1515915625599673530,27,4,119.12,4,3,3,10
1515915625599673934,27,1,1073.27,4,1,4,9
1515915625599685042,27,2,235.56,4,2,3,9
1515915625599685080,27,1,399.48,4,1,4,9
1515915625599687124,23,1,294.41,4,1,4,9
1515915625599687866,27,1,171.9,4,1,3,8
1515915625599687968,27,1,15.08,4,1,1,6
1515915625599693528,27,1,38.83,4,1,2,7
1515915625599693840,27,10,2209.5,4,4,4,12
1515915625599703740,27,3,355.71,4,3,4,11
1515915625599706623,27,1,204.29,4,1,3,8
1515915625599709912,27,1,87.46,4,1,2,7
1515915625599710081,27,2,67.3,4,2,2,8
1515915625599712132,27,1,33.65,4,1,2,7
1515915625599713241,27,1,205.25,4,1,3,8
1515915625599713551,27,1,466.52,4,1,4,9
1515915625599715318,27,1,166.03,4,1,3,8
1515915625599715737,27,1,26.63,4,1,1,6
1515915625599716127,27,1,24.52,4,1,1,6
1515915625599717010,27,3,272.48,4,3,3,10
1515915625599717263,27,2,421.58,4,2,4,10
1515915625599718213,27,1,86.16,4,1,2,7
1515915625599719498,27,5,110.39999999999999,4,4,3,11
1515915625599721464,27,1,32.22,4,1,1,6
1515915625599724030,27,1,23.9,4,1,1,6
1515915625599727546,17,3,1246.6200000000001,4,3,4,11
1515915625599732544,27,1,87.56,4,1,2,7
1515915625599733649,27,1,118.57,4,1,3,8
1515915625599738291,27,2,41.62,4,2,2,8
1515915625599741955,27,1,16.89,4,1,1,6
1515915625599744164,27,3,51.66,4,3,2,9
1515915625599745436,13,2,58.44,4,2,2,8
1515915625599748461,27,1,14.6,4,1,1,6
1515915625599753788,27,1,294.41,4,1,4,9
1515915625599757394,27,5,125.22,4,4,3,11
1515915625599760178,27,2,10.44,4,2,1,7
1515915625599767164,27,1,397.48,4,1,4,9
1515915625599768337,27,1,466.52,4,1,4,9
1515915625599770485,27,1,47.81,4,1,2,7
1515915625599770671,27,1,47.81,4,1,2,7
1515915625599783980,27,1,40.63,4,1,2,7
1515915625599792717,27,1,176.17,4,1,3,8
1515915625599794392,27,1,50.63,4,1,2,7
1515915625599794935,27,1,548.37,4,1,4,9
1515915625599798208,27,2,122.86,4,2,3,9
1515915625599801202,13,1,12.7,4,1,1,6
1515915625599804948,27,1,14.95,4,1,1,6
1515915625599805642,27,1,292.83,4,1,4,9
1515915625599807543,27,1,105.14,4,1,3,8
1515915625599808928,27,1,284.46,4,1,3,8
1515915625599810277,27,2,406.58,4,2,4,10
1515915625599812720,27,1,54.44,4,1,2,7
1515915625599813155,27,1,203.29,4,1,3,8
1515915625599813630,27,1,250.38,4,1,3,8
1515915625599814119,26,1,87.05,4,1,2,7
1515915625599817686,27,1,587.6,4,1,4,9
1515915625599818316,27,1,98.62,4,1,3,8
1515915625599819944,26,2,79.73,4,2,2,8
1515915625599830762,27,1,324.35,4,1,4,9
1515915625599832597,27,2,1039.12,4,2,4,10
1515915625599834463,5,2,869.4000000000001,4,2,4,10
1515915625599835436,27,1,10.4,4,1,1,6
1515915625599837603,27,1,519.56,4,1,4,9
1515915625599838490,6,1,13.56,4,1,1,6
1515915625599841882,27,1,218.98,4,1,3,8
1515915625599843132,27,1,26.19,4,1,1,6
1515915625599846136,25,7,886.76,4,4,4,12
1515915625599847012,23,6,497.82,4,4,4,12
1515915625599851333,27,1,184.51,4,1,3,8
1515915625599851368,27,1,8.59,4,1,1,6
1515915625599855065,27,2,915.02,4,2,4,10
1515915625599856009,27,1,202.67,4,1,3,8
1515915625599856972,27,1,466.52,4,1,4,9
1515915625599858358,27,1,596.84,4,1,4,9
1515915625599867028,27,2,458.76,4,2,4,10
1515915625599867986,27,1,656.63,4,1,4,9
1515915625599868202,26,1,77.73,4,1,2,7
1515915625599868243,26,3,248.91,4,3,3,10
1515915625599869699,27,2,237.14,4,2,3,9
1515915625599870758,27,1,32.81,4,1,2,7
1515915625599873916,26,3,888.2,4,3,4,11
1515915625599874182,27,2,405.34,4,2,4,10
1515915625599879204,27,2,1537.4099999999999,4,2,4,10
1515915625599879246,27,2,588.82,4,2,4,10
1515915625599879480,27,1,397.48,4,1,4,9
1515915625599880862,27,1,34.7,4,1,2,7
1515915625599881567,26,1,194.1,4,1,3,8
1515915625599881901,27,2,242.58,4,2,3,9
1515915625599883083,20,1,187.29,4,1,3,8
1515915625599890592,27,2,108.88,4,2,3,9
1515915625599890657,27,1,268.79,4,1,3,8
1515915625599894844,27,1,214.1,4,1,3,8
1515915625599906784,27,1,29.22,4,1,1,6
1515915625599907873,27,2,27.72,4,2,1,7
1515915625599908737,27,2,27.62,4,2,1,7
1515915625599909476,26,1,36.14,4,1,2,7
1515915625599911121,26,1,98.89,4,1,3,8
1515915625599913561,27,3,79.84,4,3,2,9
1515915625599913827,27,1,30.63,4,1,1,6
1515915625599915789,24,1,72.19,4,1,2,7
1515915625599916310,27,1,45.24,4,1,2,7
1515915625599917616,27,1,73.83,4,1,2,7
1515915625599918148,26,1,120.19,4,1,3,8
1515915625599923211,27,1,397.48,4,1,4,9
1515915625599925617,27,1,22.22,4,1,1,6
1515915625599929083,14,3,116.49,4,3,3,10
1515915625599931218,27,1,3.1,4,1,1,6
1515915625599933187,27,1,16.98,4,1,1,6
1515915625599933645,27,1,9.79,4,1,1,6
1515915625599935054,27,1,53.32,4,1,2,7
1515915625599941537,27,1,49.19,4,1,2,7
1515915625599942257,27,1,50.17,4,1,2,7
1515915625599945910,9,3,195.24,4,3,3,10
1515915625599951293,27,2,102.66,4,2,3,9
1515915625599951822,27,1,155.1,4,1,3,8
1515915625599956244,27,4,59.96,4,3,2,9
1515915625599956346,26,1,591.59,4,1,4,9
1515915625599957380,20,2,43.620000000000005,4,2,2,8
1515915625599960387,27,1,397.48,4,1,4,9
1515915625599961213,27,1,187.78,4,1,3,8
1515915625599961274,26,5,433.91999999999996,4,4,4,12
1515915625599966050,27,1,51.63,4,1,2,7
1515915625599972230,25,2,1919.66,4,2,4,10
1515915625599972748,26,1,204.29,4,1,3,8
1515915625599974958,26,2,102.66,4,2,3,9
1515915625599979979,9,2,1740.3200000000002,4,2,4,10
1515915625599980479,7,3,878.49,4,3,4,11
1515915625600003504,26,1,19.52,4,1,1,6
1515915625600003577,26,1,36.79,4,1,2,7
1515915625600009618,26,1,45.24,4,1,2,7
1515915625600011219,26,1,65.08,4,1,2,7
1515915625600026320,26,1,11.48,4,1,1,6
1515915625600026910,26,1,32.38,4,1,2,7
1515915625600030441,8,2,405.34,4,2,4,10
1515915625600031161,17,3,1776.2400000000002,4,3,4,11
1515915625600036176,20,1,591.59,4,1,4,9
1515915625600036211,26,9,260.79,4,4,3,11
1515915625600042930,17,1,87.16,4,1,2,7
1515915625600043631,26,1,397.48,4,1,4,9
1515915625600044822,26,1,102.14,4,1,3,8
1515915625600046271,10,1,30.48,4,1,1,6
1515915625600047509,26,1,43.48,4,1,2,7
1515915625600048317,26,1,79.21,4,1,2,7
1515915625600048632,26,1,167.0,4,1,3,8
1515915625600049179,26,3,708.0,4,3,4,11
1515915625600050227,24,1,124.13,4,1,3,8
1515915625600053402,26,2,60.28,4,2,2,8
1515915625600059924,26,1,397.48,4,1,4,9
1515915625600065352,26,1,420.63,4,1,4,9
1515915625600067846,26,1,82.97,4,1,2,7
1515915625600069627,26,1,292.83,4,1,4,9
1515915625600071811,26,2,69.11,4,2,2,8
1515915625600073322,26,2,95.24,4,2,3,9
1515915625600073909,21,4,167.76,4,3,3,10
1515915625600079059,4,5,130.95000000000002,4,4,3,11
1515915625600083775,26,2,1031.12,4,2,4,10
1515915625600087302,26,1,34.44,4,1,2,7
1515915625600087450,26,4,1815.44,4,3,4,11
1515915625600091245,26,2,13.790000000000001,4,2,1,7
1515915625600092390,26,1,146.65,4,1,3,8
1515915625600096920,26,1,10.59,4,1,1,6
1515915625600097813,26,2,124.74,4,2,3,9
1515915625600102535,26,1,47.62,4,1,2,7
1515915625600106109,26,1,77.73,4,1,2,7
1515915625600106585,18,1,10.43,4,1,1,6
1515915625600109441,26,2,30.32,4,2,1,7
1515915625600109446,26,1,23.81,4,1,1,6
1515915625600110229,26,1,106.52,4,1,3,8
1515915625600112818,26,1,14.27,4,1,1,6
1515915625600115981,26,6,2877.06,4,4,4,12
1515915625600119325,26,1,115.56,4,1,3,8
1515915625600119406,26,1,16.98,4,1,1,6
1515915625600119430,26,1,257.87,4,1,3,8
1515915625600122671,26,1,466.52,4,1,4,9
1515915625600126089,25,1,23.17,4,1,1,6
1515915625600126272,26,1,102.7,4,1,3,8
1515915625600127371,26,1,32.22,4,1,1,6
1515915625600128281,26,1,7.83,4,1,1,6
1515915625600133384,26,1,14.86,4,1,1,6
1515915625600138146,26,1,9.35,4,1,1,6
1515915625600140651,17,8,1295.52,4,4,4,12
1515915625600149126,17,1,173.86,4,1,3,8
1515915625600154940,26,1,397.48,4,1,4,9
1515915625600156530,25,8,1962.4999999999998,4,4,4,12
1515915625600157918,26,1,40.03,4,1,2,7
1515915625600159095,23,2,130.16,4,2,3,9
1515915625600163639,25,5,69.3,4,4,2,10
1515915625600164908,25,2,47.94,4,2,2,8
1515915625600166906,26,1,26.98,4,1,1,6
1515915625600167391,26,1,23.62,4,1,1,6
1515915625600168539,26,2,552.74,4,2,4,10
1515915625600169120,26,1,28.1,4,1,1,6
1515915625600172197,26,1,20.16,4,1,1,6
1515915625600180426,26,1,32.22,4,1,1,6
1515915625600182467,26,2,846.99,4,2,4,10
1515915625600182630,26,1,26.98,4,1,1,6
1515915625600191285,26,2,39.04,4,2,2,8
1515915625600191820,26,5,1472.0500000000002,4,4,4,12
1515915625600193409,26,1,281.06,4,1,3,8
1515915625600199236,26,1,310.03,4,1,4,9
1515915625600200802,26,1,59.62,4,1,2,7
1515915625600210723,26,1,397.48,4,1,4,9
1515915625600213735,24,1,259.38,4,1,3,8
1515915625600214066,26,1,70.59,4,1,2,7
1515915625600215767,26,1,17.92,4,1,1,6
1515915625600216716,26,1,13.03,4,1,1,6
1515915625600236531,26,1,229.78,4,1,3,8
1515915625600236905,25,4,101.83,4,3,3,10
1515915625600239719,26,2,39.74,4,2,2,8
1515915625600243218,26,1,186.67,4,1,3,8
1515915625600253876,26,1,59.84,4,1,2,7
1515915625600271766,26,1,61.16,4,1,2,7
1515915625600272713,26,1,21.21,4,1,1,6
1515915625600276184,24,6,911.1600000000001,4,4,4,12
1515915625600277394,23,3,29.43,4,3,1,8
1515915625600279086,26,4,73.01,4,3,2,9
1515915625600280853,26,3,58.56,4,3,2,9
1515915625600281060,26,1,163.52,4,1,3,8
1515915625600294691,19,5,1332.98,4,4,4,12
1515915625600298731,26,1,32.19,4,1,1,6
1515915625600300077,26,2,62.22,4,2,2,8
1515915625600302818,26,1,26.98,4,1,1,6
1515915625600304235,26,1,140.86,4,1,3,8
1515915625600304396,26,1,32.22,4,1,1,6
1515915625600308955,26,1,292.83,4,1,4,9
1515915625600312652,24,4,128.88,4,3,3,10
1515915625600316539,26,4,362.52,4,3,4,11
1515915625600322962,26,1,897.79,4,1,4,9
1515915625600325027,26,2,100.66,4,2,3,9
1515915625600326190,26,1,58.1,4,1,2,7
1515915625600326443,26,1,187.78,4,1,3,8
1515915625600327915,26,1,284.46,4,1,3,8
1515915625600336165,26,1,71.02,4,1,2,7
1515915625600347127,26,1,20.48,4,1,1,6
1515915625600352401,26,1,204.29,4,1,3,8
1515915625600371072,4,2,880.0,4,2,4,10
1515915625600377750,25,1,15.4,4,1,1,6
1515915625600382664,25,1,284.46,4,1,3,8
1515915625600384606,25,1,415.54,4,1,4,9
1515915625600384745,25,2,752.98,4,2,4,10
1515915625600384906,20,5,63.5,4,4,2,10
1515915625600389460,25,1,214.1,4,1,3,8
1515915625600394550,25,3,62.849999999999994,4,3,2,9
1515915625600394740,25,1,149.05,4,1,3,8
1515915625600397882,25,1,35.71,4,1,2,7
1515915625600402859,25,2,374.58,4,2,4,10
1515915625600403092,25,1,167.62,4,1,3,8
1515915625600406938,25,1,22.86,4,1,1,6
1515915625600409800,25,1,23.65,4,1,1,6
1515915625600410903,25,1,284.46,4,1,3,8
1515915625600415624,19,1,307.43,4,1,4,9
1515915625600420653,25,6,966.3199999999999,4,4,4,12
1515915625600423319,25,1,21.75,4,1,1,6
1515915625600424722,25,1,218.62,4,1,3,8
1515915625600426606,25,1,24.95,4,1,1,6
1515915625600427029,14,3,1678.71,4,3,4,11
1515915625600427315,25,1,11.65,4,1,1,6
1515915625600428907,25,1,20.49,4,1,1,6
1515915625600443086,24,2,194.7,4,2,3,9
1515915625600443217,25,1,36.59,4,1,2,7
1515915625600443889,23,1,274.4,4,1,3,8
1515915625600447257,25,2,56.16,4,2,2,8
1515915625600447412,25,4,65.16,4,3,2,9
1515915625600451308,25,1,17.37,4,1,1,6
1515915625600451999,25,2,177.4,4,2,3,9
1515915625600463346,25,1,1.57,4,1,1,6
1515915625600463562,25,1,56.14,4,1,2,7
1515915625600463579,25,1,126.68,4,1,3,8
1515915625600465897,25,1,26.98,4,1,1,6
1515915625600468094,25,1,122.16,4,1,3,8
1515915625600468589,25,1,16.35,4,1,1,6
1515915625600471137,25,1,24.76,4,1,1,6
1515915625600472917,25,1,486.81,4,1,4,9
1515915625600473259,25,2,117.08,4,2,3,9
1515915625600474374,25,2,3.14,4,2,1,7
1515915625600475532,25,2,117.08,4,2,3,9
1515915625600478073,23,3,1246.6200000000001,4,3,4,11
1515915625600481993,25,1,499.54,4,1,4,9
1515915625600490883,24,2,268.65,4,2,3,9
1515915625600492180,25,1,600.6,4,1,4,9
1515915625600492973,25,1,31.41,4,1,1,6
1515915625600495928,25,1,31.41,4,1,1,6
1515915625600496757,25,1,32.22,4,1,1,6
1515915625600502231,25,1,144.51,4,1,3,8
1515915625600502340,25,2,155.46,4,2,3,9
1515915625600502512,11,1,105.87,4,1,3,8
1515915625600503213,25,1,13.65,4,1,1,6
1515915625600504754,13,1,1.57,4,1,1,6
1515915625600508301,25,2,162.28,4,2,3,9
1515915625600508580,24,1,609.6,4,1,4,9
1515915625600511518,25,1,108.14,4,1,3,8
1515915625600517719,25,3,211.77,4,3,3,10
1515915625600520993,25,1,201.33,4,1,3,8
1515915625600522917,25,2,402.66,4,2,4,10
1515915625600529175,25,2,90.2,4,2,2,8
1515915625600538872,25,4,43.19,4,3,2,9
1515915625600541076,25,1,187.29,4,1,3,8
1515915625600547505,25,1,292.83,4,1,4,9
1515915625600547892,25,1,18.3,4,1,1,6
1515915625600553120,25,1,10.0,4,1,1,6
1515915625600553956,25,1,397.48,4,1,4,9
1515915625600556355,25,1,29.22,4,1,1,6
1515915625600557828,25,2,57.62,4,2,2,8
1515915625600557940,25,1,622.84,4,1,4,9
1515915625600562237,25,2,181.04,4,2,3,9
1515915625600575627,25,1,22.08,4,1,1,6
1515915625600576086,25,5,2183.52,4,4,4,12
1515915625600577803,25,1,435.7,4,1,4,9
1515915625600577942,24,2,64.44,4,2,2,8
1515915625600578662,25,1,188.06,4,1,3,8
1515915625600579579,25,1,27.62,4,1,1,6
1515915625600585557,25,1,24.44,4,1,1,6
1515915625600586439,25,1,466.52,4,1,4,9
1515915625600587413,25,1,119.7,4,1,3,8
1515915625600587859,25,1,20.29,4,1,1,6
1515915625600589455,18,1,13.81,4,1,1,6
1515915625600589831,25,1,13.86,4,1,1,6
1515915625600593985,25,1,26.19,4,1,1,6
1515915625600594379,25,1,279.37,4,1,3,8
1515915625600597544,25,2,129.78,4,2,3,9
1515915625600599349,25,1,73.81,4,1,2,7
1515915625600601820,25,1,547.97,4,1,4,9
1515915625600603526,25,1,62.52,4,1,2,7
1515915625600604538,25,1,4.49,4,1,1,6
1515915625600612416,25,1,26.19,4,1,1,6
1515915625600613990,24,4,205.32,4,3,3,10
1515915625600614402,25,1,1.57,4,1,1,6
1515915625600618744,25,1,13.57,4,1,1,6
1515915625600618842,25,2,60.76,4,2,2,8
1515915625600619234,25,1,122.86,4,1,3,8
1515915625600622589,25,1,15.87,4,1,1,6
1515915625600623224,22,4,2193.48,4,3,4,11
1515915625600626619,25,1,226.84,4,1,3,8
1515915625600631231,25,1,215.06,4,1,3,8
1515915625600633286,25,1,59.84,4,1,2,7
1515915625600634718,25,1,80.35,4,1,2,7
1515915625600638860,25,1,292.83,4,1,4,9
1515915625600639122,24,5,1021.4499999999999,4,4,4,12
1515915625600642401,25,1,31.68,4,1,1,6
1515915625600648330,21,1,133.22,4,1,3,8
1515915625600657788,25,2,406.04,4,2,4,10
1515915625600659370,25,2,121.5,4,2,3,9
1515915625600660893,25,1,223.92,4,1,3,8
1515915625600661804,20,1,140.11,4,1,3,8
1515915625600662139,20,1,357.67,4,1,4,9
1515915625600663121,25,2,242.8,4,2,3,9
1515915625600664448,25,1,21.21,4,1,1,6
1515915625600664844,25,2,33.96,4,2,2,8
1515915625600666031,25,3,928.23,4,3,4,11
1515915625600670356,25,1,16.98,4,1,1,6
1515915625600676006,25,1,26.98,4,1,1,6
1515915625600677422,25,1,397.48,4,1,4,9
1515915625600682963,25,1,294.41,4,1,4,9
1515915625600697280,25,6,147.72,4,4,3,11
1515915625600697393,23,5,140.5,4,4,3,11
1515915625600697523,5,1,397.48,4,1,4,9
1515915625600703187,25,1,453.98,4,1,4,9
1515915625600706456,25,1,577.6,4,1,4,9
1515915625600706971,25,3,286.56,4,3,3,10
1515915625600707216,25,3,1811.83,4,3,4,11
1515915625600719949,16,1,46.98,4,1,2,7
1515915625600722125,25,1,64.48,4,1,2,7
1515915625600722540,23,1,148.37,4,1,3,8
1515915625600723220,25,19,8447.61,4,4,4,12
1515915625600724434,25,1,292.83,4,1,4,9
1515915625600728016,25,1,140.86,4,1,3,8
1515915625600728618,25,1,11.65,4,1,1,6
1515915625600731701,20,1,120.16,4,1,3,8
1515915625600734726,25,3,839.0999999999999,4,3,4,11
1515915625600737685,25,2,192.74,4,2,3,9
1515915625600738292,25,2,586.44,4,2,4,10
1515915625600740878,25,1,490.54,4,1,4,9
1515915625600741304,25,1,133.65,4,1,3,8
1515915625600741673,22,9,4493.1,4,4,4,12
1515915625600746927,18,2,498.76,4,2,4,10
1515915625600747323,25,1,11.98,4,1,1,6
1515915625600749906,24,2,147.62,4,2,3,9
1515915625600754889,24,2,124.34,4,2,3,9
1515915625600762910,20,1,251.4,4,1,3,8
1515915625600765224,21,1,397.48,4,1,4,9
1515915625600767551,24,1,15.08,4,1,1,6
1515915625600768870,24,1,249.38,4,1,3,8
1515915625600773124,24,1,126.68,4,1,3,8
1515915625600778792,24,1,490.54,4,1,4,9
1515915625600785523,24,1,30.16,4,1,1,6
1515915625600796426,24,1,9.35,4,1,1,6
1515915625600796896,24,1,88.52,4,1,2,7
1515915625600797704,24,1,77.78,4,1,2,7
1515915625600800212,24,2,152.82,4,2,3,9
1515915625600800376,24,1,449.51,4,1,4,9
1515915625600801207,23,1,1.57,4,1,1,6
1515915625600801640,24,3,878.49,4,3,4,11
1515915625600802846,24,1,2.86,4,1,1,6
1515915625600808894,24,1,38.83,4,1,2,7
1515915625600809857,24,1,34.56,4,1,2,7
1515915625600811771,24,2,48.66,4,2,2,8
1515915625600812028,24,1,24.33,4,1,1,6
1515915625600812404,24,1,23.33,4,1,1,6
1515915625600812424,17,2,69.2,4,2,2,8
1515915625600813342,24,1,210.68,4,1,3,8
1515915625600813420,24,2,184.64,4,2,3,9
1515915625600822995,24,1,314.38,4,1,4,9
1515915625600824210,24,3,632.04,4,3,4,11
1515915625600838875,23,2,62.059999999999995,4,2,2,8
1515915625600839653,17,1,33.33,4,1,2,7
1515915625600841040,24,3,1255.44,4,3,4,11
1515915625600848338,24,1,26.98,4,1,1,6
1515915625600849688,22,3,5401.049999999999,4,3,4,11
1515915625600851915,24,1,15.1,4,1,1,6
1515915625600853871,24,2,64.44,4,2,2,8
1515915625600855720,24,1,55.4,4,1,2,7
1515915625600858365,24,1,94.46,4,1,3,8
1515915625600861734,24,1,55.4,4,1,2,7
1515915625600862884,24,1,32.22,4,1,1,6
1515915625600868187,24,1,10.84,4,1,1,6
1515915625600868889,24,2,32.7,4,2,2,8
1515915625600870937,24,1,569.59,4,1,4,9
1515915625600878216,24,1,22.22,4,1,1,6
1515915625600880162,24,1,204.29,4,1,3,8
1515915625600880492,24,1,252.4,4,1,3,8
1515915625600882800,24,3,408.87,4,3,4,11
1515915625600884156,24,1,204.29,4,1,3,8
1515915625600884694,24,1,15.87,4,1,1,6
1515915625600884971,22,3,259.11,4,3,3,10
1515915625600885370,24,3,116.49,4,3,3,10
1515915625600887406,15,1,26.19,4,1,1,6
1515915625600888382,24,1,274.4,4,1,3,8
1515915625600888800,24,1,136.29,4,1,3,8
1515915625600889159,24,2,121.66,4,2,3,9
1515915625600890473,24,3,202.14,4,3,3,10
1515915625600895428,24,2,64.44,4,2,2,8
1515915625600900434,21,2,289.02,4,2,4,10
1515915625600900566,12,1,14.6,4,1,1,6
1515915625600901126,22,1,70.95,4,1,2,7
1515915625600902199,24,1,34.44,4,1,2,7
1515915625600902894,23,4,70.28,4,3,2,9
1515915625600902941,5,1,23.33,4,1,1,6
1515915625600904276,24,3,468.81000000000006,4,3,4,11
1515915625600909042,24,1,13.65,4,1,1,6
1515915625600909425,24,1,397.48,4,1,4,9
1515915625600916562,24,1,224.56,4,1,3,8
1515915625600916958,24,1,77.73,4,1,2,7
1515915625600917522,24,1,397.48,4,1,4,9
1515915625600917852,24,3,29.52,4,3,1,8
1515915625600919724,23,1,29.68,4,1,1,6
1515915625600922669,21,1,300.37,4,1,4,9
1515915625600922898,24,1,24.76,4,1,1,6
1515915625600923891,22,1,43.11,4,1,2,7
1515915625600931829,24,1,218.1,4,1,3,8
1515915625600932303,24,5,614.3,4,4,4,12
1515915625600933769,24,1,397.48,4,1,4,9
1515915625600938615,24,3,40.47,4,3,2,9
1515915625600941441,24,2,794.96,4,2,4,10
1515915625600945495,19,3,27.42,4,3,1,8
1515915625600953447,24,1,292.83,4,1,4,9
1515915625600955345,24,1,10.84,4,1,1,6
1515915625600956827,24,1,67.02,4,1,2,7
1515915625600958257,24,2,46.96,4,2,2,8
1515915625600962038,21,1,33.19,4,1,2,7
1515915625600963020,24,1,23.33,4,1,1,6
1515915625600965658,24,1,140.86,4,1,3,8
1515915625600969966,24,1,397.48,4,1,4,9
1515915625600972389,24,1,399.46,4,1,4,9
1515915625600975402,24,1,203.02,4,1,3,8
1515915625600980254,22,1,154.06,4,1,3,8
1515915625600990209,18,4,3839.32,4,3,4,11
1515915625600991197,24,1,510.54,4,1,4,9
1515915625600992236,24,2,1021.08,4,2,4,10
1515915625601000354,24,2,38.74,4,2,2,8
1515915625601000631,24,1,21.75,4,1,1,6
1515915625601004289,24,1,21.75,4,1,1,6
1515915625601005548,24,1,14.92,4,1,1,6
1515915625601006735,24,2,214.32,4,2,3,9
1515915625601009671,20,4,149.84,4,3,3,10
1515915625601013239,24,1,397.48,4,1,4,9
1515915625601018942,24,1,415.54,4,1,4,9
1515915625601035367,23,2,26.04,4,2,1,7
1515915625601035826,24,2,160.06,4,2,3,9
1515915625601037348,24,3,1558.6799999999998,4,3,4,11
1515915625601039540,24,2,42.42,4,2,2,8
1515915625601040719,24,1,577.6,4,1,4,9
1515915625601042533,23,1,187.29,4,1,3,8
1515915625601044616,6,1,48.27,4,1,2,7
1515915625601045960,24,1,75.76,4,1,2,7
1515915625601054289,24,1,170.0,4,1,3,8
1515915625601058777,24,2,64.44,4,2,2,8
1515915625601061379,24,2,121.66,4,2,3,9
1515915625601071663,24,1,211.79,4,1,3,8
1515915625601077113,24,1,21.6,4,1,1,6
1515915625601077403,24,1,15.08,4,1,1,6
1515915625601079483,24,4,323.64,4,3,4,11
1515915625601079916,24,2,408.58,4,2,4,10
1515915625601086465,24,1,48.73,4,1,2,7
1515915625601091928,24,1,30.54,4,1,1,6
1515915625601092869,24,1,202.67,4,1,3,8
1515915625601093605,23,1,35.87,4,1,2,7
1515915625601094953,23,1,27.62,4,1,1,6
1515915625601096596,24,2,1186.3000000000002,4,2,4,10
1515915625601100923,23,4,1144.1,4,3,4,11
1515915625601102210,23,1,12.35,4,1,1,6
1515915625601107521,23,3,687.82,4,3,4,11
1515915625601108023,23,1,11.13,4,1,1,6
1515915625601112964,22,2,587.24,4,2,4,10
1515915625601118924,23,1,32.22,4,1,1,6
1515915625601119129,23,1,202.67,4,1,3,8
1515915625601124334,23,2,502.8,4,2,4,10
1515915625601126305,11,4,213.37,4,3,3,10
1515915625601132308,23,2,34.26,4,2,2,8
1515915625601133855,10,1,212.7,4,1,3,8
1515915625601134945,23,1,35.25,4,1,2,7
1515915625601138604,23,1,448.51,4,1,4,9
1515915625601143939,23,1,16.19,4,1,1,6
1515915625601144003,23,2,502.8,4,2,4,10
1515915625601144285,23,1,8.79,4,1,1,6
1515915625601145655,23,4,120.0,4,3,3,10
1515915625601146295,23,3,1087.79,4,3,4,11
1515915625601147968,23,1,203.02,4,1,3,8
1515915625601148512,23,4,1682.52,4,3,4,11
1515915625601148874,23,1,63.98,4,1,2,7
1515915625601152534,15,1,397.48,4,1,4,9
1515915625601152610,5,1,397.48,4,1,4,9
1515915625601155288,23,1,587.6,4,1,4,9
1515915625601155731,16,2,428.2,4,2,4,10
1515915625601156071,23,1,587.6,4,1,4,9
1515915625601158306,23,1,9.35,4,1,1,6
1515915625601158656,23,1,250.38,4,1,3,8
1515915625601165437,23,1,292.83,4,1,4,9
1515915625601165864,23,1,466.52,4,1,4,9
1515915625601165991,23,1,292.83,4,1,4,9
1515915625601168152,23,1,18.89,4,1,1,6
1515915625601168843,23,3,13.71,4,3,1,8
1515915625601170140,15,2,568.92,4,2,4,10
1515915625601170469,23,6,2253.21,4,4,4,12
1515915625601170963,22,2,859.0,4,2,4,10
1515915625601172197,23,1,349.46,4,1,4,9
1515915625601178201,23,2,401.39,4,2,4,10
1515915625601181134,23,2,533.78,4,2,4,10
1515915625601185533,23,1,127.94,4,1,3,8
1515915625601185933,21,1,23.89,4,1,1,6
1515915625601186227,23,1,15.43,4,1,1,6
1515915625601192425,12,2,35.400000000000006,4,2,2,8
1515915625601198052,23,1,32.22,4,1,1,6
1515915625601200061,23,5,639.68,4,4,4,12
1515915625601201110,23,1,12.84,4,1,1,6
1515915625601209606,23,1,10.43,4,1,1,6
1515915625601209801,23,2,798.96,4,2,4,10
1515915625601210137,23,1,399.48,4,1,4,9
1515915625601215001,23,1,40.48,4,1,2,7
1515915625601216003,23,1,88.41,4,1,2,7
1515915625601221289,23,3,99.24,4,3,3,10
1515915625601222258,23,2,165.94,4,2,3,9
1515915625601222348,23,3,14.580000000000002,4,3,1,8
1515915625601229444,23,1,214.1,4,1,3,8
1515915625601231728,23,1,21.21,4,1,1,6
1515915625601234175,22,3,308.74,4,3,4,11
1515915625601242024,23,1,39.68,4,1,2,7
1515915625601243257,23,1,78.3,4,1,2,7
1515915625601251809,23,1,83.49,4,1,2,7
1515915625601252927,8,5,673.8,4,4,4,12
1515915625601253588,23,1,448.51,4,1,4,9
1515915625601255020,23,1,29.52,4,1,1,6
1515915625601256328,23,1,16.16,4,1,1,6
1515915625601257549,23,1,219.97,4,1,3,8
1515915625601263527,20,2,379.46000000000004,4,2,4,10
1515915625601266009,23,1,29.22,4,1,1,6
1515915625601270098,23,1,15.87,4,1,1,6
1515915625601272031,22,1,151.29,4,1,3,8
1515915625601272633,20,1,39.75,4,1,2,7
1515915625601275798,23,1,14.29,4,1,1,6
1515915625601276064,23,2,1100.54,4,2,4,10
1515915625601281128,23,1,23.17,4,1,1,6
1515915625601282533,23,1,470.87,4,1,4,9
1515915625601283264,23,1,11.13,4,1,1,6
1515915625601283832,23,3,218.94,4,3,3,10
1515915625601288414,23,1,204.79,4,1,3,8
1515915625601293618,23,2,20.86,4,2,1,7
1515915625601300823,22,2,518.76,4,2,4,10
1515915625601304304,21,4,1338.01,4,3,4,11
1515915625601305195,23,1,30.16,4,1,1,6
1515915625601328519,23,2,332.04,4,2,4,10
1515915625601333089,20,3,397.11,4,3,4,11
1515915625601333840,22,2,397.24,4,2,4,10
1515915625601341439,3,2,70.16,4,2,2,8
1515915625601353534,23,1,486.81,4,1,4,9
1515915625601363473,23,1,9.35,4,1,1,6
1515915625601369180,23,1,12.56,4,1,1,6
1515915625601378082,22,1,51.59,4,1,2,7
1515915625601380554,23,1,292.83,4,1,4,9
1515915625601387902,23,2,75.96,4,2,2,8
1515915625601389013,23,1,43.11,4,1,2,7
1515915625601397364,23,3,87.66,4,3,2,9
1515915625601397871,23,1,21.11,4,1,1,6
1515915625601398085,23,1,292.83,4,1,4,9
1515915625601415374,23,1,14.6,4,1,1,6
1515915625601415669,23,1,9.35,4,1,1,6
1515915625601417730,23,1,339.16,4,1,4,9
1515915625601423100,19,1,102.46,4,1,3,8
1515915625601423415,23,1,292.83,4,1,4,9
1515915625601429612,17,2,424.78,4,2,4,10
1515915625601439475,23,1,16.19,4,1,1,6
1515915625601459561,23,1,121.19,4,1,3,8
1515915625601461610,23,3,1582.69,4,3,4,11
1515915625601462318,23,1,492.52,4,1,4,9
1515915625601473425,23,4,228.35000000000002,4,3,3,10
1515915625601474855,23,1,624.62,4,1,4,9
1515915625601475050,23,2,1047.12,4,2,4,10
1515915625601475233,23,1,523.56,4,1,4,9
1515915625601475967,21,2,21.24,4,2,1,7
1515915625601476796,23,1,82.97,4,1,2,7
1515915625601477363,23,1,33.97,4,1,2,7
1515915625601477830,23,1,64.48,4,1,2,7
1515915625601479530,5,1,40.02,4,1,2,7
1515915625601479807,23,1,35.87,4,1,2,7
1515915625601486526,7,1,519.56,4,1,4,9
1515915625601487557,22,5,477.78,4,4,4,12
1515915625601488948,23,2,30.85,4,2,1,7
1515915625601490287,23,3,1063.77,4,3,4,11
1515915625601491751,23,2,89.4,4,2,2,8
1515915625601493918,23,3,208.62,4,3,3,10
1515915625601494310,23,1,36.14,4,1,2,7
1515915625601495490,23,1,486.81,4,1,4,9
1515915625601496362,23,2,1219.2,4,2,4,10
1515915625601497804,22,1,19.33,4,1,1,6
1515915625601497833,23,1,577.6,4,1,4,9
1515915625601498808,23,1,22.08,4,1,1,6
1515915625601512187,23,1,6.43,4,1,1,6
1515915625601513467,23,1,274.4,4,1,3,8
1515915625601518921,23,1,397.48,4,1,4,9
1515915625601536261,23,1,39.84,4,1,2,7
1515915625601554959,16,2,296.74,4,2,4,10
1515915625601570692,16,1,265.05,4,1,3,8
1515915625601579158,22,56,12080.83,4,4,4,12
1515915625601581929,23,2,45.4,4,2,2,8
1515915625601595629,23,2,559.4,4,2,4,10
1515915625601595836,9,2,144.58,4,2,3,9
1515915625601596708,19,1,55.6,4,1,2,7
1515915625601599114,17,4,1914.09,4,3,4,11
1515915625601602834,22,1,309.24,4,1,4,9
1515915625601610959,22,2,1178.2,4,2,4,10
1515915625601616205,22,2,76.0,4,2,2,8
1515915625601619847,22,1,15.92,4,1,1,6
1515915625601625349,22,2,43.8,4,2,2,8
1515915625601627629,22,3,490.56000000000006,4,3,4,11
1515915625601629577,22,1,257.7,4,1,3,8
1515915625601632285,22,3,681.5799999999999,4,3,4,11
1515915625601635135,22,1,38.0,4,1,2,7
1515915625601637505,9,3,1574.67,4,3,4,11
1515915625601639209,22,1,14.6,4,1,1,6
1515915625601644947,22,2,69.3,4,2,2,8
1515915625601645176,22,1,10.63,4,1,1,6
1515915625601646459,22,1,32.25,4,1,2,7
1515915625601646539,22,1,397.48,4,1,4,9
1515915625601651323,22,1,60.33,4,1,2,7
1515915625601651524,22,2,120.66,4,2,3,9
1515915625601651992,22,2,67.94,4,2,2,8
1515915625601657435,22,1,9.59,4,1,1,6
1515915625601658652,22,1,214.1,4,1,3,8
1515915625601659955,22,1,29.22,4,1,1,6
1515915625601661206,22,1,349.46,4,1,4,9
1515915625601661585,22,1,349.46,4,1,4,9
1515915625601661962,22,3,63.63,4,3,2,9
1515915625601662357,22,7,1870.81,4,4,4,12
1515915625601672362,22,1,34.44,4,1,2,7
1515915625601683465,22,1,18.73,4,1,1,6
1515915625601684947,22,1,134.76,4,1,3,8
1515915625601686137,22,3,404.28,4,3,4,11
1515915625601709201,22,1,569.59,4,1,4,9
1515915625601710556,20,4,58.28,4,3,2,9
1515915625601710901,22,2,157.78,4,2,3,9
1515915625601712663,22,1,170.9,4,1,3,8
1515915625601713393,22,1,31.25,4,1,1,6
1515915625601713771,22,1,40.19,4,1,2,7
1515915625601714017,22,1,187.29,4,1,3,8
1515915625601714925,22,1,13.86,4,1,1,6
1515915625601720990,22,1,52.94,4,1,2,7
1515915625601726924,20,1,292.83,4,1,4,9
1515915625601730175,22,2,3.14,4,2,1,7
1515915625601731723,20,3,614.37,4,3,4,11
1515915625601734445,22,1,43.25,4,1,2,7
1515915625601744593,22,3,1388.56,4,3,4,11
1515915625601746755,22,1,21.21,4,1,1,6
1515915625601748045,4,2,97.01,4,2,3,9
1515915625601748346,22,1,19.52,4,1,1,6
1515915625601752668,22,1,1.57,4,1,1,6
1515915625601754104,22,2,80.88,4,2,2,8
1515915625601760170,22,1,486.81,4,1,4,9
1515915625601762821,22,3,571.38,4,3,4,11
1515915625601766889,22,1,49.1,4,1,2,7
1515915625601772414,14,4,144.56,4,3,3,10
1515915625601832303,22,1,257.87,4,1,3,8
1515915625601883477,22,1,265.05,4,1,3,8
1515915625601924280,22,1,21.59,4,1,1,6
1515915625602041833,22,1,75.67,4,1,2,7
1515915625602097835,22,1,10.16,4,1,1,6
1515915625602105487,22,1,18.19,4,1,1,6
1515915625602139309,22,1,292.83,4,1,4,9
1515915625602349448,22,1,479.51,4,1,4,9
1515915625602410226,22,4,230.48,4,3,3,10
1515915625602464904,22,2,156.28,4,2,3,9
1515915625602500510,22,1,18.41,4,1,1,6
1515915625602524963,22,1,43.11,4,1,2,7
1515915625602532323,22,1,23.33,4,1,1,6
1515915625602534297,22,2,253.36,4,2,3,9
1515915625602547778,18,4,1171.32,4,3,4,11
1515915625602553543,22,1,80.35,4,1,2,7
1515915625602557297,22,2,173.12,4,2,3,9
1515915625602559455,22,2,58.44,4,2,2,8
1515915625602560084,22,1,149.7,4,1,3,8
1515915625602560993,22,1,102.54,4,1,3,8
1515915625602563791,22,2,127.96,4,2,3,9
1515915625602572474,22,1,10.84,4,1,1,6
1515915625602576363,22,1,37.46,4,1,2,7
1515915625602576618,22,1,202.95,4,1,3,8
1515915625602577507,22,1,11.11,4,1,1,6
1515915625602577654,22,2,794.96,4,2,4,10
1515915625602582247,22,1,27.62,4,1,1,6
1515915625602589114,22,1,15.24,4,1,1,6
1515915625602590978,22,1,51.33,4,1,2,7
1515915625602592781,22,4,532.12,4,3,4,11
1515915625602593122,22,1,28.1,4,1,1,6
1515915625602598243,22,2,150.58,4,2,3,9
1515915625602622162,22,1,600.6,4,1,4,9
1515915625602625539,20,1,20.73,4,1,1,6
1515915625602627553,22,2,42.42,4,2,2,8
1515915625602628455,22,1,397.48,4,1,4,9
1515915625602632681,22,1,214.1,4,1,3,8
1515915625602632814,21,1,143.59,4,1,3,8
1515915625602637649,10,1,18.19,4,1,1,6
1515915625602639420,21,2,227.3,4,2,3,9
1515915625602640122,3,1,42.51,4,1,2,7
1515915625602642004,22,1,486.81,4,1,4,9
1515915625602642800,22,1,50.11,4,1,2,7
1515915625602643967,22,3,1330.52,4,3,4,11
1515915625602653990,21,1,80.03,4,1,2,7
1515915625602658908,22,2,449.52,4,2,4,10
1515915625602661115,22,1,218.98,4,1,3,8
1515915625602663824,21,1,82.97,4,1,2,7
1515915625602664096,18,1,446.51,4,1,4,9
1515915625602666107,22,1,38.83,4,1,2,7
1515915625602668111,19,2,154.8,4,2,3,9
1515915625602668996,22,1,155.1,4,1,3,8
1515915625602670765,22,1,20.32,4,1,1,6
1515915625602677869,13,1,29.4,4,1,1,6
1515915625602683709,17,2,611.58,4,2,4,10
1515915625602683813,22,1,17.57,4,1,1,6
1515915625602683988,22,6,2378.02,4,4,4,12
1515915625602686131,22,1,32.22,4,1,1,6
1515915625602686821,22,1,70.17,4,1,2,7
1515915625602688280,22,1,38.83,4,1,2,7
1515915625602696198,22,1,26.19,4,1,1,6
1515915625602700235,22,2,770.94,4,2,4,10
1515915625602700290,3,1,397.48,4,1,4,9
1515915625602701873,22,1,1.57,4,1,1,6
1515915625602706176,22,1,1.57,4,1,1,6
1515915625602706273,22,1,60.83,4,1,2,7
1515915625602716298,22,1,515.56,4,1,4,9
1515915625602716469,22,2,794.96,4,2,4,10
1515915625602716811,22,1,397.48,4,1,4,9
1515915625602718391,20,1,40.79,4,1,2,7
1515915625602719066,22,1,29.22,4,1,1,6
1515915625602721694,21,7,1418.27,4,4,4,12
1515915625602722968,22,1,609.6,4,1,4,9
1515915625602729904,22,1,397.48,4,1,4,9
1515915625602732040,20,2,68.86,4,2,2,8
1515915625602734550,21,3,1087.79,4,3,4,11
1515915625602736260,21,1,600.6,4,1,4,9
1515915625602736433,21,3,846.62,4,3,4,11
1515915625602736969,21,2,965.04,4,2,4,10
1515915625602747943,21,1,68.57,4,1,2,7
1515915625602749680,12,2,25.520000000000003,4,2,1,7
1515915625602756578,21,1,466.52,4,1,4,9
1515915625602758294,8,2,101.26,4,2,3,9
1515915625602760478,21,1,29.22,4,1,1,6
1515915625602760920,21,2,85.36,4,2,2,8
1515915625602763526,21,1,32.4,4,1,2,7
1515915625602765293,21,1,12.46,4,1,1,6
1515915625602767436,20,1,294.41,4,1,4,9
1515915625602769158,21,1,603.62,4,1,4,9
1515915625602770123,20,4,419.44,4,3,4,11
1515915625602773586,21,1,214.1,4,1,3,8
1515915625602773715,21,19,5705.96,4,4,4,12
1515915625602773805,21,2,34.44,4,2,2,8
1515915625602774514,21,1,60.83,4,1,2,7
1515915625602780158,21,1,52.05,4,1,2,7
1515915625602781647,21,1,38.83,4,1,2,7
1515915625602783610,21,3,878.49,4,3,4,11
1515915625602788254,21,2,481.70000000000005,4,2,4,10
1515915625602789707,21,2,690.31,4,2,4,10
1515915625602791730,21,1,44.03,4,1,2,7
1515915625602797915,21,1,34.44,4,1,2,7
1515915625602798661,11,1,103.83,4,1,3,8
1515915625602799671,21,1,32.22,4,1,1,6
1515915625602802947,21,2,112.54,4,2,3,9
1515915625602804002,21,1,82.97,4,1,2,7
1515915625602804584,21,1,116.49,4,1,3,8
1515915625602807899,21,1,38.83,4,1,2,7
1515915625602808757,21,3,317.61,4,3,4,11
1515915625602810209,21,1,373.46,4,1,4,9
1515915625602814107,21,1,64.48,4,1,2,7
1515915625602818480,21,2,49.84,4,2,2,8
1515915625602819376,21,1,249.38,4,1,3,8
1515915625602824033,21,3,31.44,4,3,1,8
1515915625602829379,19,3,185.57999999999998,4,3,3,10
1515915625602835589,21,2,60.59,4,2,2,8
1515915625602835911,20,2,328.66,4,2,4,10
1515915625602836066,21,1,171.9,4,1,3,8
1515915625602840548,3,1,52.83,4,1,2,7
1515915625602841870,21,1,12.41,4,1,1,6
1515915625602843297,21,1,481.54,4,1,4,9
1515915625602844087,21,1,429.51,4,1,4,9
1515915625602847071,21,1,274.4,4,1,3,8
1515915625602847889,21,1,61.29,4,1,2,7
1515915625602848425,3,2,803.5,4,2,4,10
1515915625602849301,21,2,587.24,4,2,4,10
1515915625602851636,14,1,167.9,4,1,3,8
1515915625602852800,21,1,13.81,4,1,1,6
1515915625602858100,20,1,17.78,4,1,1,6
1515915625602860240,19,2,70.5,4,2,2,8
1515915625602871499,21,1,58.25,4,1,2,7
1515915625602873109,21,1,46.98,4,1,2,7
1515915625602873963,21,1,292.83,4,1,4,9
1515915625602881060,21,1,38.83,4,1,2,7
1515915625602881300,13,4,2400.3900000000003,4,3,4,11
1515915625602882488,21,1,18.7,4,1,1,6
1515915625602885387,21,1,656.63,4,1,4,9
1515915625602886424,20,1,27.89,4,1,1,6
1515915625602889166,21,1,43.65,4,1,2,7
1515915625602897425,21,1,90.63,4,1,2,7
1515915625602900672,21,1,111.6,4,1,3,8
1515915625602900673,21,1,397.48,4,1,4,9
1515915625602901275,21,1,17.46,4,1,1,6
1515915625602905543,21,1,177.95,4,1,3,8
1515915625602908815,21,2,67.3,4,2,2,8
1515915625602909643,21,3,1101.69,4,3,4,11
1515915625602910188,21,1,79.68,4,1,2,7
1515915625602914722,21,1,83.49,4,1,2,7
1515915625602914873,21,2,506.92999999999995,4,2,4,10
1515915625602917954,21,1,486.81,4,1,4,9
1515915625602919015,19,1,203.29,4,1,3,8
1515915625602919838,21,1,115.0,4,1,3,8
1515915625602920668,21,1,21.59,4,1,1,6
1515915625602921831,21,1,250.3,4,1,3,8
1515915625602926361,21,1,470.87,4,1,4,9
1515915625602927095,21,1,397.48,4,1,4,9
1515915625602928604,21,1,294.41,4,1,4,9
1515915625602929021,21,1,249.02,4,1,3,8
1515915625602932269,20,4,1045.76,4,3,4,11
1515915625602934914,21,1,42.98,4,1,2,7
1515915625602939309,21,1,292.83,4,1,4,9
1515915625602941090,20,3,82.86,4,3,2,9
1515915625602941472,21,1,57.62,4,1,2,7
1515915625602949860,21,1,10.16,4,1,1,6
1515915625602950601,21,1,63.49,4,1,2,7
1515915625602950926,21,1,180.71,4,1,3,8
1515915625602966234,18,1,19.52,4,1,1,6
1515915625602968925,21,3,289.11,4,3,4,11
1515915625602972456,21,1,17.22,4,1,1,6
1515915625602973687,21,2,128.96,4,2,3,9
1515915625602985268,21,1,95.52,4,1,3,8
1515915625602989317,21,1,10.95,4,1,1,6
1515915625602990549,21,3,855.39,4,3,4,11
1515915625602990960,17,6,711.42,4,4,4,12
1515915625602993879,21,1,38.83,4,1,2,7
1515915625602998281,21,1,453.86,4,1,4,9
1515915625602999281,19,1,15.08,4,1,1,6
1515915625603003016,11,1,77.73,4,1,2,7
1515915625603006320,21,1,38.83,4,1,2,7
1515915625603007352,21,3,35.58,4,3,2,9
1515915625603008421,7,4,155.32,4,3,3,10
1515915625603012654,21,1,10.89,4,1,1,6
1515915625603014592,19,3,2219.07,4,3,4,11
1515915625603015300,21,1,70.6,4,1,2,7
1515915625603015558,21,3,470.18999999999994,4,3,4,11
1515915625603016989,21,1,147.3,4,1,3,8
1515915625603019356,20,1,77.73,4,1,2,7
1515915625603019396,15,1,15.08,4,1,1,6
1515915625603019508,21,2,93.34,4,2,3,9
1515915625603022283,21,1,35.92,4,1,2,7
1515915625603022296,21,1,490.54,4,1,4,9
1515915625603028725,21,2,94.28,4,2,3,9
1515915625603029577,21,1,292.83,4,1,4,9
1515915625603030207,21,2,44.58,4,2,2,8
1515915625603033762,21,4,1005.6,4,3,4,11
1515915625603035598,21,1,486.81,4,1,4,9
1515915625603037575,4,1,600.6,4,1,4,9
1515915625603042215,21,1,268.11,4,1,3,8
1515915625603051572,21,1,9.83,4,1,1,6
1515915625603051966,21,3,30.299999999999997,4,3,1,8
1515915625603054284,21,3,45.24,4,3,2,9
1515915625603056243,21,1,202.67,4,1,3,8
1515915625603058070,21,2,185.72,4,2,3,9
1515915625603058848,21,1,32.46,4,1,2,7
1515915625603058850,7,1,229.38,4,1,3,8
1515915625603063226,21,2,52.38,4,2,2,8
1515915625603065540,21,1,202.67,4,1,3,8
1515915625603069681,19,5,140.5,4,4,3,11
1515915625603070128,21,2,20.86,4,2,1,7
1515915625603073294,20,1,373.46,4,1,4,9
1515915625603073833,21,4,39.36,4,3,2,9
1515915625603077848,21,1,879.78,4,1,4,9
1515915625603078824,20,1,29.22,4,1,1,6
1515915625603079627,21,1,163.52,4,1,3,8
1515915625603081428,13,1,124.73,4,1,3,8
1515915625603081792,20,1,600.6,4,1,4,9
1515915625603091154,21,1,577.6,4,1,4,9
1515915625603091463,21,11,2363.5,4,4,4,12
1515915625603093974,21,1,102.11,4,1,3,8
1515915625603095292,21,3,1198.44,4,3,4,11
1515915625603096746,21,1,10.48,4,1,1,6
1515915625603097902,21,1,64.92,4,1,2,7
1515915625603100091,21,1,609.6,4,1,4,9
1515915625603101479,20,3,116.49,4,3,3,10
1515915625603104211,21,1,314.68,4,1,4,9
1515915625603110764,21,1,13.86,4,1,1,6
1515915625603111376,21,1,397.48,4,1,4,9
1515915625603111753,20,1,205.25,4,1,3,8
1515915625603113992,11,28,3484.43,4,4,4,12
1515915625603129718,20,1,421.06,4,1,4,9
1515915625603130737,20,8,186.28,4,4,3,11
1515915625603132276,20,3,103.32,4,3,3,10
1515915625603137176,20,1,10.13,4,1,1,6
1515915625603137220,20,1,449.51,4,1,4,9
1515915625603141960,20,2,87.3,4,2,2,8
1515915625603143175,20,6,56.099999999999994,4,4,2,10
1515915625603145970,20,1,205.49,4,1,3,8
1515915625603149862,19,3,883.23,4,3,4,11
1515915625603151816,20,2,222.0,4,2,3,9
1515915625603153253,10,1,17.92,4,1,1,6
1515915625603159546,20,1,466.52,4,1,4,9
1515915625603162237,20,1,1.57,4,1,1,6
1515915625603165350,20,1,449.51,4,1,4,9
1515915625603165458,20,2,44.82,4,2,2,8
1515915625603170471,20,1,50.63,4,1,2,7
1515915625603170749,20,1,39.35,4,1,2,7
1515915625603174432,20,1,490.54,4,1,4,9
1515915625603175066,20,3,48.33,4,3,2,9
1515915625603180074,20,6,1107.3200000000002,4,4,4,12
1515915625603180969,20,4,856.4,4,3,4,11
1515915625603181323,20,1,9.81,4,1,1,6
1515915625603182215,20,3,174.81,4,3,3,10
1515915625603183956,20,1,332.87,4,1,4,9
1515915625603187233,20,2,72.28,4,2,2,8
1515915625603188550,20,1,21.21,4,1,1,6
1515915625603188834,19,1,26.17,4,1,1,6
1515915625603190451,20,4,69.0,4,3,2,9
1515915625603195435,20,3,20.009999999999998,4,3,1,8
1515915625603202442,20,1,38.83,4,1,2,7
1515915625603202767,18,2,250.8,4,2,3,9
1515915625603202871,20,1,287.94,4,1,4,9
1515915625603203910,20,1,38.83,4,1,2,7
1515915625603207402,20,1,399.48,4,1,4,9
1515915625603208469,20,1,274.4,4,1,3,8
1515915625603211518,20,1,36.14,4,1,2,7
1515915625603212851,20,2,314.35,4,2,4,10
1515915625603215810,20,1,19.19,4,1,1,6
1515915625603227217,20,1,139.52,4,1,3,8
1515915625603238956,20,1,13.86,4,1,1,6
1515915625603241823,20,4,63.48,4,3,2,9
1515915625603242648,17,1,77.73,4,1,2,7
1515915625603242935,20,1,151.29,4,1,3,8
1515915625603243302,20,4,117.71,4,3,3,10
1515915625603246898,20,4,72.4,4,3,2,9
1515915625603249285,20,1,322.57,4,1,4,9
1515915625603249591,20,1,26.19,4,1,1,6
1515915625603254413,20,1,187.29,4,1,3,8
1515915625603255203,20,3,41.58,4,3,2,9
1515915625603256271,20,2,85.96,4,2,2,8
1515915625603261831,20,2,102.66,4,2,3,9
1515915625603263117,20,1,51.33,4,1,2,7
1515915625603263630,20,1,9.35,4,1,1,6
1515915625603263760,20,2,60.96,4,2,2,8
1515915625603264109,20,1,18.57,4,1,1,6
1515915625603267008,17,1,499.54,4,1,4,9
1515915625603270297,20,2,1201.2,4,2,4,10
1515915625603271780,20,3,422.58000000000004,4,3,4,11
1515915625603273611,20,3,1345.53,4,3,4,11
1515915625603277364,20,1,46.67,4,1,2,7
1515915625603279743,20,1,159.14,4,1,3,8
1515915625603279900,20,2,585.66,4,2,4,10
1515915625603282107,13,1,32.25,4,1,2,7
1515915625603282482,20,1,26.19,4,1,1,6
1515915625603282774,1,1,32.22,4,1,1,6
1515915625603287577,13,6,342.78000000000003,4,4,4,12
1515915625603288252,20,1,62.7,4,1,2,7
1515915625603289934,17,1,55.6,4,1,2,7
1515915625603291607,20,1,51.33,4,1,2,7
1515915625603292021,19,1,29.62,4,1,1,6
1515915625603292817,10,3,763.14,4,3,4,11
1515915625603293090,20,1,27.03,4,1,1,6
1515915625603293711,20,4,187.8,4,3,3,10
1515915625603296384,20,1,29.7,4,1,1,6
1515915625603300797,20,1,38.83,4,1,2,7
1515915625603303539,17,2,548.8,4,2,4,10
1515915625603308870,19,1,292.83,4,1,4,9
1515915625603311956,20,3,89.12,4,3,2,9
1515915625603313098,20,1,35.71,4,1,2,7
1515915625603318312,20,1,118.57,4,1,3,8
1515915625603318688,20,1,79.21,4,1,2,7
1515915625603319605,20,2,794.96,4,2,4,10
1515915625603321357,20,2,18.7,4,2,1,7
1515915625603326495,20,2,459.56,4,2,4,10
1515915625603327435,20,1,62.1,4,1,2,7
1515915625603329725,19,2,38.54,4,2,2,8
1515915625603329959,20,2,100.66,4,2,3,9
1515915625603330722,11,8,1821.04,4,4,4,12
1515915625603332539,20,1,229.38,4,1,3,8
1515915625603337591,20,1,214.1,4,1,3,8
1515915625603337999,19,1,251.4,4,1,3,8
1515915625603340826,20,2,698.92,4,2,4,10
1515915625603343218,18,4,980.8599999999999,4,3,4,11
1515915625603344581,20,1,27.62,4,1,1,6
1515915625603345428,20,1,253.38,4,1,3,8
1515915625603350666,20,1,17.0,4,1,1,6
1515915625603354173,20,2,981.08,4,2,4,10
1515915625603354204,20,3,1099.3700000000001,4,3,4,11
1515915625603355374,20,3,45.3,4,3,2,9
1515915625603359223,20,1,140.19,4,1,3,8
1515915625603359887,20,1,27.62,4,1,1,6
1515915625603364133,20,1,839.75,4,1,4,9
1515915625603364609,20,1,397.48,4,1,4,9
1515915625603367600,20,1,466.52,4,1,4,9
1515915625603368539,20,2,66.16,4,2,2,8
1515915625603368926,20,1,292.83,4,1,4,9
1515915625603369742,13,2,1079.12,4,2,4,10
1515915625603371028,20,1,16.83,4,1,1,6
1515915625603372364,20,1,173.86,4,1,3,8
1515915625603372760,20,1,492.52,4,1,4,9
1515915625603373003,20,1,22.22,4,1,1,6
1515915625603374178,20,3,41.58,4,3,2,9
1515915625603379552,20,2,981.08,4,2,4,10
1515915625603388900,20,1,21.75,4,1,1,6
1515915625603389582,20,2,794.96,4,2,4,10
1515915625603390842,20,1,32.41,4,1,2,7
1515915625603393384,20,1,21.21,4,1,1,6
1515915625603393596,20,1,466.52,4,1,4,9
1515915625603394248,20,1,397.48,4,1,4,9
1515915625603396319,19,4,95.24,4,3,3,10
1515915625603397824,17,1,202.38,4,1,3,8
1515915625603403541,19,1,105.87,4,1,3,8
1515915625603403650,20,1,82.97,4,1,2,7
1515915625603405801,3,1,201.94,4,1,3,8
1515915625603409961,20,2,1136.1399999999999,4,2,4,10
1515915625603417088,20,1,66.98,4,1,2,7
1515915625603420848,20,3,567.14,4,3,4,11
1515915625603421298,20,2,698.92,4,2,4,10
1515915625603421805,16,1,82.97,4,1,2,7
1515915625603423247,20,1,349.46,4,1,4,9
1515915625603423501,20,4,341.51,4,3,4,11
1515915625603423807,20,1,28.25,4,1,1,6
1515915625603424705,20,1,81.9,4,1,2,7
1515915625603425267,15,1,486.81,4,1,4,9
1515915625603427355,18,1,62.7,4,1,2,7
1515915625603427817,20,1,797.71,4,1,4,9
1515915625603430929,19,1,13.65,4,1,1,6
1515915625603434005,20,1,86.16,4,1,2,7
1515915625603435009,20,1,60.83,4,1,2,7
1515915625603435935,20,1,397.48,4,1,4,9
1515915625603437684,20,1,55.56,4,1,2,7
1515915625603441306,20,1,20.71,4,1,1,6
1515915625603441837,20,2,899.02,4,2,4,10
1515915625603443285,20,1,466.52,4,1,4,9
1515915625603443781,19,4,204.44,4,3,3,10
1515915625603453656,20,1,274.4,4,1,3,8
1515915625603454982,20,1,214.1,4,1,3,8
1515915625603455134,19,2,588.82,4,2,4,10
1515915625603458576,19,2,48.88,4,2,2,8
1515915625603458587,20,1,590.6,4,1,4,9
1515915625603460163,17,7,2049.81,4,4,4,12
1515915625603463571,20,1,449.51,4,1,4,9
1515915625603467833,16,2,587.24,4,2,4,10
1515915625603470537,20,2,49.52,4,2,2,8
1515915625603474216,20,2,49.52,4,2,2,8
1515915625603474727,20,1,156.95,4,1,3,8
1515915625603480039,20,1,16.35,4,1,1,6
1515915625603482178,9,1,24.0,4,1,1,6
1515915625603483440,19,1,884.78,4,1,4,9
1515915625603490078,19,1,247.4,4,1,3,8
1515915625603490800,19,1,20.0,4,1,1,6
1515915625603504390,19,3,1339.53,4,3,4,11
1515915625603505763,19,3,1471.6200000000001,4,3,4,11
1515915625603507589,19,2,303.58,4,2,4,10
1515915625603509222,19,2,31.59,4,2,1,7
1515915625603509367,19,1,171.9,4,1,3,8
1515915625603509823,19,1,34.32,4,1,2,7
1515915625603518264,19,1,642.62,4,1,4,9
1515915625603523592,19,1,449.51,4,1,4,9
1515915625603523856,19,1,32.41,4,1,2,7
1515915625603528538,19,1,35.19,4,1,2,7
1515915625603534913,19,2,64.76,4,2,2,8
1515915625603536132,19,1,292.83,4,1,4,9
1515915625603536701,19,1,187.29,4,1,3,8
1515915625603538715,19,1,31.11,4,1,1,6
1515915625603538762,19,1,16.67,4,1,1,6
1515915625603539179,19,1,202.67,4,1,3,8
1515915625603539972,11,1,32.86,4,1,2,7
1515915625603540766,19,3,845.04,4,3,4,11
1515915625603540895,19,1,68.57,4,1,2,7
1515915625603555788,1,1,214.1,4,1,3,8
1515915625603557023,19,1,22.52,4,1,1,6
1515915625603559245,19,1,23.81,4,1,1,6
1515915625603560564,19,2,33.96,4,2,2,8
1515915625603560897,19,1,126.68,4,1,3,8
1515915625603567337,19,1,133.92,4,1,3,8
1515915625603567624,19,1,202.67,4,1,3,8
1515915625603570461,19,3,1460.43,4,3,4,11
1515915625603572875,19,1,29.9,4,1,1,6
1515915625603573472,19,2,533.5,4,2,4,10
1515915625603576529,19,1,19.97,4,1,1,6
1515915625603577690,19,1,19.68,4,1,1,6
1515915625603578185,19,2,30.16,4,2,1,7
1515915625603579392,19,1,16.24,4,1,1,6
1515915625603579800,14,1,609.6,4,1,4,9
1515915625603579901,19,1,37.94,4,1,2,7
1515915625603580974,19,2,498.8,4,2,4,10
1515915625603581575,19,1,22.22,4,1,1,6
1515915625603589040,19,3,80.03,4,3,2,9
1515915625603589386,19,1,397.48,4,1,4,9
1515915625603591816,19,1,53.33,4,1,2,7
1515915625603591974,19,1,482.52,4,1,4,9
1515915625603592317,19,2,8.86,4,2,1,7
1515915625603603719,19,1,29.84,4,1,1,6
1515915625603606130,19,2,325.52,4,2,4,10
1515915625603618688,19,4,1035.59,4,3,4,11
1515915625603619800,19,2,219.02,4,2,3,9
1515915625603624406,19,2,88.48,4,2,2,8
1515915625603632003,19,1,51.68,4,1,2,7
1515915625603645053,19,1,45.4,4,1,2,7
1515915625603653503,19,1,10.43,4,1,1,6
1515915625603658557,12,3,78.57000000000001,4,3,2,9
1515915625603662591,19,1,26.19,4,1,1,6
1515915625603663559,19,1,656.63,4,1,4,9
1515915625603667639,19,1,397.48,4,1,4,9
1515915625603667888,19,2,1248.92,4,2,4,10
1515915625603668030,19,1,115.4,4,1,3,8
1515915625603678266,19,1,69.35,4,1,2,7
1515915625603679574,19,1,23.48,4,1,1,6
1515915625603681714,19,1,399.48,4,1,4,9
1515915625603683035,5,4,1412.54,4,3,4,11
1515915625603686008,19,1,40.48,4,1,2,7
1515915625603686353,19,5,3178.12,4,4,4,12
1515915625603692723,19,1,294.41,4,1,4,9
1515915625603693462,19,2,281.72,4,2,3,9
1515915625603694281,19,1,23.48,4,1,1,6
1515915625603694506,19,7,943.3199999999999,4,4,4,12
1515915625603698183,19,2,1507.3899999999999,4,2,4,10
1515915625603705341,6,1,656.63,4,1,4,9
1515915625603706137,19,1,23.7,4,1,1,6
1515915625603709925,19,1,10.43,4,1,1,6
1515915625603711195,19,1,40.79,4,1,2,7
1515915625603716853,19,1,140.86,4,1,3,8
1515915625603717772,19,1,25.73,4,1,1,6
1515915625603718352,19,1,284.46,4,1,3,8
1515915625603725192,16,1,1295.83,4,1,4,9
1515915625603729182,19,1,38.83,4,1,2,7
1515915625603730138,19,1,140.86,4,1,3,8
1515915625603730534,19,1,71.75,4,1,2,7
1515915625603746388,19,1,519.56,4,1,4,9
1515915625603754605,19,1,122.97,4,1,3,8
1515915625603758652,19,1,170.0,4,1,3,8
1515915625603761090,19,1,62.83,4,1,2,7
1515915625603762967,19,1,37.46,4,1,2,7
1515915625603772268,19,1,218.98,4,1,3,8
1515915625603792291,19,1,38.24,4,1,2,7
1515915625603795913,19,1,37.0,4,1,2,7
1515915625603798800,19,1,26.49,4,1,1,6
1515915625603807023,16,1,51.33,4,1,2,7
1515915625603808292,19,1,519.56,4,1,4,9
1515915625603811646,18,2,997.08,4,2,4,10
1515915625603814615,19,1,577.6,4,1,4,9
1515915625603815855,19,1,187.29,4,1,3,8
1515915625603830438,19,1,1.57,4,1,1,6
1515915625603833568,19,1,155.11,4,1,3,8
1515915625603834965,19,2,121.66,4,2,3,9
1515915625603835139,19,1,55.6,4,1,2,7
1515915625603835873,19,1,52.9,4,1,2,7
1515915625603836073,19,2,42.54,4,2,2,8
1515915625603836802,19,1,214.1,4,1,3,8
1515915625603838664,19,1,294.41,4,1,4,9
1515915625603840072,19,33,5147.05,4,4,4,12
1515915625603841050,19,2,121.66,4,2,3,9
1515915625603842998,19,2,293.84,4,2,4,10
1515915625603847167,19,1,479.51,4,1,4,9
1515915625603847213,19,1,298.76,4,1,4,9
1515915625603847709,16,12,2509.3199999999997,4,4,4,12
1515915625603855146,19,1,577.6,4,1,4,9
1515915625603856004,19,1,127.08,4,1,3,8
1515915625603862847,18,2,455.69,4,2,4,10
1515915625603864031,19,1,32.22,4,1,1,6
1515915625603866954,15,2,893.4300000000001,4,2,4,10
1515915625603867720,19,1,16.16,4,1,1,6
1515915625603868045,19,1,26.19,4,1,1,6
1515915625603883875,19,1,51.33,4,1,2,7
1515915625603884163,19,1,397.48,4,1,4,9
1515915625603887374,19,2,1201.2,4,2,4,10
1515915625603891112,19,2,18.7,4,2,1,7
1515915625603892819,19,1,133.02,4,1,3,8
1515915625603897846,19,1,215.06,4,1,3,8
1515915625603902651,19,1,63.33,4,1,2,7
1515915625603903048,19,2,42.86,4,2,2,8
1515915625603904388,18,1,577.6,4,1,4,9
1515915625603904746,19,1,21.43,4,1,1,6
1515915625603906303,19,2,933.04,4,2,4,10
1515915625603906372,19,1,9.81,4,1,1,6
1515915625603906760,18,3,243.81,4,3,3,10
1515915625603906864,14,2,1313.26,4,2,4,10
1515915625603913442,19,1,399.48,4,1,4,9
1515915625603915161,17,2,332.48,4,2,4,10
1515915625603915934,18,5,1475.25,4,4,4,12
1515915625603916899,19,1,656.63,4,1,4,9
1515915625603917257,19,1,236.97,4,1,3,8
1515915625603918043,19,1,382.94,4,1,4,9
1515915625603918905,19,2,54.28,4,2,2,8
1515915625603921258,19,1,214.1,4,1,3,8
1515915625603922023,19,1,66.76,4,1,2,7
1515915625603922343,14,3,728.0999999999999,4,3,4,11
1515915625603924993,18,4,108.56,4,3,3,10
1515915625603927187,17,3,561.87,4,3,4,11
1515915625603928891,19,1,478.52,4,1,4,9
1515915625603934982,17,1,294.41,4,1,4,9
1515915625603937649,18,3,1471.6200000000001,4,3,4,11
1515915625603938455,19,1,294.41,4,1,4,9
1515915625603939701,17,5,83.65,4,4,2,10
1515915625603940698,19,1,292.83,4,1,4,9
1515915625603943380,18,1,404.49,4,1,4,9
1515915625603943764,19,1,66.44,4,1,2,7
1515915625603945346,19,1,373.46,4,1,4,9
1515915625603953757,1,1,214.1,4,1,3,8
1515915625603954326,17,3,172.85999999999999,4,3,3,10
1515915625603955855,18,4,205.32,4,3,3,10
1515915625603963084,18,1,15.1,4,1,1,6
1515915625603972136,3,1,47.02,4,1,2,7
1515915625603981822,18,1,230.19,4,1,3,8
1515915625603983851,18,1,140.11,4,1,3,8
1515915625603988066,17,3,87.66,4,3,2,9
1515915625603988425,18,1,48.59,4,1,2,7
1515915625603992404,18,2,10.42,4,2,1,7
1515915625603994174,17,2,77.66,4,2,2,8
1515915625603999178,18,1,13.17,4,1,1,6
1515915625604001472,17,2,905.29,4,2,4,10
1515915625604003697,18,1,43.03,4,1,2,7
1515915625604003751,18,1,274.4,4,1,3,8
1515915625604004107,18,1,16.83,4,1,1,6
1515915625604006917,18,1,187.29,4,1,3,8
1515915625604007126,18,2,1031.46,4,2,4,10
1515915625604008959,18,1,80.03,4,1,2,7
1515915625604010565,18,1,48.22,4,1,2,7
1515915625604011374,18,1,374.44,4,1,4,9
1515915625604011648,18,1,33.08,4,1,2,7
1515915625604015953,18,1,43.03,4,1,2,7
1515915625604016325,9,1,26.83,4,1,1,6
1515915625604018153,18,1,38.83,4,1,2,7
1515915625604019831,17,6,784.72,4,4,4,12
1515915625604020417,16,3,1721.75,4,3,4,11
1515915625604022494,17,2,679.02,4,2,4,10
1515915625604027984,4,1,15.1,4,1,1,6
1515915625604028204,18,1,19.68,4,1,1,6
1515915625604034315,18,1,67.02,4,1,2,7
1515915625604037830,18,2,33.3,4,2,2,8
1515915625604040888,18,1,32.7,4,1,2,7
1515915625604048612,18,2,300.02,4,2,4,10
1515915625604050940,12,2,226.34,4,2,3,9
1515915625604052605,18,4,55.44,4,3,2,9
1515915625604055359,18,1,32.22,4,1,1,6
1515915625604056557,18,1,32.22,4,1,1,6
1515915625604056577,18,2,899.02,4,2,4,10
1515915625604064567,18,1,322.35,4,1,4,9
1515915625604066915,18,4,146.04,4,3,3,10
1515915625604067128,18,1,203.02,4,1,3,8
1515915625604067563,18,1,86.16,4,1,2,7
1515915625604067746,18,1,87.16,4,1,2,7
1515915625604070217,18,1,52.9,4,1,2,7
1515915625604070828,18,2,72.48,4,2,2,8
1515915625604072289,18,1,50.51,4,1,2,7
1515915625604072426,18,2,28.88,4,2,1,7
1515915625604075422,18,1,259.94,4,1,3,8
1515915625604081049,13,2,1219.2,4,2,4,10
1515915625604085355,18,1,199.37,4,1,3,8
1515915625604085954,18,1,88.25,4,1,2,7
1515915625604094361,18,1,32.71,4,1,2,7
1515915625604096595,18,1,31.11,4,1,1,6
1515915625604099117,18,4,129.01999999999998,4,3,3,10
1515915625604100525,18,1,21.75,4,1,1,6
1515915625604101778,16,3,56.19,4,3,2,9
1515915625604103735,18,1,14.6,4,1,1,6
1515915625604106513,18,1,177.95,4,1,3,8
1515915625604110787,18,1,34.29,4,1,2,7
1515915625604118887,18,1,418.48,4,1,4,9
1515915625604121613,14,3,293.79999999999995,4,3,4,11
1515915625604122597,18,1,112.27,4,1,3,8
1515915625604127010,18,1,61.87,4,1,2,7
1515915625604128587,18,2,301.3,4,2,4,10
1515915625604133662,18,1,839.75,4,1,4,9
1515915625604133741,18,1,46.67,4,1,2,7
1515915625604138986,18,3,1213.44,4,3,4,11
1515915625604144325,18,1,16.51,4,1,1,6
1515915625604144437,18,3,80.49,4,3,2,9
1515915625604147242,16,3,1873.8600000000001,4,3,4,11
1515915625604148857,18,2,420.38,4,2,4,10
1515915625604150549,18,2,568.81,4,2,4,10
1515915625604151498,18,3,381.24,4,3,4,11
1515915625604151531,14,2,1199.2,4,2,4,10
1515915625604155681,18,3,381.24,4,3,4,11
1515915625604160525,18,2,1329.26,4,2,4,10
1515915625604161317,18,1,624.62,4,1,4,9
1515915625604162694,18,1,28.1,4,1,1,6
1515915625604165141,16,1,86.48,4,1,2,7
1515915625604165517,18,2,1297.26,4,2,4,10
1515915625604166856,18,1,486.81,4,1,4,9
1515915625604167970,18,1,298.76,4,1,4,9
1515915625604175669,11,43,5399.13,4,4,4,12
1515915625604177503,18,2,794.96,4,2,4,10
1515915625604183785,15,1,214.1,4,1,3,8
1515915625604184816,18,1,51.33,4,1,2,7
1515915625604185527,18,1,65.08,4,1,2,7
1515915625604191426,18,1,28.41,4,1,1,6
1515915625604192869,18,1,187.29,4,1,3,8
1515915625604194537,18,1,259.94,4,1,3,8
1515915625604198950,18,1,77.73,4,1,2,7
1515915625604200233,18,1,119.03,4,1,3,8
1515915625604200270,18,2,374.58,4,2,4,10
1515915625604200781,15,4,807.1,4,3,4,11
1515915625604202372,18,2,42.04,4,2,2,8
1515915625604202773,18,1,397.48,4,1,4,9
1515915625604203105,18,3,30.18,4,3,1,8
1515915625604205543,18,1,13.81,4,1,1,6
1515915625604210635,9,6,1514.52,4,4,4,12
1515915625604211433,9,9,4516.92,4,4,4,12
1515915625604227871,18,1,839.75,4,1,4,9
1515915625604228186,18,1,136.92,4,1,3,8
1515915625604228454,18,5,341.25,4,4,4,12
1515915625604228628,18,1,11.9,4,1,1,6
1515915625604231171,18,5,327.0,4,4,4,12
1515915625604240118,18,1,146.92,4,1,3,8
1515915625604248259,15,1,39.37,4,1,2,7
1515915625604249221,18,1,13.14,4,1,1,6
1515915625604249521,15,10,1347.13,4,4,4,12
1515915625604249882,18,1,109.51,4,1,3,8
1515915625604251350,18,1,42.7,4,1,2,7
1515915625604251831,12,3,561.87,4,3,4,11
1515915625604253739,18,1,415.54,4,1,4,9
1515915625604254832,17,2,428.2,4,2,4,10
1515915625604255918,18,1,471.52,4,1,4,9
1515915625604258542,12,2,1059.13,4,2,4,10
1515915625604260028,18,1,609.6,4,1,4,9
1515915625604262310,18,1,609.6,4,1,4,9
1515915625604264183,18,2,86.22,4,2,2,8
1515915625604264431,18,1,26.98,4,1,1,6
1515915625604267102,18,1,274.4,4,1,3,8
1515915625604269613,18,1,28.1,4,1,1,6
1515915625604272230,18,1,101.9,4,1,3,8
1515915625604273599,18,1,2.86,4,1,1,6
1515915625604273666,18,1,122.86,4,1,3,8
1515915625604274432,18,1,292.83,4,1,4,9
1515915625604279446,14,5,515.42,4,4,4,12
1515915625604281542,18,1,897.79,4,1,4,9
1515915625604281828,18,1,539.57,4,1,4,9
1515915625604282304,18,1,187.29,4,1,3,8
1515915625604285604,14,2,68.88,4,2,2,8
1515915625604286829,18,1,140.86,4,1,3,8
1515915625604289471,18,1,140.86,4,1,3,8
1515915625604290953,18,1,292.83,4,1,4,9
1515915625604293348,17,10,1089.83,4,4,4,12
1515915625604293634,18,1,294.41,4,1,4,9
1515915625604295905,18,1,10.14,4,1,1,6
1515915625604303562,18,1,125.4,4,1,3,8
1515915625604303647,18,1,214.1,4,1,3,8
1515915625604304386,18,1,30.63,4,1,1,6
1515915625604304490,18,1,29.22,4,1,1,6
1515915625604304837,18,5,146.05,4,4,3,11
1515915625604309672,18,1,457.51,4,1,4,9
1515915625604310997,18,1,259.94,4,1,3,8
1515915625604312429,17,2,508.70000000000005,4,2,4,10
1515915625604314816,18,9,419.90999999999997,4,4,4,12
1515915625604316019,18,1,519.56,4,1,4,9
1515915625604324215,18,1,32.06,4,1,1,6
1515915625604324830,18,1,21.9,4,1,1,6
1515915625604336716,17,2,893.02,4,2,4,10
1515915625604343174,17,1,9.84,4,1,1,6
1515915625604343424,17,1,30.16,4,1,1,6
1515915625604350699,5,2,98.89,4,2,3,9
1515915625604353300,17,1,397.48,4,1,4,9
1515915625604354910,17,2,428.2,4,2,4,10
1515915625604356414,17,3,28.049999999999997,4,3,1,8
1515915625604365767,17,2,64.44,4,2,2,8
1515915625604366555,17,1,214.1,4,1,3,8
1515915625604368356,17,1,27.67,4,1,1,6
1515915625604375982,17,2,114.26,4,2,3,9
1515915625604376659,17,2,963.08,4,2,4,10
1515915625604383295,17,1,15.08,4,1,1,6
1515915625604388775,14,1,376.11,4,1,4,9
1515915625604393495,17,1,22.54,4,1,1,6
1515915625604409083,17,1,294.41,4,1,4,9
1515915625604432853,17,1,19.37,4,1,1,6
1515915625604436907,17,1,1.57,4,1,1,6
1515915625604445043,17,1,16.19,4,1,1,6
1515915625604449407,17,1,200.43,4,1,3,8
1515915625604452536,17,1,75.71,4,1,2,7
1515915625604465394,17,1,294.41,4,1,4,9
1515915625604476054,17,1,466.52,4,1,4,9
1515915625604477117,17,1,167.0,4,1,3,8
1515915625604485933,17,1,214.1,4,1,3,8
1515915625604488115,17,1,466.52,4,1,4,9
1515915625604488665,17,2,698.92,4,2,4,10
1515915625604488909,17,1,218.98,4,1,3,8
1515915625604494066,12,1,9.84,4,1,1,6
1515915625604515327,17,1,33.33,4,1,2,7
1515915625604528011,17,1,26.17,4,1,1,6
1515915625604530037,3,2,935.0999999999999,4,2,4,10
1515915625604551301,17,1,15.38,4,1,1,6
1515915625604571130,17,2,42.04,4,2,2,8
1515915625604581579,17,1,16.98,4,1,1,6
1515915625604589125,17,3,853.3799999999999,4,3,4,11
1515915625604595105,17,1,435.7,4,1,4,9
1515915625604595472,17,1,294.41,4,1,4,9
1515915625604597128,17,2,195.88,4,2,3,9
1515915625604600642,17,3,79.94999999999999,4,3,2,9
1515915625604602337,17,1,16.98,4,1,1,6
1515915625604605765,17,1,115.4,4,1,3,8
1515915625604610326,17,2,48.97,4,2,2,8
1515915625604612084,17,3,1374.55,4,3,4,11
1515915625604614505,17,1,600.6,4,1,4,9
1515915625604615065,17,1,155.4,4,1,3,8
1515915625604616729,17,1,18.57,4,1,1,6
1515915625604619875,17,1,52.7,4,1,2,7
1515915625604620905,17,4,155.32,4,3,3,10
1515915625604623214,17,4,1187.5,4,3,4,11
1515915625604624558,17,2,3.14,4,2,1,7
1515915625604627798,17,2,20.1,4,2,1,7
1515915625604627857,17,1,55.35,4,1,2,7
1515915625604628656,17,4,1714.48,4,3,4,11
1515915625604636138,17,1,18.1,4,1,1,6
1515915625604637948,17,1,53.06,4,1,2,7
1515915625604638609,17,1,371.46,4,1,4,9
1515915625604639052,17,1,42.84,4,1,2,7
1515915625604644651,17,1,397.48,4,1,4,9
1515915625604647803,17,1,577.6,4,1,4,9
1515915625604653449,10,2,332.04,4,2,4,10
1515915625604654130,17,1,214.1,4,1,3,8
1515915625604658837,12,2,585.66,4,2,4,10
1515915625604660492,10,3,878.49,4,3,4,11
1515915625604661069,17,1,22.08,4,1,1,6
1515915625604661406,17,2,52.38,4,2,2,8
1515915625604667445,17,2,3.14,4,2,1,7
1515915625604670365,17,1,127.08,4,1,3,8
1515915625604680247,7,1,53.95,4,1,2,7
1515915625604680774,17,2,748.76,4,2,4,10
1515915625604684121,9,1,214.1,4,1,3,8
1515915625604685222,17,1,20.95,4,1,1,6
1515915625604691151,17,1,214.1,4,1,3,8
1515915625604697207,14,6,175.32,4,4,3,11
1515915625604698868,17,1,55.6,4,1,2,7
1515915625604699726,17,1,38.83,4,1,2,7
1515915625604700759,17,1,449.51,4,1,4,9
1515915625604702178,17,1,10.6,4,1,1,6
1515915625604706500,17,10,1321.49,4,4,4,12
1515915625604707280,17,1,9.79,4,1,1,6
1515915625604708847,17,1,26.19,4,1,1,6
1515915625604723663,17,2,82.22,4,2,2,8
1515915625604727997,17,1,164.33,4,1,3,8
1515915625604736917,17,1,115.4,4,1,3,8
1515915625604738639,17,2,30.16,4,2,1,7
1515915625604738847,17,1,292.83,4,1,4,9
1515915625604741127,17,1,298.76,4,1,4,9
1515915625604742803,16,2,76.12,4,2,2,8
1515915625604752747,17,1,163.52,4,1,3,8
1515915625604754695,2,1,55.38,4,1,2,7
1515915625604754830,8,2,598.82,4,2,4,10
1515915625604757097,17,1,19.68,4,1,1,6
1515915625604757138,17,2,32.38,4,2,2,8
1515915625604758008,17,3,96.66,4,3,3,10
1515915625604758458,16,5,1021.4499999999999,4,4,4,12
1515915625604761411,17,1,161.3,4,1,3,8
1515915625604765665,17,1,17.62,4,1,1,6
1515915625604771469,17,3,152.85000000000002,4,3,3,10
1515915625604773528,17,1,180.79,4,1,3,8
1515915625604774126,17,1,236.97,4,1,3,8
1515915625604777166,17,1,399.48,4,1,4,9
1515915625604780759,16,1,10.63,4,1,1,6
1515915625604780850,17,1,481.54,4,1,4,9
1515915625604782539,17,2,428.2,4,2,4,10
1515915625604785379,17,1,397.48,4,1,4,9
1515915625604787774,17,2,29.189999999999998,4,2,1,7
1515915625604790425,17,1,600.6,4,1,4,9
1515915625604791253,17,1,164.33,4,1,3,8
1515915625604796480,17,1,1.57,4,1,1,6
1515915625604800926,17,1,15.21,4,1,1,6
1515915625604802025,17,1,292.83,4,1,4,9
1515915625604804553,1,1,968.83,4,1,4,9
1515915625604805615,17,1,173.86,4,1,3,8
1515915625604808370,16,3,1247.64,4,3,4,11
1515915625604810580,17,1,624.62,4,1,4,9
1515915625604811575,17,2,690.31,4,2,4,10
1515915625604811790,17,2,1058.1100000000001,4,2,4,10
1515915625604814521,17,1,115.4,4,1,3,8
1515915625604817089,17,1,43.13,4,1,2,7
1515915625604818139,16,9,744.57,4,4,4,12
1515915625604819145,15,2,260.0,4,2,3,9
1515915625604822233,14,1,11.75,4,1,1,6
1515915625604824183,17,1,642.62,4,1,4,9
1515915625604824390,16,3,60.63,4,3,2,9
1515915625604827444,17,1,16.16,4,1,1,6
1515915625604840191,17,2,798.96,4,2,4,10
1515915625604840452,17,1,170.0,4,1,3,8
1515915625604840724,17,1,17.3,4,1,1,6
1515915625604850259,17,1,187.29,4,1,3,8
1515915625604850279,17,1,298.76,4,1,4,9
1515915625604850743,7,2,1720.53,4,2,4,10
1515915625604851776,2,2,606.59,4,2,4,10
1515915625604856814,17,1,371.46,4,1,4,9
1515915625604866437,16,1,27.62,4,1,1,6
1515915625604873202,16,1,33.19,4,1,2,7
1515915625604875287,16,1,94.06,4,1,3,8
1515915625604875547,16,3,1042.03,4,3,4,11
1515915625604884456,16,2,973.62,4,2,4,10
1515915625604895088,16,1,137.63,4,1,3,8
1515915625604902663,11,4,221.6,4,3,3,10
1515915625604903832,16,1,113.05,4,1,3,8
1515915625604905729,16,1,29.22,4,1,1,6
1515915625604905952,16,2,798.96,4,2,4,10
1515915625604906600,16,4,94.92,4,3,3,10
1515915625604909055,16,1,449.51,4,1,4,9
1515915625604909262,11,3,2393.13,4,3,4,11
1515915625604910250,16,1,294.41,4,1,4,9
1515915625604913944,16,3,427.47,4,3,4,11
1515915625604914191,16,5,1053.4,4,4,4,12
1515915625604921230,16,1,23.7,4,1,1,6
1515915625604921997,16,1,656.63,4,1,4,9
1515915625604922887,16,1,631.62,4,1,4,9
1515915625604923511,16,1,631.62,4,1,4,9
1515915625604924537,16,1,203.02,4,1,3,8
1515915625604924897,16,2,329.84,4,2,4,10
1515915625604927682,16,1,98.21,4,1,3,8
1515915625604935948,16,1,61.87,4,1,2,7
1515915625604950969,14,3,388.17,4,3,4,11
1515915625604951560,16,1,82.63,4,1,2,7
1515915625604951786,16,1,52.9,4,1,2,7
1515915625604953511,16,1,72.83,4,1,2,7
1515915625604953823,16,2,2550.04,4,2,4,10
1515915625604955334,16,1,298.76,4,1,4,9
1515915625604956288,16,1,43.7,4,1,2,7
1515915625604956947,16,1,32.06,4,1,1,6
1515915625604957314,16,1,10.56,4,1,1,6
1515915625604959620,16,1,160.44,4,1,3,8
1515915625604964350,16,1,214.1,4,1,3,8
1515915625604964609,16,3,110.49,4,3,3,10
1515915625604966835,16,1,47.49,4,1,2,7
1515915625604968175,16,2,88.1,4,2,2,8
1515915625604968250,8,4,155.32,4,3,3,10
1515915625604968304,16,1,66.98,4,1,2,7
1515915625604969684,16,1,29.22,4,1,1,6
1515915625604972533,16,3,3223.6899999999996,4,3,4,11
1515915625604973096,16,2,878.99,4,2,4,10
1515915625604974741,16,1,9.98,4,1,1,6
1515915625604975323,16,2,36.82,4,2,2,8
1515915625604976698,16,1,373.46,4,1,4,9
1515915625604981213,16,1,202.67,4,1,3,8
1515915625604997208,16,1,32.86,4,1,2,7
1515915625604998881,16,2,912.99,4,2,4,10
1515915625604998899,16,2,416.77,4,2,4,10
1515915625605000878,16,1,397.48,4,1,4,9
1515915625605013268,16,1,26.98,4,1,1,6
1515915625605017922,16,1,294.41,4,1,4,9
1515915625605019275,8,1,247.4,4,1,3,8
1515915625605019572,16,1,72.38,4,1,2,7
1515915625605020866,16,1,38.83,4,1,2,7
1515915625605025139,14,1,15.52,4,1,1,6
1515915625605025883,16,2,356.44,4,2,4,10
1515915625605032238,7,2,92.57,4,2,3,9
1515915625605036488,11,1,259.38,4,1,3,8
1515915625605038738,16,2,64.44,4,2,2,8
1515915625605042662,16,1,448.51,4,1,4,9
1515915625605043239,1,2,408.58,4,2,4,10
1515915625605045552,16,1,15.4,4,1,1,6
1515915625605046463,16,1,43.11,4,1,2,7
1515915625605047316,16,1,486.81,4,1,4,9
1515915625605054644,16,42,4465.509999999999,4,4,4,12
1515915625605060396,16,4,495.94,4,3,4,11
1515915625605064222,16,1,65.4,4,1,2,7
1515915625605067024,16,1,27.32,4,1,1,6
1515915625605071953,16,1,292.83,4,1,4,9
1515915625605073380,15,1,15.71,4,1,1,6
1515915625605078937,16,1,121.4,4,1,3,8
1515915625605080557,6,2,798.96,4,2,4,10
1515915625605080992,16,2,30.6,4,2,1,7
1515915625605082677,15,1,45.4,4,1,2,7
1515915625605086923,12,2,742.92,4,2,4,10
1515915625605089426,16,2,506.92999999999995,4,2,4,10
1515915625605094292,16,1,294.41,4,1,4,9
1515915625605094630,16,1,490.54,4,1,4,9
1515915625605102361,16,3,89.52,4,3,2,9
1515915625605103061,2,1,205.25,4,1,3,8
1515915625605105511,16,2,111.3,4,2,3,9
1515915625605105753,16,2,973.62,4,2,4,10
1515915625605107016,16,3,716.9,4,3,4,11
1515915625605107639,16,6,2923.48,4,4,4,12
1515915625605111457,16,1,21.06,4,1,1,6
1515915625605111998,16,1,103.83,4,1,3,8
1515915625605114522,16,1,397.48,4,1,4,9
1515915625605115264,16,1,331.41,4,1,4,9
1515915625605120090,16,1,9.35,4,1,1,6
1515915625605123062,16,1,105.87,4,1,3,8
1515915625605123080,16,2,101.26,4,2,3,9
1515915625605125974,16,1,54.29,4,1,2,7
1515915625605127382,15,1,42.68,4,1,2,7
1515915625605127511,16,2,85.36,4,2,2,8
1515915625605134333,16,1,126.68,4,1,3,8
1515915625605134936,7,2,102.66,4,2,3,9
1515915625605137482,16,1,70.95,4,1,2,7
1515915625605137799,16,1,337.44,4,1,4,9
1515915625605152282,14,1,176.17,4,1,3,8
1515915625605152994,13,1,50.9,4,1,2,7
1515915625605159081,16,2,119.42,4,2,3,9
1515915625605161118,16,1,294.41,4,1,4,9
1515915625605161860,12,2,3.14,4,2,1,7
1515915625605163251,13,3,33.39,4,3,2,9
1515915625605165430,16,1,482.52,4,1,4,9
1515915625605166199,16,2,506.76,4,2,4,10
1515915625605166644,16,1,31.27,4,1,1,6
1515915625605169607,16,1,77.73,4,1,2,7
1515915625605172489,16,1,52.87,4,1,2,7
1515915625605172708,16,1,41.41,4,1,2,7
1515915625605174542,2,4,899.04,4,3,4,11
1515915625605187377,16,1,74.21,4,1,2,7
1515915625605188457,16,1,839.75,4,1,4,9
1515915625605194015,16,1,519.56,4,1,4,9
1515915625605194983,16,2,1201.2,4,2,4,10
1515915625605199270,16,1,294.41,4,1,4,9
1515915625605200741,15,1,173.86,4,1,3,8
1515915625605206319,16,1,294.41,4,1,4,9
1515915625605207892,16,6,2420.7599999999998,4,4,4,12
1515915625605208977,16,1,479.51,4,1,4,9
1515915625605211350,16,1,752.22,4,1,4,9
1515915625605214439,16,1,370.46,4,1,4,9
1515915625605215136,16,1,370.46,4,1,4,9
1515915625605218022,2,1,249.38,4,1,3,8
1515915625605226679,15,4,107.92,4,3,3,10
1515915625605227076,15,1,294.41,4,1,4,9
1515915625605227436,15,1,43.48,4,1,2,7
1515915625605233895,15,1,73.81,4,1,2,7
1515915625605253693,15,1,294.41,4,1,4,9
1515915625605257359,15,1,23.13,4,1,1,6
1515915625605257996,10,3,261.48,4,3,3,10
1515915625605271927,15,1,32.22,4,1,1,6
1515915625605272335,15,1,466.52,4,1,4,9
1515915625605277109,15,1,93.37,4,1,3,8
1515915625605278320,15,1,214.1,4,1,3,8
1515915625605278351,14,4,348.64,4,3,4,11
1515915625605292400,15,1,600.6,4,1,4,9
1515915625605298037,15,1,16.35,4,1,1,6
1515915625605300023,15,2,603.77,4,2,4,10
1515915625605300211,15,1,822.73,4,1,4,9
1515915625605303220,12,2,1096.74,4,2,4,10
1515915625605315875,15,1,214.1,4,1,3,8
1515915625605318137,15,2,963.08,4,2,4,10
1515915625605322322,15,1,38.83,4,1,2,7
1515915625605322827,13,6,2325.37,4,4,4,12
1515915625605327139,15,1,24.37,4,1,1,6
1515915625605335281,15,1,58.95,4,1,2,7
1515915625605335841,15,1,56.27,4,1,2,7
1515915625605338513,15,1,9.35,4,1,1,6
1515915625605341544,15,2,798.96,4,2,4,10
1515915625605342364,6,1,292.83,4,1,4,9
1515915625605348114,11,2,68.88,4,2,2,8
1515915625605350998,15,1,115.4,4,1,3,8
1515915625605351302,15,1,70.6,4,1,2,7
1515915625605355231,15,1,122.97,4,1,3,8
1515915625605356360,15,2,798.96,4,2,4,10
1515915625605357826,15,1,897.79,4,1,4,9
1515915625605358309,15,3,1675.71,4,3,4,11
1515915625605359748,14,1,126.27,4,1,3,8
1515915625605360218,15,1,126.27,4,1,3,8
1515915625605362248,15,3,205.32,4,3,3,10
1515915625605362875,15,1,12.46,4,1,1,6
1515915625605363644,15,1,73.81,4,1,2,7
1515915625605364937,15,1,331.59,4,1,4,9
1515915625605366462,15,1,187.78,4,1,3,8
1515915625605368146,15,1,32.43,4,1,2,7
1515915625605371477,15,3,1372.53,4,3,4,11
1515915625605377766,15,2,117.14,4,2,3,9
1515915625605379289,15,1,58.57,4,1,2,7
1515915625605382942,15,1,28.1,4,1,1,6
1515915625605383581,15,1,370.46,4,1,4,9
1515915625605390349,15,1,572.57,4,1,4,9
1515915625605390733,15,10,75.81,4,4,2,10
1515915625605392148,15,1,156.59,4,1,3,8
1515915625605394102,15,1,71.29,4,1,2,7
1515915625605396668,15,5,1884.3300000000002,4,4,4,12
1515915625605397022,1,3,422.58000000000004,4,3,4,11
1515915625605398031,15,1,399.48,4,1,4,9
1515915625605398803,8,6,601.4,4,4,4,12
1515915625605400367,15,1,481.54,4,1,4,9
1515915625605401081,9,2,781.22,4,2,4,10
1515915625605405302,15,1,15.87,4,1,1,6
1515915625605405760,15,1,36.14,4,1,2,7
1515915625605413499,12,2,352.34,4,2,4,10
1515915625605415568,15,1,26.57,4,1,1,6
1515915625605416090,15,1,32.06,4,1,1,6
1515915625605416957,15,1,10.79,4,1,1,6
1515915625605417000,15,2,237.14,4,2,3,9
1515915625605419911,15,1,41.27,4,1,2,7
1515915625605421061,15,1,105.87,4,1,3,8
1515915625605422452,15,2,794.96,4,2,4,10
1515915625605423730,12,1,187.29,4,1,3,8
1515915625605424473,15,1,215.06,4,1,3,8
1515915625605428467,15,1,177.95,4,1,3,8
1515915625605433833,15,2,1175.2,4,2,4,10
1515915625605435447,15,1,214.1,4,1,3,8
1515915625605444600,12,3,29.52,4,3,1,8
1515915625605447991,15,4,39.36,4,3,2,9
1515915625605450068,15,1,201.33,4,1,3,8
1515915625605451941,15,1,839.75,4,1,4,9
1515915625605455445,15,2,68.88,4,2,2,8
1515915625605456662,15,1,129.05,4,1,3,8
1515915625605457634,14,1,244.0,4,1,3,8
1515915625605461100,15,3,1471.6200000000001,4,3,4,11
1515915625605461327,15,1,240.11,4,1,3,8
1515915625605462037,15,1,210.19,4,1,3,8
1515915625605470861,15,1,202.67,4,1,3,8
1515915625605475155,15,1,218.98,4,1,3,8
1515915625605480988,15,1,292.83,4,1,4,9
1515915625605482036,15,2,69.84,4,2,2,8
1515915625605484754,15,3,93.33,4,3,3,10
1515915625605486639,15,1,60.67,4,1,2,7
1515915625605489340,15,1,397.48,4,1,4,9
1515915625605490035,15,1,18.57,4,1,1,6
1515915625605494988,4,4,546.88,4,3,4,11
1515915625605495863,15,1,501.54,4,1,4,9
1515915625605498611,15,10,1166.2,4,4,4,12
1515915625605498971,15,1,68.05,4,1,2,7
1515915625605500873,15,2,1120.1599999999999,4,2,4,10
1515915625605503538,15,2,781.22,4,2,4,10
1515915625605503756,13,4,41.72,4,3,2,9
1515915625605506530,6,2,692.31,4,2,4,10
1515915625605506772,15,1,909.79,4,1,4,9
1515915625605508830,15,1,64.48,4,1,2,7
1515915625605509782,3,3,1036.4,4,3,4,11
1515915625605511290,15,1,32.22,4,1,1,6
1515915625605511524,15,2,385.72,4,2,4,10
1515915625605513113,14,1,65.71,4,1,2,7
1515915625605516199,9,2,417.73,4,2,4,10
1515915625605519638,15,1,214.1,4,1,3,8
1515915625605521415,15,1,36.59,4,1,2,7
1515915625605524218,15,1,11.86,4,1,1,6
1515915625605530296,15,5,275.79999999999995,4,4,3,11
1515915625605536363,15,3,119.05000000000001,4,3,3,10
1515915625605537295,15,1,80.03,4,1,2,7
1515915625605542004,9,3,63.81,4,3,2,9
1515915625605543832,15,1,51.75,4,1,2,7
1515915625605547243,15,2,21.68,4,2,1,7
1515915625605547780,14,1,16.43,4,1,1,6
1515915625605549793,15,1,397.48,4,1,4,9
1515915625605551127,15,1,415.54,4,1,4,9
1515915625605552460,15,1,34.13,4,1,2,7
1515915625605555185,14,1,167.75,4,1,3,8
1515915625605556503,15,1,373.46,4,1,4,9
1515915625605558286,15,1,251.4,4,1,3,8
1515915625605558990,15,1,150.16,4,1,3,8
1515915625605570151,15,1,274.4,4,1,3,8
1515915625605575546,15,1,18.7,4,1,1,6
1515915625605575767,15,1,31.11,4,1,1,6
1515915625605576009,15,1,397.48,4,1,4,9
1515915625605578639,5,2,128.96,4,2,3,9
1515915625605588405,14,1,587.6,4,1,4,9
1515915625605593111,14,1,55.0,4,1,2,7
1515915625605598171,14,4,67.92,4,3,2,9
1515915625605600861,14,1,42.38,4,1,2,7
1515915625605601917,9,1,191.52,4,1,3,8
1515915625605606805,14,2,22.54,4,2,1,7
1515915625605610874,13,3,467.51,4,3,4,11
1515915625605613213,14,3,790.56,4,3,4,11
1515915625605627547,11,1,60.54,4,1,2,7
1515915625605627942,14,1,274.4,4,1,3,8
1515915625605629547,13,6,520.02,4,4,4,12
1515915625605633510,14,3,1075.2,4,3,4,11
1515915625605636248,14,1,187.29,4,1,3,8
1515915625605642072,14,1,490.54,4,1,4,9
1515915625605646413,11,5,304.15,4,4,4,12
1515915625605647760,14,3,32.37,4,3,2,9
1515915625605652839,14,3,41.58,4,3,2,9
1515915625605654163,14,1,31.68,4,1,1,6
1515915625605654852,14,1,26.19,4,1,1,6
1515915625605656213,14,1,215.06,4,1,3,8
1515915625605656516,14,1,41.75,4,1,2,7
1515915625605657779,14,1,11.62,4,1,1,6
1515915625605658461,14,1,107.16,4,1,3,8
1515915625605658751,14,1,491.9,4,1,4,9
1515915625605666641,14,1,46.98,4,1,2,7
1515915625605666848,14,3,459.51,4,3,4,11
1515915625605669319,13,3,181.62,4,3,3,10
1515915625605674601,14,1,122.86,4,1,3,8
1515915625605677741,14,1,152.08,4,1,3,8
1515915625605680550,14,1,292.83,4,1,4,9
1515915625605683112,14,4,1662.16,4,3,4,11
1515915625605683848,14,1,298.76,4,1,4,9
1515915625605687518,6,2,347.72,4,2,4,10
1515915625605689877,14,2,429.8,4,2,4,10
1515915625605691294,14,1,294.41,4,1,4,9
1515915625605695365,14,3,381.24,4,3,4,11
1515915625605701394,14,1,26.65,4,1,1,6
1515915625605707204,14,1,210.9,4,1,3,8
1515915625605708203,14,1,32.22,4,1,1,6
1515915625605712350,14,1,292.83,4,1,4,9
1515915625605714457,14,1,62.54,4,1,2,7
1515915625605719888,14,1,292.83,4,1,4,9
1515915625605724024,14,1,397.48,4,1,4,9
1515915625605727123,14,1,600.6,4,1,4,9
1515915625605731886,14,1,38.83,4,1,2,7
1515915625605732544,14,1,172.54,4,1,3,8
1515915625605739460,14,1,292.83,4,1,4,9
1515915625605740442,14,1,15.1,4,1,1,6
1515915625605748885,14,1,34.44,4,1,2,7
1515915625605750542,14,4,39.08,4,3,2,9
1515915625605755703,14,1,87.51,4,1,2,7
1515915625605757137,14,1,59.6,4,1,2,7
1515915625605757675,14,2,65.42,4,2,2,8
1515915625605768365,14,1,292.83,4,1,4,9
1515915625605770059,14,1,85.62,4,1,2,7
1515915625605770764,14,1,138.4,4,1,3,8
1515915625605773572,14,1,10.84,4,1,1,6
1515915625605778041,14,2,128.96,4,2,3,9
1515915625605779056,14,5,622.01,4,4,4,12
1515915625605779586,10,1,23.48,4,1,1,6
1515915625605780474,14,1,292.83,4,1,4,9
1515915625605786193,11,2,150.58,4,2,3,9
1515915625605787102,14,2,92.54,4,2,3,9
1515915625605787388,14,1,490.54,4,1,4,9
1515915625605789538,13,1,14.08,4,1,1,6
1515915625605792210,14,2,46.66,4,2,2,8
1515915625605794604,14,1,486.81,4,1,4,9
1515915625605794874,14,2,32.86,4,2,2,8
1515915625605795802,12,2,121.08,4,2,3,9
1515915625605796501,14,4,3235.93,4,3,4,11
1515915625605797539,14,1,104.46,4,1,3,8
1515915625605802101,14,1,294.41,4,1,4,9
1515915625605804720,14,1,43.13,4,1,2,7
1515915625605807855,14,1,294.41,4,1,4,9
1515915625605809083,14,1,50.56,4,1,2,7
1515915625605811605,14,1,294.41,4,1,4,9
1515915625605812691,14,2,61.66,4,2,2,8
1515915625605817577,14,1,294.41,4,1,4,9
1515915625605819896,14,1,204.29,4,1,3,8
1515915625605822207,14,1,61.16,4,1,2,7
1515915625605822927,14,1,16.43,4,1,1,6
1515915625605823221,14,1,371.46,4,1,4,9
1515915625605825996,14,2,907.96,4,2,4,10
1515915625605828186,14,1,399.48,4,1,4,9
1515915625605833858,14,1,397.48,4,1,4,9
1515915625605834531,14,1,57.13,4,1,2,7
1515915625605835781,14,1,397.48,4,1,4,9
1515915625605836612,11,2,254.16,4,2,3,9
1515915625605837770,14,1,36.51,4,1,2,7
1515915625605838820,14,2,1219.2,4,2,4,10
1515915625605845575,14,1,415.54,4,1,4,9
1515915625605845811,14,1,265.05,4,1,3,8
1515915625605846424,14,1,23.57,4,1,1,6
1515915625605847949,14,1,23.57,4,1,1,6
1515915625605848865,14,1,82.97,4,1,2,7
1515915625605849152,14,1,163.52,4,1,3,8
1515915625605854272,14,4,1597.92,4,3,4,11
1515915625605856042,14,1,107.16,4,1,3,8
1515915625605861020,14,1,10.95,4,1,1,6
1515915625605861431,14,1,60.83,4,1,2,7
1515915625605862215,14,1,258.03,4,1,3,8
1515915625605864344,9,1,519.56,4,1,4,9
1515915625605866120,14,1,170.95,4,1,3,8
1515915625605867832,14,1,87.16,4,1,2,7
1515915625605868526,14,1,214.1,4,1,3,8
1515915625605871701,14,1,22.08,4,1,1,6
1515915625605872332,13,2,923.04,4,2,4,10
1515915625605873164,14,2,1047.12,4,2,4,10
1515915625605874914,14,1,486.81,4,1,4,9
1515915625605881957,14,1,23.57,4,1,1,6
1515915625605884181,14,1,599.6,4,1,4,9
1515915625605885487,14,1,82.97,4,1,2,7
1515915625605886239,14,2,68.88,4,2,2,8
1515915625605888021,13,1,600.6,4,1,4,9
1515915625605888904,14,1,63.98,4,1,2,7
1515915625605893911,14,1,38.83,4,1,2,7
1515915625605900703,8,11,1249.66,4,4,4,12
1515915625605902551,14,2,110.32,4,2,3,9
1515915625605903767,14,1,20.94,4,1,1,6
1515915625605912984,14,1,107.79,4,1,3,8
1515915625605914104,13,1,13.65,4,1,1,6
1515915625605917356,14,1,9.4,4,1,1,6
1515915625605919298,14,1,32.22,4,1,1,6
1515915625605925184,14,6,83.16,4,4,2,10
1515915625605926205,14,1,284.46,4,1,3,8
1515915625605927315,14,1,77.35,4,1,2,7
1515915625605928123,14,1,490.54,4,1,4,9
1515915625605929018,14,1,236.97,4,1,3,8
1515915625605933260,14,4,1563.9,4,3,4,11
1515915625605933757,14,5,381.34999999999997,4,4,4,12
1515915625605943043,14,3,1196.44,4,3,4,11
1515915625605943881,14,1,223.35,4,1,3,8
1515915625605952247,14,1,113.81,4,1,3,8
1515915625605959221,13,1,22.22,4,1,1,6
1515915625605972983,13,1,34.29,4,1,2,7
1515915625605976508,13,1,418.48,4,1,4,9
1515915625605988120,11,2,253.52,4,2,3,9
1515915625605990422,13,1,284.46,4,1,3,8
1515915625605990871,13,1,52.33,4,1,2,7
1515915625605994231,13,1,105.87,4,1,3,8
1515915625605996492,13,1,292.83,4,1,4,9
1515915625605999186,13,1,63.98,4,1,2,7
1515915625606005205,13,2,1679.5,4,2,4,10
1515915625606006326,13,1,110.63,4,1,3,8
1515915625606009494,13,1,121.19,4,1,3,8
1515915625606011591,13,1,97.94,4,1,3,8
1515915625606016881,13,1,214.1,4,1,3,8
1515915625606017590,13,2,21.42,4,2,1,7
1515915625606028642,13,1,20.71,4,1,1,6
1515915625606028906,13,1,19.52,4,1,1,6
1515915625606033640,13,1,40.79,4,1,2,7
1515915625606034386,13,2,123.78,4,2,3,9
1515915625606035450,13,1,43.33,4,1,2,7
1515915625606036639,7,1,20.71,4,1,1,6
1515915625606041371,12,2,272.7,4,2,3,9
1515915625606044958,13,1,60.83,4,1,2,7
1515915625606044994,13,1,415.54,4,1,4,9
1515915625606051707,13,2,230.8,4,2,3,9
1515915625606061224,13,1,20.79,4,1,1,6
1515915625606062308,13,1,209.7,4,1,3,8
1515915625606065801,13,1,22.86,4,1,1,6
1515915625606067615,13,1,127.87,4,1,3,8
1515915625606068142,13,1,229.38,4,1,3,8
1515915625606070013,13,1,285.13,4,1,3,8
1515915625606072080,13,1,294.41,4,1,4,9
1515915625606074004,13,1,577.6,4,1,4,9
1515915625606074259,13,6,550.5,4,4,4,12
1515915625606076969,13,3,65.37,4,3,2,9
1515915625606077346,13,1,35.68,4,1,2,7
1515915625606080113,13,1,25.7,4,1,1,6
1515915625606080146,13,1,1.57,4,1,1,6
1515915625606080685,9,3,248.91,4,3,3,10
1515915625606082116,13,4,93.48,4,3,3,10
1515915625606082348,13,1,11.11,4,1,1,6
1515915625606083041,13,1,20.95,4,1,1,6
1515915625606083295,13,1,118.57,4,1,3,8
1515915625606083639,13,2,16.11,4,2,1,7
1515915625606083837,13,1,42.6,4,1,2,7
1515915625606084063,13,1,107.16,4,1,3,8
1515915625606084497,13,2,174.32,4,2,3,9
1515915625606096429,13,4,83.16,4,3,2,9
1515915625606099457,13,1,567.79,4,1,4,9
1515915625606101212,13,2,7.96,4,2,1,7
1515915625606102971,13,1,18.1,4,1,1,6
1515915625606108769,9,3,558.89,4,3,4,11
1515915625606115863,13,1,29.22,4,1,1,6
1515915625606117238,13,2,133.96,4,2,3,9
1515915625606119400,13,2,67.3,4,2,2,8
1515915625606120123,13,1,879.78,4,1,4,9
1515915625606125433,13,2,588.82,4,2,4,10
1515915625606125849,13,2,44.16,4,2,2,8
1515915625606126131,13,1,31.75,4,1,1,6
1515915625606128573,13,1,38.83,4,1,2,7
1515915625606129417,13,1,52.49,4,1,2,7
1515915625606130135,13,1,284.46,4,1,3,8
1515915625606130665,13,1,164.33,4,1,3,8
1515915625606132366,6,9,1837.07,4,4,4,12
1515915625606135266,11,2,253.36,4,2,3,9
1515915625606136456,13,1,294.41,4,1,4,9
1515915625606137021,13,1,599.6,4,1,4,9
1515915625606137908,13,1,32.22,4,1,1,6
1515915625606143543,13,1,82.97,4,1,2,7
1515915625606143561,13,1,38.83,4,1,2,7
1515915625606145917,13,1,415.54,4,1,4,9
1515915625606147868,13,1,187.29,4,1,3,8
1515915625606149678,13,1,656.63,4,1,4,9
1515915625606150187,13,1,482.52,4,1,4,9
1515915625606150335,13,1,214.1,4,1,3,8
1515915625606151007,13,3,6.0,4,3,1,8
1515915625606159653,13,1,10.84,4,1,1,6
1515915625606159726,13,1,449.51,4,1,4,9
1515915625606159781,13,1,10.84,4,1,1,6
1515915625606160337,13,1,15.4,4,1,1,6
1515915625606168581,12,3,140.01,4,3,3,10
1515915625606168812,7,4,3133.85,4,3,4,11
1515915625606169487,13,1,43.65,4,1,2,7
1515915625606170739,13,1,32.38,4,1,2,7
1515915625606171336,13,2,41.75,4,2,2,8
1515915625606173270,13,1,897.79,4,1,4,9
1515915625606173429,13,1,449.51,4,1,4,9
1515915625606175908,13,3,116.49,4,3,3,10
1515915625606178717,11,4,137.77999999999997,4,3,3,10
1515915625606179015,13,1,415.54,4,1,4,9
1515915625606179302,13,1,600.6,4,1,4,9
1515915625606180577,13,3,116.49,4,3,3,10
1515915625606180799,13,1,31.86,4,1,1,6
1515915625606187129,12,1,539.57,4,1,4,9
1515915625606188279,13,1,31.86,4,1,1,6
1515915625606188595,4,1,156.73,4,1,3,8
1515915625606189685,13,1,77.73,4,1,2,7
1515915625606190687,13,1,29.22,4,1,1,6
1515915625606190778,13,1,21.76,4,1,1,6
1515915625606194097,13,2,428.2,4,2,4,10
1515915625606196433,13,1,56.67,4,1,2,7
1515915625606196446,13,4,43.36,4,3,2,9
1515915625606197578,13,2,46.96,4,2,2,8
1515915625606197784,13,5,369.05,4,4,4,12
1515915625606202954,13,1,127.08,4,1,3,8
1515915625606203910,4,1,187.29,4,1,3,8
1515915625606203979,12,1,51.33,4,1,2,7
1515915625606204260,13,2,21.68,4,2,1,7
1515915625606205694,4,3,778.04,4,3,4,11
1515915625606205896,12,2,453.4,4,2,4,10
1515915625606206012,13,1,31.11,4,1,1,6
1515915625606216404,12,1,9.21,4,1,1,6
1515915625606223631,3,4,176.7,4,3,3,10
1515915625606224619,13,2,585.66,4,2,4,10
1515915625606231049,13,3,882.04,4,3,4,11
1515915625606231977,13,1,36.14,4,1,2,7
1515915625606233315,13,1,38.83,4,1,2,7
1515915625606233970,13,1,307.43,4,1,4,9
1515915625606234075,13,2,428.2,4,2,4,10
1515915625606236242,13,3,878.49,4,3,4,11
1515915625606236811,13,2,51.46,4,2,2,8
1515915625606240393,13,2,89.14,4,2,2,8
1515915625606241509,13,1,374.38,4,1,4,9
1515915625606251736,13,3,61.67999999999999,4,3,2,9
1515915625606252484,13,3,651.0699999999999,4,3,4,11
1515915625606255684,13,1,73.32,4,1,2,7
1515915625606259425,10,1,45.1,4,1,2,7
1515915625606262087,13,1,118.57,4,1,3,8
1515915625606263144,12,4,33.16,4,3,2,9
1515915625606268819,12,1,11.62,4,1,1,6
1515915625606273874,13,1,38.83,4,1,2,7
1515915625606275151,13,1,84.89,4,1,2,7
1515915625606275626,13,3,96.66,4,3,3,10
1515915625606276531,12,3,149.7,4,3,3,10
1515915625606277433,3,2,547.24,4,2,4,10
1515915625606278624,13,1,77.78,4,1,2,7
1515915625606280971,13,1,202.67,4,1,3,8
1515915625606286965,13,1,397.48,4,1,4,9
1515915625606288270,13,1,1.57,4,1,1,6
1515915625606289809,13,3,799.76,4,3,4,11
1515915625606291049,13,1,490.54,4,1,4,9
1515915625606291184,13,2,116.2,4,2,3,9
1515915625606292148,13,4,858.97,4,3,4,11
1515915625606292554,13,1,486.81,4,1,4,9
1515915625606294536,12,2,41.46,4,2,2,8
1515915625606294852,13,1,284.46,4,1,3,8
1515915625606298945,13,2,981.08,4,2,4,10
1515915625606299445,13,2,981.08,4,2,4,10
1515915625606299838,12,1,420.63,4,1,4,9
1515915625606300317,13,1,490.54,4,1,4,9
1515915625606302939,12,1,284.46,4,1,3,8
1515915625606304845,13,3,69.99,4,3,2,9
1515915625606307462,13,1,292.83,4,1,4,9
1515915625606309873,13,2,58.44,4,2,2,8
1515915625606333813,12,2,36.82,4,2,2,8
1515915625606339690,12,1,397.48,4,1,4,9
1515915625606340792,12,3,899.23,4,3,4,11
1515915625606341306,12,2,1030.08,4,2,4,10
1515915625606344553,12,1,201.33,4,1,3,8
1515915625606345822,12,1,21.43,4,1,1,6
1515915625606347394,12,1,112.06,4,1,3,8
1515915625606358244,10,2,222.16,4,2,3,9
1515915625606359683,11,3,1285.8600000000001,4,3,4,11
1515915625606360840,12,1,202.67,4,1,3,8
1515915625606364398,12,12,3916.13,4,4,4,12
1515915625606370933,12,1,9.94,4,1,1,6
1515915625606381960,12,1,16.35,4,1,1,6
1515915625606383572,12,1,65.71,4,1,2,7
1515915625606387516,12,1,5.0,4,1,1,6
1515915625606389024,12,1,64.48,4,1,2,7
1515915625606391776,12,1,521.56,4,1,4,9
1515915625606392936,12,7,283.35999999999996,4,4,3,11
1515915625606393840,12,1,48.41,4,1,2,7
1515915625606395377,12,1,490.54,4,1,4,9
1515915625606396294,12,1,226.84,4,1,3,8
1515915625606398821,12,1,20.13,4,1,1,6
1515915625606399359,12,1,428.62,4,1,4,9
1515915625606405912,12,1,287.4,4,1,3,8
1515915625606406765,12,2,115.24,4,2,3,9
1515915625606409108,12,1,453.86,4,1,4,9
1515915625606411038,12,2,428.2,4,2,4,10
1515915625606417522,12,1,1.57,4,1,1,6
1515915625606417953,12,1,15.1,4,1,1,6
1515915625606418056,12,1,339.94,4,1,4,9
1515915625606419407,12,2,30.2,4,2,1,7
1515915625606421710,12,3,1706.01,4,3,4,11
1515915625606422816,12,3,96.18,4,3,3,10
1515915625606423514,11,1,204.29,4,1,3,8
1515915625606426061,12,1,259.38,4,1,3,8
1515915625606433700,12,1,36.14,4,1,2,7
1515915625606435537,12,1,399.48,4,1,4,9
1515915625606435743,12,1,399.48,4,1,4,9
1515915625606436181,10,2,87.3,4,2,2,8
1515915625606438441,12,2,27.72,4,2,1,7
1515915625606441953,9,2,965.04,4,2,4,10
1515915625606447341,12,2,77.66,4,2,2,8
1515915625606450976,12,1,220.52,4,1,3,8
1515915625606453193,12,3,24.869999999999997,4,3,1,8
1515915625606453344,12,3,1732.8000000000002,4,3,4,11
1515915625606453933,12,1,18.71,4,1,1,6
1515915625606458170,12,1,26.49,4,1,1,6
1515915625606459251,12,1,33.08,4,1,2,7
1515915625606461810,12,1,125.4,4,1,3,8
1515915625606462294,12,1,8.59,4,1,1,6
1515915625606462426,12,1,187.29,4,1,3,8
1515915625606465367,12,1,45.14,4,1,2,7
1515915625606469928,12,3,498.06000000000006,4,3,4,11
1515915625606472226,12,1,420.63,4,1,4,9
1515915625606473481,12,1,81.27,4,1,2,7
1515915625606481197,12,1,193.13,4,1,3,8
1515915625606483588,12,1,163.52,4,1,3,8
1515915625606483618,5,1,38.06,4,1,2,7
1515915625606488939,12,1,13.89,4,1,1,6
1515915625606489628,12,1,72.0,4,1,2,7
1515915625606491082,12,1,214.1,4,1,3,8
1515915625606492444,12,1,373.46,4,1,4,9
1515915625606492799,12,2,121.66,4,2,3,9
1515915625606499114,12,1,122.86,4,1,3,8
1515915625606504997,12,2,428.2,4,2,4,10
1515915625606513719,12,1,32.22,4,1,1,6
1515915625606517138,12,2,177.46,4,2,3,9
1515915625606518072,12,1,20.13,4,1,1,6
1515915625606521711,12,1,202.67,4,1,3,8
1515915625606522938,12,1,466.52,4,1,4,9
1515915625606522976,12,1,52.44,4,1,2,7
1515915625606524504,12,1,607.92,4,1,4,9
1515915625606528184,12,2,20.92,4,2,1,7
1515915625606529255,11,1,116.05,4,1,3,8
1515915625606529402,12,2,165.94,4,2,3,9
1515915625606532932,10,1,10.16,4,1,1,6
1515915625606533006,12,2,66.72,4,2,2,8
1515915625606533202,12,1,35.71,4,1,2,7
1515915625606540125,12,2,71.84,4,2,2,8
1515915625606541701,12,1,15.43,4,1,1,6
1515915625606541703,8,2,58.44,4,2,2,8
1515915625606551142,12,1,397.48,4,1,4,9
1515915625606552488,3,2,141.2,4,2,3,9
1515915625606559724,12,1,486.81,4,1,4,9
1515915625606561036,12,1,16.51,4,1,1,6
1515915625606564319,11,1,73.68,4,1,2,7
1515915625606565072,12,2,68.88,4,2,2,8
1515915625606565635,12,1,29.22,4,1,1,6
1515915625606570114,12,1,63.33,4,1,2,7
1515915625606570745,12,2,72.28,4,2,2,8
1515915625606576224,12,1,154.27,4,1,3,8
1515915625606577646,11,1,49.38,4,1,2,7
1515915625606580217,12,1,107.16,4,1,3,8
1515915625606581990,9,2,428.2,4,2,4,10
1515915625606582552,12,1,51.11,4,1,2,7
1515915625606585374,8,1,251.4,4,1,3,8
1515915625606585418,12,1,251.4,4,1,3,8
1515915625606594851,12,1,32.19,4,1,1,6
1515915625606598628,11,10,1142.45,4,4,4,12
1515915625606599338,2,1,75.97,4,1,2,7
1515915625606600013,12,1,29.05,4,1,1,6
1515915625606600077,12,1,159.1,4,1,3,8
1515915625606605861,12,1,230.75,4,1,3,8
1515915625606606833,12,1,54.29,4,1,2,7
1515915625606610685,11,1,190.03,4,1,3,8
1515915625606610876,12,1,49.29,4,1,2,7
1515915625606614335,12,3,185.82,4,3,3,10
1515915625606614484,12,6,3282.4,4,4,4,12
1515915625606616031,12,1,97.57,4,1,3,8
1515915625606616083,12,1,35.22,4,1,2,7
1515915625606622901,12,1,177.65,4,1,3,8
1515915625606623682,12,5,440.33,4,4,4,12
1515915625606624206,12,2,245.14,4,2,3,9
1515915625606630012,12,1,21.43,4,1,1,6
1515915625606635039,12,2,973.62,4,2,4,10
1515915625606639266,12,3,642.3,4,3,4,11
1515915625606642592,12,1,55.65,4,1,2,7
1515915625606642889,12,1,28.59,4,1,1,6
1515915625606644736,12,1,415.54,4,1,4,9
1515915625606645213,12,1,397.48,4,1,4,9
1515915625606646444,12,2,480.22,4,2,4,10
1515915625606650268,12,2,123.78,4,2,3,9
1515915625606654304,12,1,539.57,4,1,4,9
1515915625606654518,12,2,458.76,4,2,4,10
1515915625606654725,12,1,29.22,4,1,1,6
1515915625606656527,12,2,423.58,4,2,4,10
1515915625606657127,12,2,508.51,4,2,4,10
1515915625606661169,12,2,29.6,4,2,1,7
1515915625606665766,12,2,204.55,4,2,3,9
1515915625606665940,12,1,292.83,4,1,4,9
1515915625606670713,12,7,2016.03,4,4,4,12
1515915625606675823,12,1,14.6,4,1,1,6
1515915625606676241,12,1,40.63,4,1,2,7
1515915625606676958,3,1,202.67,4,1,3,8
1515915625606677157,12,1,53.33,4,1,2,7
1515915625606680126,12,4,490.42,4,3,4,11
1515915625606682263,12,2,34.42,4,2,2,8
1515915625606683062,11,3,553.98,4,3,4,11
1515915625606683075,12,1,897.79,4,1,4,9
1515915625606684509,12,1,9.59,4,1,1,6
1515915625606685977,12,2,106.48,4,2,3,9
1515915625606689175,11,2,471.80999999999995,4,2,4,10
1515915625606693033,11,1,12.49,4,1,1,6
1515915625606696735,11,3,487.53,4,3,4,11
1515915625606699019,11,1,519.56,4,1,4,9
1515915625606702221,9,2,147.62,4,2,3,9
1515915625606718954,11,1,25.3,4,1,1,6
1515915625606722905,11,1,292.83,4,1,4,9
1515915625606730917,11,2,40.34,4,2,2,8
1515915625606739977,11,1,466.52,4,1,4,9
1515915625606740903,11,1,471.52,4,1,4,9
1515915625606741405,11,1,279.37,4,1,3,8
1515915625606741450,10,3,2510.2799999999997,4,3,4,11
1515915625606742360,11,1,169.67,4,1,3,8
1515915625606743580,11,1,18.7,4,1,1,6
1515915625606749685,11,1,15.4,4,1,1,6
1515915625606760496,11,1,16.98,4,1,1,6
1515915625606761043,11,1,33.33,4,1,2,7
1515915625606763048,11,3,883.23,4,3,4,11
1515915625606763198,11,1,150.89,4,1,3,8
1515915625606768271,11,2,100.64,4,2,3,9
1515915625606770162,11,2,166.98,4,2,3,9
1515915625606772444,11,3,1105.2199999999998,4,3,4,11
1515915625606773332,11,2,408.58,4,2,4,10
1515915625606776517,11,1,19.97,4,1,1,6
1515915625606778398,11,1,37.9,4,1,2,7
1515915625606779613,11,4,79.12,4,3,2,9
1515915625606780083,11,2,177.08,4,2,3,9
1515915625606785466,11,1,29.22,4,1,1,6
1515915625606785602,11,1,51.33,4,1,2,7
1515915625606788718,11,2,698.92,4,2,4,10
1515915625606789747,11,1,19.37,4,1,1,6
1515915625606794035,11,1,19.52,4,1,1,6
1515915625606795451,11,1,259.38,4,1,3,8
1515915625606796379,11,4,60.32,4,3,2,9
1515915625606798406,11,4,105.69999999999999,4,3,3,10
1515915625606799296,11,1,10.1,4,1,1,6
1515915625606802899,11,2,61.58,4,2,2,8
1515915625606805557,11,2,75.24,4,2,2,8
1515915625606806735,11,1,140.81,4,1,3,8
1515915625606807694,11,1,1.57,4,1,1,6
1515915625606814056,11,1,256.22,4,1,3,8
1515915625606816688,11,5,202.39999999999998,4,4,3,11
1515915625606823968,11,1,215.06,4,1,3,8
1515915625606823971,11,3,45.24,4,3,2,9
1515915625606827370,11,1,1.57,4,1,1,6
1515915625606828660,11,1,77.73,4,1,2,7
1515915625606832703,11,2,230.16,4,2,3,9
1515915625606834253,11,1,94.06,4,1,3,8
1515915625606842667,10,2,1673.52,4,2,4,10
1515915625606845054,11,1,77.73,4,1,2,7
1515915625606846062,5,11,137.60999999999999,4,4,3,11
1515915625606848150,11,1,23.62,4,1,1,6
1515915625606849713,11,1,482.52,4,1,4,9
1515915625606849956,11,2,831.08,4,2,4,10
1515915625606852693,11,3,88.56,4,3,2,9
1515915625606856150,9,3,247.23,4,3,3,10
1515915625606862032,11,1,37.62,4,1,2,7
1515915625606866067,11,1,515.56,4,1,4,9
1515915625606868601,11,1,10.0,4,1,1,6
1515915625606869200,11,1,81.92,4,1,2,7
1515915625606869627,11,1,229.38,4,1,3,8
1515915625606871625,11,1,214.1,4,1,3,8
1515915625606874169,11,1,40.0,4,1,2,7
1515915625606874928,11,1,40.95,4,1,2,7
1515915625606879986,11,1,17.25,4,1,1,6
1515915625606882006,11,1,1.57,4,1,1,6
1515915625606883114,11,1,155.1,4,1,3,8
1515915625606884713,9,1,78.37,4,1,2,7
1515915625606891206,11,1,163.52,4,1,3,8
1515915625606895181,10,3,2510.2799999999997,4,3,4,11
1515915625606896564,11,4,348.56,4,3,4,11
1515915625606898331,11,1,43.02,4,1,2,7
1515915625606900366,11,1,32.22,4,1,1,6
1515915625606901414,11,2,49.24,4,2,2,8
1515915625606907547,11,1,32.22,4,1,1,6
1515915625606907667,11,2,81.26,4,2,2,8
1515915625606910518,11,5,470.3,4,4,4,12
1515915625606911271,3,2,365.9,4,2,4,10
1515915625606912793,11,1,77.73,4,1,2,7
1515915625606914790,4,1,397.48,4,1,4,9
1515915625606916834,11,2,611.58,4,2,4,10
1515915625606924402,11,1,897.79,4,1,4,9
1515915625606936934,11,1,15.71,4,1,1,6
1515915625606938809,6,6,3735.44,4,4,4,12
1515915625606940342,9,10,4575.09,4,4,4,12
1515915625606944464,11,4,1960.2200000000003,4,3,4,11
1515915625606946315,9,4,75.56,4,3,2,9
1515915625606948760,11,1,34.65,4,1,2,7
1515915625606951998,11,1,292.83,4,1,4,9
1515915625606952694,10,1,209.25,4,1,3,8
1515915625606957352,8,3,492.99,4,3,4,11
1515915625606959433,10,1,300.37,4,1,4,9
1515915625606960440,10,2,96.54,4,2,3,9
1515915625606960968,11,2,260.22,4,2,3,9
1515915625606963093,8,3,483.33000000000004,4,3,4,11
1515915625606963568,11,2,68.88,4,2,2,8
1515915625606967172,11,1,7.44,4,1,1,6
1515915625606970797,11,2,165.94,4,2,3,9
1515915625606975590,11,3,73.80000000000001,4,3,2,9
1515915625606981903,11,2,998.08,4,2,4,10
1515915625606984355,11,1,33.97,4,1,2,7
1515915625606984537,11,3,69.99,4,3,2,9
1515915625606985012,11,2,597.52,4,2,4,10
1515915625606986677,11,3,70.94999999999999,4,3,2,9
1515915625606987998,11,1,13.29,4,1,1,6
1515915625606988656,10,2,27.3,4,2,1,7
1515915625606988833,11,2,60.32,4,2,2,8
1515915625606990632,11,2,742.3399999999999,4,2,4,10
1515915625606991945,11,2,15.08,4,2,1,7
1515915625606992719,11,1,449.51,4,1,4,9
1515915625606997402,11,1,87.16,4,1,2,7
1515915625606997470,10,4,1441.86,4,3,4,11
1515915625606999583,11,1,575.73,4,1,4,9
1515915625607003709,11,1,449.51,4,1,4,9
1515915625607013366,11,1,187.29,4,1,3,8
1515915625607018156,11,1,257.87,4,1,3,8
1515915625607025033,5,2,67.94,4,2,2,8
1515915625607026516,11,1,29.37,4,1,1,6
1515915625607027095,10,1,210.68,4,1,3,8
1515915625607032072,3,1,339.51,4,1,4,9
1515915625607032444,11,1,11.65,4,1,1,6
1515915625607035593,11,1,210.68,4,1,3,8
1515915625607035815,11,1,303.43,4,1,4,9
1515915625607036235,11,2,606.86,4,2,4,10
1515915625607036379,11,1,39.68,4,1,2,7
1515915625607041261,11,1,162.95,4,1,3,8
1515915625607049188,11,1,179.94,4,1,3,8
1515915625607050946,11,2,703.64,4,2,4,10
1515915625607052580,11,1,10.43,4,1,1,6
1515915625607053002,11,2,585.66,4,2,4,10
1515915625607053494,11,1,397.48,4,1,4,9
1515915625607067381,9,1,600.6,4,1,4,9
1515915625607067594,7,1,36.59,4,1,2,7
1515915625607068792,7,1,49.11,4,1,2,7
1515915625607069756,11,3,110.01,4,3,3,10
1515915625607074101,11,1,10.16,4,1,1,6
1515915625607074363,10,2,280.51,4,2,3,9
1515915625607075873,11,1,19.87,4,1,1,6
1515915625607076664,11,1,292.83,4,1,4,9
1515915625607077702,11,1,23.49,4,1,1,6
1515915625607085288,8,2,949.46,4,2,4,10
1515915625607087172,10,1,449.51,4,1,4,9
1515915625607091019,10,2,400.7,4,2,4,10
1515915625607091880,10,1,897.79,4,1,4,9
1515915625607093411,9,1,23.33,4,1,1,6
1515915625607099454,10,1,519.56,4,1,4,9
1515915625607101185,10,1,457.51,4,1,4,9
1515915625607104436,10,1,897.79,4,1,4,9
1515915625607107339,10,1,192.86,4,1,3,8
1515915625607107755,10,2,65.02,4,2,2,8
1515915625607108450,10,1,210.68,4,1,3,8
1515915625607119650,10,2,53.96,4,2,2,8
1515915625607123634,10,1,18.1,4,1,1,6
1515915625607261794,10,1,397.48,4,1,4,9
1515915625607264508,10,1,87.14,4,1,2,7
1515915625607265593,10,2,53.46,4,2,2,8
1515915625607268744,10,1,376.11,4,1,4,9
1515915625607269696,10,1,265.05,4,1,3,8
1515915625607270606,10,1,16.35,4,1,1,6
1515915625607271259,10,1,12.48,4,1,1,6
1515915625607271731,10,2,32.38,4,2,2,8
1515915625607275297,10,1,29.4,4,1,1,6
1515915625607282161,10,1,466.52,4,1,4,9
1515915625607288379,10,1,226.7,4,1,3,8
1515915625607290161,8,2,121.66,4,2,3,9
1515915625607293491,10,3,155.04,4,3,3,10
1515915625607296422,10,1,292.83,4,1,4,9
1515915625607297278,10,1,14.08,4,1,1,6
1515915625607298385,10,1,149.05,4,1,3,8
1515915625607302348,10,1,292.83,4,1,4,9
1515915625607302406,10,1,577.6,4,1,4,9
1515915625607303162,10,1,244.0,4,1,3,8
1515915625607307499,10,1,101.9,4,1,3,8
1515915625607310269,10,1,177.95,4,1,3,8
1515915625607312568,10,2,19.68,4,2,1,7
1515915625607313511,9,4,2094.24,4,3,4,11
1515915625607315141,10,1,97.41,4,1,3,8
1515915625607317852,10,1,490.54,4,1,4,9
1515915625607318244,10,1,82.97,4,1,2,7
1515915625607324353,10,1,63.49,4,1,2,7
1515915625607329202,10,1,33.65,4,1,2,7
1515915625607329257,10,1,12.08,4,1,1,6
1515915625607338163,10,2,408.58,4,2,4,10
1515915625607340673,10,1,109.51,4,1,3,8
1515915625607340790,2,3,506.84999999999997,4,3,4,11
1515915625607340880,10,4,508.32,4,3,4,11
1515915625607342288,10,1,68.57,4,1,2,7
1515915625607343847,5,1,14.08,4,1,1,6
1515915625607345371,10,1,32.06,4,1,1,6
1515915625607348218,10,2,588.82,4,2,4,10
1515915625607349273,10,1,582.37,4,1,4,9
1515915625607350591,10,4,142.84,4,3,3,10
1515915625607352137,10,1,13.02,4,1,1,6
1515915625607355296,10,1,146.92,4,1,3,8
1515915625607355368,9,1,77.73,4,1,2,7
1515915625607359765,5,5,1571.96,4,4,4,12
1515915625607360107,10,3,83.67,4,3,2,9
1515915625607362033,10,2,690.31,4,2,4,10
1515915625607365520,10,1,29.22,4,1,1,6
1515915625607365710,3,1,12.83,4,1,1,6
1515915625607366559,10,1,34.44,4,1,2,7
1515915625607367372,10,3,255.71999999999997,4,3,3,10
1515915625607367518,10,1,28.68,4,1,1,6
1515915625607368791,10,1,15.9,4,1,1,6
1515915625607372732,10,2,691.8900000000001,4,2,4,10
1515915625607380328,10,3,2017.8899999999999,4,3,4,11
1515915625607382026,10,2,954.26,4,2,4,10
1515915625607383287,10,1,7.0,4,1,1,6
1515915625607388047,7,1,448.51,4,1,4,9
1515915625607389697,10,3,1498.6200000000001,4,3,4,11
1515915625607392164,10,1,30.54,4,1,1,6
1515915625607394567,10,1,22.08,4,1,1,6
1515915625607396067,10,3,255.71999999999997,4,3,3,10
1515915625607397101,10,1,274.4,4,1,3,8
1515915625607401067,10,2,149.68,4,2,3,9
1515915625607401094,10,1,77.35,4,1,2,7
1515915625607402043,9,5,69.05,4,4,2,10
1515915625607403023,10,1,77.35,4,1,2,7
1515915625607403144,10,1,46.86,4,1,2,7
1515915625607404027,10,1,373.46,4,1,4,9
1515915625607404318,10,1,63.35,4,1,2,7
1515915625607404976,9,1,75.29,4,1,2,7
1515915625607406462,10,1,292.83,4,1,4,9
1515915625607411047,8,2,644.8,4,2,4,10
1515915625607416659,10,1,68.57,4,1,2,7
1515915625607417294,10,1,14.86,4,1,1,6
1515915625607422611,10,1,403.46,4,1,4,9
1515915625607422866,10,1,15.87,4,1,1,6
1515915625607425372,10,1,365.41,4,1,4,9
1515915625607425397,10,1,13.89,4,1,1,6
1515915625607433031,10,2,674.88,4,2,4,10
1515915625607433280,10,1,9.95,4,1,1,6
1515915625607438197,10,1,82.97,4,1,2,7
1515915625607441673,10,1,24.6,4,1,1,6
1515915625607444149,10,2,77.66,4,2,2,8
1515915625607444387,10,2,77.66,4,2,2,8
1515915625607444668,10,3,1288.5900000000001,4,3,4,11
1515915625607446080,10,3,492.99,4,3,4,11
1515915625607446395,10,1,124.89,4,1,3,8
1515915625607448029,10,1,43.11,4,1,2,7
1515915625607448675,2,1,170.0,4,1,3,8
1515915625607454150,8,11,472.78,4,4,4,12
1515915625607462128,10,2,151.78,4,2,3,9
1515915625607462674,10,1,204.29,4,1,3,8
1515915625607467220,10,2,129.08,4,2,3,9
1515915625607467888,10,2,55.78,4,2,2,8
1515915625607472949,10,1,399.48,4,1,4,9
1515915625607474177,10,1,10.48,4,1,1,6
1515915625607474982,9,1,55.87,4,1,2,7
1515915625607475851,10,1,48.84,4,1,2,7
1515915625607479843,10,1,82.97,4,1,2,7
1515915625607482956,10,3,1036.32,4,3,4,11
1515915625607484036,10,1,9.35,4,1,1,6
1515915625607486828,10,1,27.89,4,1,1,6
1515915625607487647,10,1,82.97,4,1,2,7
1515915625607497686,10,1,199.37,4,1,3,8
1515915625607504125,6,1,80.03,4,1,2,7
1515915625607505819,10,1,76.57,4,1,2,7
1515915625607508850,10,1,298.76,4,1,4,9
1515915625607509575,10,1,15.1,4,1,1,6
1515915625607510811,10,1,15.1,4,1,1,6
1515915625607512279,9,1,29.37,4,1,1,6
1515915625607512486,10,1,166.24,4,1,3,8
1515915625607518670,10,2,460.96,4,2,4,10
1515915625607522638,9,3,130.71,4,3,3,10
1515915625607523982,10,1,839.75,4,1,4,9
1515915625607524455,10,1,839.75,4,1,4,9
1515915625607526553,10,1,21.86,4,1,1,6
1515915625607528680,10,3,561.87,4,3,4,11
1515915625607550596,10,1,251.4,4,1,3,8
1515915625607551370,10,1,82.97,4,1,2,7
1515915625607562248,9,1,672.63,4,1,4,9
1515915625607567790,9,2,149.68,4,2,3,9
1515915625607574624,9,1,32.22,4,1,1,6
1515915625607584189,9,1,82.52,4,1,2,7
1515915625607591893,9,1,127.08,4,1,3,8
1515915625607595168,9,2,38.33,4,2,2,8
1515915625607596803,9,1,10.35,4,1,1,6
1515915625607604655,9,1,331.59,4,1,4,9
1515915625607608379,9,1,12.51,4,1,1,6
1515915625607609458,9,1,458.51,4,1,4,9
1515915625607611913,9,1,62.32,4,1,2,7
1515915625607614357,9,1,214.1,4,1,3,8
1515915625607617906,9,1,16.98,4,1,1,6
1515915625607619327,9,1,35.25,4,1,2,7
1515915625607622009,9,1,247.4,4,1,3,8
1515915625607623559,9,1,82.97,4,1,2,7
1515915625607624962,9,1,24.62,4,1,1,6
1515915625607631637,9,1,373.46,4,1,4,9
1515915625607633650,9,1,27.89,4,1,1,6
1515915625607634262,9,5,125.39999999999999,4,4,3,11
1515915625607639810,9,2,58.42,4,2,2,8
1515915625607640288,9,1,86.16,4,1,2,7
1515915625607649542,9,2,40.0,4,2,2,8
1515915625607653714,9,2,548.8,4,2,4,10
1515915625607655508,9,1,12.46,4,1,1,6
1515915625607657300,9,2,515.74,4,2,4,10
1515915625607664042,9,2,26.32,4,2,1,7
1515915625607664245,9,1,77.73,4,1,2,7
1515915625607667500,8,1,14.29,4,1,1,6
1515915625607667704,9,1,24.29,4,1,1,6
1515915625607668151,9,1,39.75,4,1,2,7
1515915625607670905,9,1,21.86,4,1,1,6
1515915625607675414,9,1,40.67,4,1,2,7
1515915625607675599,9,1,23.57,4,1,1,6
1515915625607676548,9,1,197.41,4,1,3,8
1515915625607681053,9,1,64.48,4,1,2,7
1515915625607685490,9,4,791.76,4,3,4,11
1515915625607688283,9,1,44.65,4,1,2,7
1515915625607689627,9,1,156.73,4,1,3,8
1515915625607692624,9,1,68.37,4,1,2,7
1515915625607696514,9,3,1578.65,4,3,4,11
1515915625607701805,9,4,806.16,4,3,4,11
1515915625607707401,9,1,60.83,4,1,2,7
1515915625607708047,9,1,17.3,4,1,1,6
1515915625607711735,9,2,142.7,4,2,3,9
1515915625607714004,9,1,486.81,4,1,4,9
1515915625607715277,9,1,10.32,4,1,1,6
1515915625607716989,9,2,86.96,4,2,2,8
1515915625607724962,9,1,122.86,4,1,3,8
1515915625607727506,7,4,212.68,4,3,3,10
1515915625607730605,9,1,12.38,4,1,1,6
1515915625607734229,9,1,167.0,4,1,3,8
1515915625607737452,6,1,122.86,4,1,3,8
1515915625607744618,9,1,43.11,4,1,2,7
1515915625607746475,9,1,83.49,4,1,2,7
1515915625607755696,9,1,9.16,4,1,1,6
1515915625607758353,9,1,75.76,4,1,2,7
1515915625607766850,9,2,46.26,4,2,2,8
1515915625607768027,7,2,124.74,4,2,3,9
1515915625607770622,9,1,377.46,4,1,4,9
1515915625607771050,9,1,32.83,4,1,2,7
1515915625607771690,2,1,486.81,4,1,4,9
1515915625607773789,9,1,612.6,4,1,4,9
1515915625607775360,9,1,27.89,4,1,1,6
1515915625607775842,9,1,20.16,4,1,1,6
1515915625607776395,9,2,570.92,4,2,4,10
1515915625607776914,9,6,584.28,4,4,4,12
1515915625607777852,9,1,214.1,4,1,3,8
1515915625607778569,9,1,285.46,4,1,3,8
1515915625607779402,9,1,968.83,4,1,4,9
1515915625607780315,7,1,204.29,4,1,3,8
1515915625607782428,9,1,415.54,4,1,4,9
1515915625607784962,9,1,32.38,4,1,2,7
1515915625607785641,8,3,302.25,4,3,4,11
1515915625607788188,5,2,428.2,4,2,4,10
1515915625607792477,9,2,935.0999999999999,4,2,4,10
1515915625607796836,9,1,15.08,4,1,1,6
1515915625607799938,9,1,144.51,4,1,3,8
1515915625607800341,9,6,752.64,4,4,4,12
1515915625607804101,9,2,44.16,4,2,2,8
1515915625607805031,6,1,346.44,4,1,4,9
1515915625607805338,9,3,1724.77,4,3,4,11
1515915625607807800,9,1,22.22,4,1,1,6
1515915625607807972,6,2,390.45,4,2,4,10
1515915625607808639,9,2,19.58,4,2,1,7
1515915625607809835,9,2,916.03,4,2,4,10
1515915625607811246,8,1,65.32,4,1,2,7
1515915625607812050,9,1,437.05,4,1,4,9
1515915625607812628,9,1,134.76,4,1,3,8
1515915625607815117,9,1,26.98,4,1,1,6
1515915625607817924,9,1,292.83,4,1,4,9
1515915625607820884,9,1,127.98,4,1,3,8
1515915625607822825,9,1,7.86,4,1,1,6
1515915625607848758,9,1,93.02,4,1,3,8
1515915625607851931,9,2,85.96,4,2,2,8
1515915625607855574,7,2,30.16,4,2,1,7
1515915625607856473,9,4,128.88,4,3,3,10
1515915625607857932,9,1,42.41,4,1,2,7
1515915625607858122,9,2,585.66,4,2,4,10
1515915625607858233,9,1,9.84,4,1,1,6
1515915625607865601,8,1,292.83,4,1,4,9
1515915625607866212,9,1,57.62,4,1,2,7
1515915625607867463,9,1,140.86,4,1,3,8
1515915625607870832,9,1,292.83,4,1,4,9
1515915625607872562,9,1,1.57,4,1,1,6
1515915625607874114,9,1,31.59,4,1,1,6
1515915625607875826,9,2,46.81,4,2,2,8
1515915625607876711,9,1,32.22,4,1,1,6
1515915625607879239,9,1,160.16,4,1,3,8
1515915625607879602,8,2,58.44,4,2,2,8
1515915625607880300,9,1,16.11,4,1,1,6
1515915625607883865,9,1,50.63,4,1,2,7
1515915625607897328,8,3,2383.18,4,3,4,11
1515915625607900829,8,2,401.39,4,2,4,10
1515915625607903259,8,1,32.22,4,1,1,6
1515915625607904839,8,1,10.43,4,1,1,6
1515915625607906383,8,2,973.62,4,2,4,10
1515915625607907639,8,2,498.34,4,2,4,10
1515915625607907745,8,3,155.25,4,3,3,10
1515915625607907983,8,1,214.1,4,1,3,8
1515915625607912156,8,2,25.4,4,2,1,7
1515915625607917445,8,1,11.43,4,1,1,6
1515915625607931742,8,2,73.34,4,2,2,8
1515915625607955069,8,1,624.62,4,1,4,9
1515915625607956252,8,3,86.03999999999999,4,3,2,9
1515915625607957485,8,1,34.44,4,1,2,7
1515915625607958212,8,2,101.26,4,2,3,9
1515915625607959120,8,1,257.87,4,1,3,8
1515915625607959940,8,1,11.11,4,1,1,6
1515915625607960884,8,1,515.56,4,1,4,9
1515915625607962933,8,1,43.11,4,1,2,7
1515915625607965771,8,2,128.96,4,2,3,9
1515915625607967000,8,1,466.52,4,1,4,9
1515915625607967672,8,1,161.3,4,1,3,8
1515915625607969817,8,2,102.66,4,2,3,9
1515915625607975540,8,1,50.21,4,1,2,7
1515915625607982503,8,1,60.54,4,1,2,7
1515915625607983678,8,1,56.27,4,1,2,7
1515915625607985029,8,1,38.83,4,1,2,7
1515915625607988732,7,24,2220.45,4,4,4,12
1515915625607990199,8,1,156.73,4,1,3,8
1515915625607995401,8,1,10.84,4,1,1,6
1515915625608001115,8,1,173.86,4,1,3,8
1515915625608001680,8,1,229.81,4,1,3,8
1515915625608002249,8,1,20.0,4,1,1,6
1515915625608003019,8,1,13.81,4,1,1,6
1515915625608004528,8,2,112.54,4,2,3,9
1515915625608006411,8,3,70.44,4,3,2,9
1515915625608010091,8,1,202.95,4,1,3,8
1515915625608010327,8,1,1.57,4,1,1,6
1515915625608010370,8,1,63.98,4,1,2,7
1515915625608012211,8,1,486.81,4,1,4,9
1515915625608012522,8,1,50.63,4,1,2,7
1515915625608012901,8,1,373.02,4,1,4,9
1515915625608017236,8,2,232.0,4,2,3,9
1515915625608017709,8,2,155.46,4,2,3,9
1515915625608019020,8,1,126.68,4,1,3,8
1515915625608019359,8,1,72.83,4,1,2,7
1515915625608021995,8,1,51.3,4,1,2,7
1515915625608024102,8,1,51.33,4,1,2,7
1515915625608024265,8,1,23.9,4,1,1,6
1515915625608025293,8,1,15.9,4,1,1,6
1515915625608026838,8,1,87.16,4,1,2,7
1515915625608027222,8,1,292.83,4,1,4,9
1515915625608027408,7,3,616.97,4,3,4,11
1515915625608029750,8,1,292.83,4,1,4,9
1515915625608029847,8,1,164.33,4,1,3,8
1515915625608031096,4,3,492.99,4,3,4,11
1515915625608031645,8,1,415.54,4,1,4,9
1515915625608032591,8,2,585.66,4,2,4,10
1515915625608035062,8,1,82.33,4,1,2,7
1515915625608040370,8,2,585.66,4,2,4,10
1515915625608041511,8,1,1.57,4,1,1,6
1515915625608042531,8,2,37.12,4,2,2,8
1515915625608043844,8,1,15.0,4,1,1,6
1515915625608050361,8,1,292.83,4,1,4,9
1515915625608055843,8,1,203.29,4,1,3,8
1515915625608060552,8,2,214.44,4,2,3,9
1515915625608062481,8,1,27.84,4,1,1,6
1515915625608063559,8,1,292.83,4,1,4,9
1515915625608066763,4,5,1805.31,4,4,4,12
1515915625608067177,8,1,132.67,4,1,3,8
1515915625608069254,8,4,211.44,4,3,3,10
1515915625608071527,8,1,35.25,4,1,2,7
1515915625608071658,8,1,210.9,4,1,3,8
1515915625608075790,8,1,38.83,4,1,2,7
1515915625608078894,7,1,490.54,4,1,4,9
1515915625608081372,8,1,73.81,4,1,2,7
1515915625608081978,8,1,146.92,4,1,3,8
1515915625608083729,8,3,1159.42,4,3,4,11
1515915625608084739,8,1,38.83,4,1,2,7
1515915625608085141,1,1,187.29,4,1,3,8
1515915625608086273,3,10,1643.3000000000002,4,4,4,12
1515915625608087894,8,1,50.33,4,1,2,7
1515915625608092942,8,2,242.38,4,2,3,9
1515915625608093487,8,1,609.6,4,1,4,9
1515915625608097306,8,1,52.33,4,1,2,7
1515915625608098166,8,1,20.0,4,1,1,6
1515915625608098724,8,1,11.7,4,1,1,6
1515915625608103298,8,2,37.46,4,2,2,8
1515915625608104905,8,1,797.71,4,1,4,9
1515915625608106515,8,2,102.66,4,2,3,9
1515915625608108508,7,1,146.65,4,1,3,8
1515915625608124801,8,3,233.19,4,3,3,10
1515915625608125735,8,1,22.08,4,1,1,6
1515915625608127112,8,4,69.0,4,3,2,9
1515915625608132929,8,1,797.71,4,1,4,9
1515915625608134042,8,1,172.89,4,1,3,8
1515915625608134071,8,2,129.78,4,2,3,9
1515915625608137070,6,2,588.82,4,2,4,10
1515915625608138852,8,1,397.48,4,1,4,9
1515915625608141702,8,1,73.32,4,1,2,7
1515915625608144011,8,1,52.22,4,1,2,7
1515915625608147469,8,1,490.54,4,1,4,9
1515915625608147917,8,1,292.83,4,1,4,9
1515915625608148455,2,1,106.52,4,1,3,8
1515915625608148879,8,5,1838.2400000000002,4,4,4,12
1515915625608149080,8,1,14.6,4,1,1,6
1515915625608151557,8,2,400.7,4,2,4,10
1515915625608153373,8,1,226.84,4,1,3,8
1515915625608154728,7,3,66.24,4,3,2,9
1515915625608158350,7,2,102.66,4,2,3,9
1515915625608158968,8,1,482.52,4,1,4,9
1515915625608161603,2,4,40.2,4,3,2,9
1515915625608161695,8,1,336.57,4,1,4,9
1515915625608161881,7,1,75.29,4,1,2,7
1515915625608162980,8,1,41.11,4,1,2,7
1515915625608163896,8,2,82.22,4,2,2,8
1515915625608164747,8,1,114.59,4,1,3,8
1515915625608165056,8,1,21.43,4,1,1,6
1515915625608165230,8,1,80.51,4,1,2,7
1515915625608167862,8,2,175.12,4,2,3,9
1515915625608168442,8,1,50.11,4,1,2,7
1515915625608170997,3,1,16.62,4,1,1,6
1515915625608173543,8,1,205.25,4,1,3,8
1515915625608173847,8,1,461.52,4,1,4,9
1515915625608175743,8,4,79.12,4,3,2,9
1515915625608176398,4,5,339.25,4,4,4,12
1515915625608177802,7,1,449.51,4,1,4,9
1515915625608182056,8,1,163.48,4,1,3,8
1515915625608182060,8,1,352.68,4,1,4,9
1515915625608182781,8,2,70.5,4,2,2,8
1515915625608182916,8,1,397.48,4,1,4,9
1515915625608185627,8,1,15.1,4,1,1,6
1515915625608185826,8,1,38.3,4,1,2,7
1515915625608186807,8,1,214.1,4,1,3,8
1515915625608191496,8,1,214.1,4,1,3,8
1515915625608192459,8,1,210.0,4,1,3,8
1515915625608194831,8,1,36.14,4,1,2,7
1515915625608197036,8,1,105.4,4,1,3,8
1515915625608197744,8,2,69.12,4,2,2,8
1515915625608198285,8,3,203.37,4,3,3,10
1515915625608199229,8,1,87.16,4,1,2,7
1515915625608199642,8,5,1056.82,4,4,4,12
1515915625608205783,8,1,397.48,4,1,4,9
1515915625608206068,8,6,2877.06,4,4,4,12
1515915625608215151,8,4,195.36,4,3,3,10
1515915625608221586,8,1,292.83,4,1,4,9
1515915625608221875,8,1,48.84,4,1,2,7
1515915625608224601,8,1,127.08,4,1,3,8
1515915625608232393,8,1,82.97,4,1,2,7
1515915625608232843,8,1,219.97,4,1,3,8
1515915625608239662,8,1,11.9,4,1,1,6
1515915625608245349,8,1,64.46,4,1,2,7
1515915625608254315,8,1,471.52,4,1,4,9
1515915625608256477,8,1,213.11,4,1,3,8
1515915625608257030,8,1,600.6,4,1,4,9
1515915625608257776,7,3,1748.23,4,3,4,11
1515915625608267106,7,1,164.33,4,1,3,8
1515915625608270362,7,1,609.6,4,1,4,9
1515915625608274092,7,3,121.56,4,3,3,10
1515915625608276117,7,4,100.32,4,3,3,10
1515915625608279415,7,1,38.83,4,1,2,7
1515915625608290334,7,2,794.96,4,2,4,10
1515915625608293453,7,1,296.4,4,1,4,9
1515915625608306609,7,1,15.1,4,1,1,6
1515915625608310346,7,2,521.25,4,2,4,10
1515915625608310530,7,2,64.44,4,2,2,8
1515915625608311061,7,1,38.83,4,1,2,7
1515915625608313159,7,2,34.86,4,2,2,8
1515915625608313510,7,1,226.84,4,1,3,8
1515915625608313899,7,1,31.41,4,1,1,6
1515915625608314228,7,2,32.88,4,2,2,8
1515915625608315686,6,2,209.72,4,2,3,9
1515915625608316740,7,5,1224.93,4,4,4,12
1515915625608317454,7,1,136.92,4,1,3,8
1515915625608319891,7,1,20.14,4,1,1,6
1515915625608327904,7,1,187.29,4,1,3,8
1515915625608328456,7,1,187.29,4,1,3,8
1515915625608340085,7,1,58.24,4,1,2,7
1515915625608341845,7,1,124.73,4,1,3,8
1515915625608351631,7,2,59.36,4,2,2,8
1515915625608355420,7,1,797.71,4,1,4,9
1515915625608365786,7,1,251.4,4,1,3,8
1515915625608368198,7,1,11.7,4,1,1,6
1515915625608375457,7,6,232.98,4,4,3,11
1515915625608376232,7,1,397.48,4,1,4,9
1515915625608378471,7,1,14.21,4,1,1,6
1515915625608380763,7,2,164.66,4,2,3,9
1515915625608382114,7,2,161.34,4,2,3,9
1515915625608383392,7,3,1374.56,4,3,4,11
1515915625608383556,7,1,87.3,4,1,2,7
1515915625608384306,7,1,29.22,4,1,1,6
1515915625608384847,7,1,64.48,4,1,2,7
1515915625608387286,7,2,276.48,4,2,3,9
1515915625608387707,4,1,449.51,4,1,4,9
1515915625608400004,7,4,467.48,4,3,4,11
1515915625608400258,7,1,23.65,4,1,1,6
1515915625608402238,7,1,14.6,4,1,1,6
1515915625608406811,6,1,140.02,4,1,3,8
1515915625608417137,7,1,264.4,4,1,3,8
1515915625608420500,7,1,23.14,4,1,1,6
1515915625608423061,7,1,457.51,4,1,4,9
1515915625608424028,7,1,144.51,4,1,3,8
1515915625608429917,7,3,104.09,4,3,3,10
1515915625608431231,7,1,20.0,4,1,1,6
1515915625608431991,7,1,591.59,4,1,4,9
1515915625608432929,6,2,374.58,4,2,4,10
1515915625608433887,7,1,415.54,4,1,4,9
1515915625608439301,7,6,3029.09,4,4,4,12
1515915625608442311,7,1,176.17,4,1,3,8
1515915625608444856,7,2,1006.3699999999999,4,2,4,10
1515915625608448376,7,1,292.83,4,1,4,9
1515915625608448836,7,1,23.9,4,1,1,6
1515915625608451132,7,1,48.84,4,1,2,7
1515915625608453492,7,1,322.57,4,1,4,9
1515915625608456482,5,2,360.88,4,2,4,10
1515915625608456793,7,1,284.46,4,1,3,8
1515915625608459748,7,1,96.19,4,1,3,8
1515915625608461262,7,1,836.76,4,1,4,9
1515915625608469297,7,1,82.97,4,1,2,7
1515915625608477756,5,2,65.42,4,2,2,8
1515915625608477991,7,2,585.66,4,2,4,10
1515915625608480733,7,2,52.38,4,2,2,8
1515915625608486237,7,1,27.62,4,1,1,6
1515915625608487365,7,1,486.81,4,1,4,9
1515915625608487377,7,3,34.29,4,3,2,9
1515915625608502389,7,2,461.68999999999994,4,2,4,10
1515915625608507512,7,1,1.57,4,1,1,6
1515915625608513164,7,1,115.4,4,1,3,8
1515915625608513470,5,2,221.9,4,2,3,9
1515915625608514475,7,4,77.48,4,3,2,9
1515915625608514997,7,2,78.12,4,2,2,8
1515915625608518965,7,1,46.67,4,1,2,7
1515915625608521371,7,1,24.44,4,1,1,6
1515915625608522188,7,1,82.97,4,1,2,7
1515915625608525963,1,6,1219.26,4,4,4,12
1515915625608528148,7,1,59.84,4,1,2,7
1515915625608533995,7,2,174.32,4,2,3,9
1515915625608539578,7,1,46.94,4,1,2,7
1515915625608547805,7,2,165.94,4,2,3,9
1515915625608548538,7,1,122.4,4,1,3,8
1515915625608554448,7,1,82.97,4,1,2,7
1515915625608555607,7,14,246.77,4,4,3,11
1515915625608555753,7,1,31.59,4,1,1,6
1515915625608557474,7,2,973.62,4,2,4,10
1515915625608568237,7,1,17.62,4,1,1,6
1515915625608572470,7,2,568.92,4,2,4,10
1515915625608572717,7,1,9.22,4,1,1,6
1515915625608574274,7,1,599.6,4,1,4,9
1515915625608575588,7,1,176.17,4,1,3,8
1515915625608576683,7,2,204.23999999999998,4,2,3,9
1515915625608580353,7,1,26.17,4,1,1,6
1515915625608581600,7,2,101.14,4,2,3,9
1515915625608583678,7,1,94.06,4,1,3,8
1515915625608588481,6,1,33.19,4,1,2,7
1515915625608592569,6,1,82.97,4,1,2,7
1515915625608592758,6,2,1653.72,4,2,4,10
1515915625608593756,7,2,2550.04,4,2,4,10
1515915625608595181,7,1,228.79,4,1,3,8
1515915625608595586,7,1,839.75,4,1,4,9
1515915625608599841,7,1,577.6,4,1,4,9
1515915625608602069,7,1,294.41,4,1,4,9
1515915625608602089,7,1,214.1,4,1,3,8
1515915625608607079,7,2,1080.12,4,2,4,10
1515915625608607368,7,1,214.1,4,1,3,8
1515915625608609561,6,4,1279.85,4,3,4,11
1515915625608617934,6,1,449.51,4,1,4,9
1515915625608626119,4,2,203.9,4,2,3,9
1515915625608626412,6,2,113.34,4,2,3,9
1515915625608627422,6,4,1401.82,4,3,4,11
1515915625608633669,6,4,856.4,4,3,4,11
1515915625608634046,6,2,335.24,4,2,4,10
1515915625608636802,6,1,218.98,4,1,3,8
1515915625608644523,6,1,214.1,4,1,3,8
1515915625608649875,6,1,46.67,4,1,2,7
1515915625608655242,6,1,101.06,4,1,3,8
1515915625608658454,6,1,24.6,4,1,1,6
1515915625608659271,5,2,334.0,4,2,4,10
1515915625608659731,6,2,473.94,4,2,4,10
1515915625608659814,6,1,19.52,4,1,1,6
1515915625608665197,2,2,299.94,4,2,4,10
1515915625608665502,6,3,157.47,4,3,3,10
1515915625608666365,6,3,1606.09,4,3,4,11
1515915625608666462,1,1,103.83,4,1,3,8
1515915625608674801,6,1,614.6,4,1,4,9
1515915625608680406,6,1,32.22,4,1,1,6
1515915625608680858,6,2,95.83000000000001,4,2,3,9
1515915625608681508,6,2,28.25,4,2,1,7
1515915625608686802,6,1,29.68,4,1,1,6
1515915625608688117,6,2,30.16,4,2,1,7
1515915625608690310,6,1,104.92,4,1,3,8
1515915625608690758,6,1,24.76,4,1,1,6
1515915625608693532,6,1,16.51,4,1,1,6
1515915625608696119,6,1,19.84,4,1,1,6
1515915625608698567,6,1,29.22,4,1,1,6
1515915625608700166,6,3,39.87,4,3,2,9
1515915625608710961,6,1,127.08,4,1,3,8
1515915625608712541,6,2,33.96,4,2,2,8
1515915625608717009,6,1,294.41,4,1,4,9
1515915625608717221,6,1,839.75,4,1,4,9
1515915625608721191,6,5,1070.5,4,4,4,12
1515915625608722244,6,2,46.96,4,2,2,8
1515915625608722766,6,1,21.27,4,1,1,6
1515915625608722861,6,2,519.88,4,2,4,10
1515915625608723869,6,3,1744.19,4,3,4,11
1515915625608726989,6,1,880.78,4,1,4,9
1515915625608728253,6,1,14.05,4,1,1,6
1515915625608729359,6,2,162.64,4,2,3,9
1515915625608734875,6,1,397.48,4,1,4,9
1515915625608736592,6,1,373.46,4,1,4,9
1515915625608736823,6,1,600.6,4,1,4,9
1515915625608743586,4,1,58.24,4,1,2,7
1515915625608754857,6,1,17.44,4,1,1,6
1515915625608758157,6,1,54.89,4,1,2,7
1515915625608758482,5,3,1531.6200000000001,4,3,4,11
1515915625608758597,5,1,51.68,4,1,2,7
1515915625608759438,6,1,1152.97,4,1,4,9
1515915625608759933,6,1,72.83,4,1,2,7
1515915625608762581,6,1,839.75,4,1,4,9
1515915625608765310,6,1,23.9,4,1,1,6
1515915625608765472,6,1,88.33,4,1,2,7
1515915625608767570,6,2,235.5,4,2,3,9
1515915625608767771,6,1,193.63,4,1,3,8
1515915625608767829,6,4,1532.62,4,3,4,11
1515915625608777565,6,1,202.67,4,1,3,8
1515915625608782624,6,1,449.51,4,1,4,9
1515915625608784695,6,1,600.6,4,1,4,9
1515915625608785534,5,6,879.9000000000001,4,4,4,12
1515915625608788153,3,2,853.99,4,2,4,10
1515915625608790570,6,1,17.19,4,1,1,6
1515915625608792081,6,2,11.72,4,2,1,7
1515915625608796336,6,3,1284.56,4,3,4,11
1515915625608796382,6,1,87.16,4,1,2,7
1515915625608797559,6,1,9.92,4,1,1,6
1515915625608802929,6,1,214.1,4,1,3,8
1515915625608803916,6,3,642.3,4,3,4,11
1515915625608806337,6,7,412.02,4,4,4,12
1515915625608807965,6,1,9.84,4,1,1,6
1515915625608809611,6,2,19.68,4,2,1,7
1515915625608816521,6,1,449.51,4,1,4,9
1515915625608823019,6,1,64.89,4,1,2,7
1515915625608828862,5,3,66.66,4,3,2,9
1515915625608829849,6,1,33.19,4,1,2,7
1515915625608831050,5,2,52.38,4,2,2,8
1515915625608831538,6,2,166.98,4,2,3,9
1515915625608833662,6,1,11.86,4,1,1,6
1515915625608833920,6,1,9.92,4,1,1,6
1515915625608836382,6,1,486.81,4,1,4,9
1515915625608840409,4,5,1794.52,4,4,4,12
1515915625608847065,6,1,64.89,4,1,2,7
1515915625608848140,6,2,64.44,4,2,2,8
1515915625608849102,6,10,246.0,4,4,3,11
1515915625608849452,6,1,58.24,4,1,2,7
1515915625608850440,6,3,615.49,4,3,4,11
1515915625608851702,6,1,14.6,4,1,1,6
1515915625608852605,6,1,34.44,4,1,2,7
1515915625608855187,6,1,41.37,4,1,2,7
1515915625608857113,6,1,519.56,4,1,4,9
1515915625608857123,6,8,2355.28,4,4,4,12
1515915625608860828,6,1,35.87,4,1,2,7
1515915625608863445,6,1,118.57,4,1,3,8
1515915625608871140,6,1,839.75,4,1,4,9
1515915625608880491,6,1,81.92,4,1,2,7
1515915625608881755,6,1,78.3,4,1,2,7
1515915625608889683,6,2,30.5,4,2,1,7
1515915625608890601,6,3,23.310000000000002,4,3,1,8
1515915625608902255,6,1,539.57,4,1,4,9
1515915625608903457,6,1,220.52,4,1,3,8
1515915625608908834,6,1,15.08,4,1,1,6
1515915625608911449,6,1,23.7,4,1,1,6
1515915625608912542,6,1,49.3,4,1,2,7
1515915625608913566,6,1,481.54,4,1,4,9
1515915625608914340,6,1,104.86,4,1,3,8
1515915625608931912,5,1,77.73,4,1,2,7
1515915625608935847,5,4,1114.42,4,3,4,11
1515915625608938289,6,1,19.37,4,1,1,6
1515915625608939386,5,8,2692.7400000000002,4,4,4,12
1515915625608942796,5,6,1280.49,4,4,4,12
1515915625608951379,5,1,16.67,4,1,1,6
1515915625608953653,5,1,87.16,4,1,2,7
1515915625608960831,3,1,32.06,4,1,1,6
1515915625608960984,5,1,32.06,4,1,1,6
1515915625608964366,5,1,214.1,4,1,3,8
1515915625608979128,5,1,164.33,4,1,3,8
1515915625608982064,4,1,100.32,4,1,3,8
1515915625608984671,5,1,257.87,4,1,3,8
1515915625608993377,5,3,204.29999999999998,4,3,3,10
1515915625608996412,5,2,440.0,4,2,4,10
1515915625608997295,5,2,11.73,4,2,1,7
1515915625608998302,5,2,1087.41,4,2,4,10
1515915625608999017,5,1,294.41,4,1,4,9
1515915625609002914,5,1,29.06,4,1,1,6
1515915625609004225,3,2,47.04,4,2,2,8
1515915625609007010,5,1,222.7,4,1,3,8
1515915625609007360,5,1,58.86,4,1,2,7
1515915625609016823,5,1,164.33,4,1,3,8
1515915625609017318,5,4,162.85999999999999,4,3,3,10
1515915625609017367,5,2,157.42,4,2,3,9
1515915625609017994,5,3,332.85,4,3,4,11
1515915625609018846,1,1,43.33,4,1,2,7
1515915625609022367,5,3,100.94999999999999,4,3,3,10
1515915625609023829,5,1,72.38,4,1,2,7
1515915625609025059,5,1,16.19,4,1,1,6
1515915625609025399,5,1,63.35,4,1,2,7
1515915625609026326,5,1,14.37,4,1,1,6
1515915625609026523,5,1,486.81,4,1,4,9
1515915625609030903,3,2,515.74,4,2,4,10
1515915625609035067,5,1,31.89,4,1,1,6
1515915625609038645,5,1,236.97,4,1,3,8
1515915625609044091,5,3,96.66,4,3,3,10
1515915625609047424,5,1,397.48,4,1,4,9
1515915625609055093,5,1,8.7,4,1,1,6
1515915625609060331,5,1,519.56,4,1,4,9
1515915625609064704,5,1,456.51,4,1,4,9
1515915625609066619,5,4,66.6,4,3,2,9
1515915625609067451,5,1,599.6,4,1,4,9
1515915625609071422,5,1,226.84,4,1,3,8
1515915625609072499,5,2,21.68,4,2,1,7
1515915625609072806,5,1,26.19,4,1,1,6
1515915625609076006,5,1,33.97,4,1,2,7
1515915625609078384,5,1,73.81,4,1,2,7
1515915625609080510,5,3,91.14,4,3,3,10
1515915625609087259,5,3,159.18,4,3,3,10
1515915625609087596,5,1,28.1,4,1,1,6
1515915625609088163,5,2,794.96,4,2,4,10
1515915625609089453,5,1,93.43,4,1,3,8
1515915625609097614,5,1,18.41,4,1,1,6
1515915625609097769,5,1,34.29,4,1,2,7
1515915625609098531,5,1,35.87,4,1,2,7
1515915625609099543,5,1,33.08,4,1,2,7
1515915625609099573,1,2,19.68,4,2,1,7
1515915625609100971,5,1,490.54,4,1,4,9
1515915625609102341,5,1,16.33,4,1,1,6
1515915625609104471,5,2,266.44,4,2,3,9
1515915625609107462,5,1,93.43,4,1,3,8
1515915625609107481,3,2,193.72,4,2,3,9
1515915625609108013,5,1,100.75,4,1,3,8
1515915625609109704,5,1,136.29,4,1,3,8
1515915625609109859,5,1,1275.02,4,1,4,9
1515915625609109874,5,1,399.48,4,1,4,9
1515915625609116743,5,6,956.6700000000001,4,4,4,12
1515915625609117560,5,1,16.67,4,1,1,6
1515915625609118273,5,1,43.33,4,1,2,7
1515915625609118766,4,2,812.95,4,2,4,10
1515915625609120245,5,1,9.79,4,1,1,6
1515915625609125327,5,1,292.83,4,1,4,9
1515915625609125826,5,2,44.8,4,2,2,8
1515915625609127008,4,1,158.57,4,1,3,8
1515915625609129405,5,2,598.82,4,2,4,10
1515915625609129791,5,1,23.81,4,1,1,6
1515915625609130385,3,4,856.4,4,3,4,11
1515915625609133908,5,1,110.95,4,1,3,8
1515915625609135146,5,1,49.3,4,1,2,7
1515915625609138973,5,3,107.69999999999999,4,3,3,10
1515915625609139414,5,1,85.24,4,1,2,7
1515915625609144903,5,1,12.08,4,1,1,6
1515915625609148744,5,1,29.52,4,1,1,6
1515915625609150425,5,1,48.27,4,1,2,7
1515915625609151795,4,2,117.42,4,2,3,9
1515915625609153632,5,6,1082.6399999999999,4,4,4,12
1515915625609156684,5,1,35.08,4,1,2,7
1515915625609159480,5,1,880.78,4,1,4,9
1515915625609162711,5,1,140.86,4,1,3,8
1515915625609163583,5,1,11.11,4,1,1,6
1515915625609169557,5,2,90.48,4,2,2,8
1515915625609169707,5,1,41.51,4,1,2,7
1515915625609171154,5,1,49.3,4,1,2,7
1515915625609175345,5,1,292.83,4,1,4,9
1515915625609176612,5,2,32.38,4,2,2,8
1515915625609182918,5,1,140.86,4,1,3,8
1515915625609183926,5,2,47.04,4,2,2,8
1515915625609184503,5,3,1348.53,4,3,4,11
1515915625609186176,5,4,616.91,4,3,4,11
1515915625609186369,5,1,214.1,4,1,3,8
1515915625609188211,5,1,75.76,4,1,2,7
1515915625609191317,5,2,848.99,4,2,4,10
1515915625609193296,5,1,53.06,4,1,2,7
1515915625609198186,5,1,9.35,4,1,1,6
1515915625609201682,5,1,187.29,4,1,3,8
1515915625609204071,5,1,52.06,4,1,2,7
1515915625609205538,5,2,388.83,4,2,4,10
1515915625609205548,4,1,187.29,4,1,3,8
1515915625609208815,5,1,251.4,4,1,3,8
1515915625609210381,5,1,251.4,4,1,3,8
1515915625609213816,3,1,63.02,4,1,2,7
1515915625609215527,5,1,177.95,4,1,3,8
1515915625609215614,5,2,82.86,4,2,2,8
1515915625609220746,5,1,202.67,4,1,3,8
1515915625609236087,5,5,996.85,4,4,4,12
1515915625609237074,5,3,431.90999999999997,4,3,4,11
1515915625609242043,5,1,166.02,4,1,3,8
1515915625609243074,5,2,457.58,4,2,4,10
1515915625609244593,5,1,9.92,4,1,1,6
1515915625609245096,5,2,1087.41,4,2,4,10
1515915625609245368,5,3,121.89000000000001,4,3,3,10
1515915625609246373,5,2,919.04,4,2,4,10
1515915625609251659,5,1,16.67,4,1,1,6
1515915625609252644,5,1,177.95,4,1,3,8
1515915625609257558,5,1,33.97,4,1,2,7
1515915625609258913,5,1,292.83,4,1,4,9
1515915625609261855,4,1,222.92,4,1,3,8
1515915625609263035,5,1,11.9,4,1,1,6
1515915625609265999,5,8,198.07999999999998,4,4,3,11
1515915625609266197,4,17,99.15,4,4,3,11
1515915625609268435,5,2,457.58,4,2,4,10
1515915625609276856,5,1,164.33,4,1,3,8
1515915625609278253,5,1,102.46,4,1,3,8
1515915625609284065,5,1,34.51,4,1,2,7
1515915625609285703,5,1,32.7,4,1,2,7
1515915625609285766,5,1,192.51,4,1,3,8
1515915625609299107,4,1,15.08,4,1,1,6
1515915625609301600,4,1,292.83,4,1,4,9
1515915625609309766,4,3,944.9100000000001,4,3,4,11
1515915625609313921,2,2,347.72,4,2,4,10
1515915625609314112,4,1,214.1,4,1,3,8
1515915625609318164,4,1,397.48,4,1,4,9
1515915625609318231,4,2,86.22,4,2,2,8
1515915625609319827,4,1,88.25,4,1,2,7
1515915625609325675,4,2,888.02,4,2,4,10
1515915625609327687,3,3,355.71,4,3,4,11
1515915625609330802,4,2,166.98,4,2,3,9
1515915625609331622,4,1,32.7,4,1,2,7
1515915625609336814,4,4,331.88,4,3,4,11
1515915625609344531,4,1,36.14,4,1,2,7
1515915625609345001,4,1,1.57,4,1,1,6
1515915625609346255,4,1,32.22,4,1,1,6
1515915625609346272,4,1,214.1,4,1,3,8
1515915625609347426,4,1,140.86,4,1,3,8
1515915625609347795,2,1,266.56,4,1,3,8
1515915625609350526,4,1,82.97,4,1,2,7
1515915625609355286,4,1,8.57,4,1,1,6
1515915625609355678,4,1,73.65,4,1,2,7
1515915625609355843,4,1,118.57,4,1,3,8
1515915625609359207,4,1,397.48,4,1,4,9
1515915625609367014,4,3,248.91,4,3,3,10
1515915625609367306,4,1,21.9,4,1,1,6
1515915625609370289,4,2,1620.44,4,2,4,10
1515915625609373060,4,1,31.68,4,1,1,6
1515915625609375586,4,3,1142.02,4,3,4,11
1515915625609376118,4,1,74.84,4,1,2,7
1515915625609383681,4,1,294.41,4,1,4,9
1515915625609385053,4,2,67.94,4,2,2,8
1515915625609385716,4,3,722.95,4,3,4,11
1515915625609388251,2,1,14.6,4,1,1,6
1515915625609395182,3,2,570.92,4,2,4,10
1515915625609396964,4,1,257.87,4,1,3,8
1515915625609402434,4,1,15.65,4,1,1,6
1515915625609403497,4,2,1089.13,4,2,4,10
1515915625609409263,4,1,23.9,4,1,1,6
1515915625609409722,4,1,481.54,4,1,4,9
1515915625609410801,4,1,144.49,4,1,3,8
1515915625609411662,4,1,55.87,4,1,2,7
1515915625609413362,4,1,120.86,4,1,3,8
1515915625609417292,4,1,61.27,4,1,2,7
1515915625609417895,4,1,21.21,4,1,1,6
1515915625609418279,4,1,30.16,4,1,1,6
1515915625609418292,4,1,600.6,4,1,4,9
1515915625609419047,4,1,176.17,4,1,3,8
1515915625609426747,4,2,587.24,4,2,4,10
1515915625609434429,4,1,415.54,4,1,4,9
1515915625609439626,3,1,64.48,4,1,2,7
1515915625609439892,4,1,18.57,4,1,1,6
1515915625609441788,4,1,479.51,4,1,4,9
1515915625609442757,4,1,331.59,4,1,4,9
1515915625609442762,4,1,214.1,4,1,3,8
1515915625609445971,4,1,9.35,4,1,1,6
1515915625609449186,4,2,976.04,4,2,4,10
1515915625609457670,4,1,205.25,4,1,3,8
1515915625609462913,4,1,264.4,4,1,3,8
1515915625609465441,4,1,149.05,4,1,3,8
1515915625609469890,4,1,603.62,4,1,4,9
1515915625609472297,4,1,524.92,4,1,4,9
1515915625609477310,4,1,77.73,4,1,2,7
1515915625609478254,4,4,1383.7800000000002,4,3,4,11
1515915625609479176,4,1,21.43,4,1,1,6
1515915625609479383,4,2,498.08,4,2,4,10
1515915625609480528,4,6,641.5200000000001,4,4,4,12
1515915625609486175,4,1,609.6,4,1,4,9
1515915625609487061,4,2,155.4,4,2,3,9
1515915625609487312,4,1,70.6,4,1,2,7
1515915625609493326,4,2,21.58,4,2,1,7
1515915625609501306,4,1,16.67,4,1,1,6
1515915625609502179,4,1,399.48,4,1,4,9
1515915625609502967,4,1,115.24,4,1,3,8
1515915625609503575,4,2,116.27,4,2,3,9
1515915625609511796,2,1,298.32,4,1,4,9
1515915625609517882,4,1,312.43,4,1,4,9
1515915625609519993,4,1,12.22,4,1,1,6
1515915625609524730,3,2,337.76,4,2,4,10
1515915625609530533,4,2,111.74,4,2,3,9
1515915625609530652,1,1,1275.02,4,1,4,9
1515915625609530721,4,1,608.95,4,1,4,9
1515915625609536658,4,2,70.2,4,2,2,8
1515915625609538555,4,1,127.08,4,1,3,8
1515915625609541997,4,1,56.14,4,1,2,7
1515915625609542852,4,1,56.14,4,1,2,7
1515915625609543729,4,2,707.03,4,2,4,10
1515915625609544059,4,1,397.48,4,1,4,9
1515915625609546764,4,2,679.02,4,2,4,10
1515915625609548122,4,1,22.86,4,1,1,6
1515915625609548272,4,1,292.83,4,1,4,9
1515915625609557656,4,1,205.32,4,1,3,8
1515915625609558575,4,1,214.1,4,1,3,8
1515915625609560574,4,6,511.43999999999994,4,4,4,12
1515915625609564185,4,1,202.67,4,1,3,8
1515915625609564314,4,2,546.5,4,2,4,10
1515915625609564672,4,1,292.83,4,1,4,9
1515915625609564819,4,2,7.08,4,2,1,7
1515915625609565147,4,1,839.75,4,1,4,9
1515915625609566135,4,1,600.6,4,1,4,9
1515915625609566988,4,1,839.75,4,1,4,9
1515915625609568142,4,1,587.6,4,1,4,9
1515915625609568165,1,1,103.83,4,1,3,8
1515915625609570586,4,1,449.51,4,1,4,9
1515915625609570846,4,3,1476.6200000000001,4,3,4,11
1515915625609571114,4,1,300.17,4,1,4,9
1515915625609572529,4,1,839.75,4,1,4,9
1515915625609577468,4,1,73.68,4,1,2,7
1515915625609586484,3,3,1396.97,4,3,4,11
1515915625609587362,4,1,95.95,4,1,3,8
1515915625609587906,4,1,219.97,4,1,3,8
1515915625609589314,3,1,105.87,4,1,3,8
1515915625609590348,4,1,490.54,4,1,4,9
1515915625609594829,4,1,52.63,4,1,2,7
1515915625609594957,4,1,229.38,4,1,3,8
1515915625609596205,4,1,16.67,4,1,1,6
1515915625609598425,4,1,1.57,4,1,1,6
1515915625609598535,4,2,1144.16,4,2,4,10
1515915625609599926,4,1,415.54,4,1,4,9
1515915625609601105,4,2,40.76,4,2,2,8
1515915625609602041,4,1,59.32,4,1,2,7
1515915625609605412,4,1,909.79,4,1,4,9
1515915625609612665,4,2,812.12,4,2,4,10
1515915625609613473,4,1,277.1,4,1,3,8
1515915625609614430,4,1,292.83,4,1,4,9
1515915625609615378,4,5,4430.91,4,4,4,12
1515915625609624754,4,1,797.71,4,1,4,9
1515915625609628217,4,1,13.65,4,1,1,6
1515915625609629407,4,1,292.83,4,1,4,9
1515915625609630600,4,2,951.04,4,2,4,10
1515915625609632644,4,1,839.75,4,1,4,9
1515915625609639729,4,2,134.6,4,2,3,9
1515915625609640514,4,3,1588.69,4,3,4,11
1515915625609642180,4,1,24.6,4,1,1,6
1515915625609642572,4,1,471.52,4,1,4,9
1515915625609643265,4,1,839.75,4,1,4,9
1515915625609644021,4,1,429.51,4,1,4,9
1515915625609646735,3,11,5332.96,4,4,4,12
1515915625609653103,3,1,397.48,4,1,4,9
1515915625609658303,3,1,496.54,4,1,4,9
1515915625609659073,3,1,292.83,4,1,4,9
1515915625609659085,2,1,18.73,4,1,1,6
1515915625609662664,3,3,55.230000000000004,4,3,2,9
1515915625609668340,3,1,26.19,4,1,1,6
1515915625609686443,3,1,441.49,4,1,4,9
1515915625609693273,3,1,5.16,4,1,1,6
1515915625609693916,3,1,38.83,4,1,2,7
1515915625609694216,3,1,399.48,4,1,4,9
1515915625609703876,3,1,38.83,4,1,2,7
1515915625609704625,3,1,134.46,4,1,3,8
1515915625609708338,3,1,1.57,4,1,1,6
1515915625609724006,3,1,214.1,4,1,3,8
1515915625609727567,3,1,32.22,4,1,1,6
1515915625609727876,3,1,203.29,4,1,3,8
1515915625609728233,3,1,18.48,4,1,1,6
1515915625609734411,3,1,198.38,4,1,3,8
1515915625609735157,3,8,1439.52,4,4,4,12
1515915625609736199,3,1,397.48,4,1,4,9
1515915625609742545,3,2,168.96,4,2,3,9
1515915625609743124,3,1,292.83,4,1,4,9
1515915625609745834,3,1,29.51,4,1,1,6
1515915625609752825,3,1,256.22,4,1,3,8
1515915625609806899,3,1,484.52,4,1,4,9
1515915625609836937,3,1,65.97,4,1,2,7
1515915625609850964,3,2,19.68,4,2,1,7
1515915625609862369,3,1,10.57,4,1,1,6
1515915625609866755,3,1,12.46,4,1,1,6
1515915625609891667,3,1,210.19,4,1,3,8
1515915625609899058,3,3,427.89,4,3,4,11
1515915625609900497,3,2,116.5,4,2,3,9
1515915625609900598,3,6,232.98,4,4,3,11
1515915625609900610,3,2,798.96,4,2,4,10
1515915625609907005,3,2,10.0,4,2,1,7
1515915625609912289,3,4,52.68,4,3,2,9
1515915625609912484,3,1,21.21,4,1,1,6
1515915625609912790,3,2,217.46,4,2,3,9
1515915625609915416,3,2,86.22,4,2,2,8
1515915625609915989,3,2,1595.42,4,2,4,10
1515915625609919575,3,4,563.44,4,3,4,11
1515915625609926891,3,1,26.57,4,1,1,6
1515915625609930771,3,1,486.81,4,1,4,9
1515915625609935428,3,1,34.65,4,1,2,7
1515915625609937992,3,2,44.44,4,2,2,8
1515915625609941058,3,1,839.75,4,1,4,9
1515915625609950510,3,2,315.04999999999995,4,2,4,10
1515915625609954330,3,1,9.35,4,1,1,6
1515915625609958211,3,1,486.81,4,1,4,9
1515915625609959138,3,2,568.8,4,2,4,10
1515915625609959699,2,1,36.17,4,1,2,7
1515915625609965835,3,1,294.41,4,1,4,9
1515915625609969839,3,2,585.66,4,2,4,10
1515915625609969979,3,1,16.19,4,1,1,6
1515915625609971822,3,1,17.52,4,1,1,6
1515915625609977515,3,1,34.44,4,1,2,7
1515915625609985654,3,1,496.54,4,1,4,9
1515915625609986397,3,1,29.84,4,1,1,6
1515915625609987625,3,2,880.0,4,2,4,10
1515915625609990572,3,2,254.96,4,2,3,9
1515915625609991559,3,1,577.6,4,1,4,9
1515915625609992287,3,1,26.19,4,1,1,6
1515915625609992293,3,1,35.54,4,1,2,7
1515915625609993941,3,1,25.73,4,1,1,6
1515915625609997727,3,1,397.48,4,1,4,9
1515915625609998584,3,1,36.14,4,1,2,7
1515915625610001809,3,2,20.64,4,2,1,7
1515915625610003510,3,1,42.7,4,1,2,7
1515915625610007707,3,1,127.08,4,1,3,8
1515915625610007912,3,2,110.32,4,2,3,9
1515915625610013446,3,1,397.48,4,1,4,9
1515915625610050339,3,1,102.11,4,1,3,8
1515915625610050729,2,4,104.76,4,3,3,10
1515915625610051466,2,2,26.44,4,2,1,7
1515915625610053906,3,1,16.83,4,1,1,6
1515915625610057486,2,1,59.14,4,1,2,7
1515915625610066256,3,1,30.48,4,1,1,6
1515915625610075570,3,1,34.9,4,1,2,7
1515915625610075840,3,1,397.48,4,1,4,9
1515915625610077131,3,1,27.62,4,1,1,6
1515915625610081429,3,1,283.33,4,1,3,8
1515915625610083104,3,1,38.83,4,1,2,7
1515915625610086203,3,1,151.75,4,1,3,8
1515915625610091451,3,2,335.24,4,2,4,10
1515915625610096870,2,1,298.76,4,1,4,9
1515915625610099160,3,3,317.61,4,3,4,11
1515915625610105445,3,3,312.39,4,3,4,11
1515915625610105932,3,1,11.46,4,1,1,6
1515915625610107587,3,1,30.83,4,1,1,6
1515915625610109918,3,6,261.9,4,4,3,11
1515915625610111386,3,2,1043.12,4,2,4,10
1515915625610113633,3,1,486.81,4,1,4,9
1515915625610114014,3,2,64.44,4,2,2,8
1515915625610114668,3,1,4.79,4,1,1,6
1515915625610114691,3,1,539.57,4,1,4,9
1515915625610115663,3,1,486.81,4,1,4,9
1515915625610120880,3,1,897.79,4,1,4,9
1515915625610120963,3,3,878.49,4,3,4,11
1515915625610125566,3,1,273.62,4,1,3,8
1515915625610126765,3,1,14.6,4,1,1,6
1515915625610133188,3,1,839.75,4,1,4,9
1515915625610135040,3,3,1455.58,4,3,4,11
1515915625610138022,3,1,600.6,4,1,4,9
1515915625610139888,3,1,251.4,4,1,3,8
1515915625610142581,2,2,937.02,4,2,4,10
1515915625610148643,3,4,409.96,4,3,4,11
1515915625610148677,3,1,102.49,4,1,3,8
1515915625610148808,3,1,19.37,4,1,1,6
1515915625610149387,3,2,76.2,4,2,2,8
1515915625610150476,3,1,33.08,4,1,2,7
1515915625610152683,3,1,20.16,4,1,1,6
1515915625610153928,3,3,1018.37,4,3,4,11
1515915625610156135,2,2,123.78,4,2,3,9
1515915625610164418,3,1,127.08,4,1,3,8
1515915625610171639,1,3,28.11,4,3,1,8
1515915625610176364,2,6,2032.52,4,4,4,12
1515915625610183359,1,1,22.92,4,1,1,6
1515915625610195710,2,1,205.25,4,1,3,8
1515915625610197477,2,1,94.0,4,1,3,8
1515915625610199488,2,2,281.72,4,2,3,9
1515915625610199746,2,1,10.57,4,1,1,6
1515915625610205504,2,1,15.87,4,1,1,6
1515915625610214316,2,1,486.81,4,1,4,9
1515915625610224305,2,1,77.73,4,1,2,7
1515915625610275663,2,2,356.44,4,2,4,10
1515915625610280019,2,1,397.48,4,1,4,9
1515915625610283673,2,1,167.62,4,1,3,8
1515915625610291774,2,2,913.02,4,2,4,10
1515915625610295457,2,1,294.41,4,1,4,9
1515915625610295477,2,1,51.43,4,1,2,7
1515915625610297107,2,1,121.19,4,1,3,8
1515915625610305418,2,1,572.57,4,1,4,9
1515915625610306316,2,3,346.20000000000005,4,3,4,11
1515915625610306561,2,1,137.63,4,1,3,8
1515915625610306822,2,1,215.06,4,1,3,8
1515915625610309817,2,1,140.86,4,1,3,8
1515915625610324322,2,2,412.38,4,2,4,10
1515915625610325447,2,2,798.96,4,2,4,10
1515915625610326064,2,1,49.38,4,1,2,7
1515915625610326366,2,1,418.48,4,1,4,9
1515915625610330250,2,1,44.13,4,1,2,7
1515915625610330349,2,1,139.44,4,1,3,8
1515915625610333418,2,6,617.62,4,4,4,12
1515915625610336582,2,1,42.98,4,1,2,7
1515915625610336618,2,2,721.12,4,2,4,10
1515915625610337419,2,1,284.46,4,1,3,8
1515915625610338517,2,2,55.24,4,2,2,8
1515915625610338578,2,1,45.24,4,1,2,7
1515915625610340810,2,3,28.049999999999997,4,3,1,8
1515915625610341446,2,1,9.35,4,1,1,6
1515915625610344131,2,1,82.97,4,1,2,7
1515915625610346815,2,1,294.41,4,1,4,9
1515915625610360117,2,1,672.63,4,1,4,9
1515915625610360407,2,2,118.12,4,2,3,9
1515915625610361939,1,1,579.59,4,1,4,9
1515915625610365251,2,2,281.72,4,2,3,9
1515915625610383707,2,1,36.59,4,1,2,7
1515915625610384217,2,2,1043.12,4,2,4,10
1515915625610390020,2,2,50.08,4,2,2,8
1515915625610391325,2,1,18.89,4,1,1,6
1515915625610391868,2,1,214.1,4,1,3,8
1515915625610393136,2,1,116.49,4,1,3,8
1515915625610393312,2,4,797.48,4,3,4,11
1515915625610393596,2,1,397.48,4,1,4,9
1515915625610393704,2,2,25.92,4,2,1,7
1515915625610394697,2,3,642.3,4,3,4,11
1515915625610394920,1,1,104.44,4,1,3,8
1515915625610395835,2,1,188.06,4,1,3,8
1515915625610399442,2,1,199.37,4,1,3,8
1515915625610400751,2,1,146.92,4,1,3,8
1515915625610401625,2,1,104.86,4,1,3,8
1515915625610402151,2,4,427.54,4,3,4,11
1515915625610402425,1,6,119.82,4,4,3,11
1515915625610403993,2,1,17.46,4,1,1,6
1515915625610405539,2,1,60.0,4,1,2,7
1515915625610408072,2,3,261.48,4,3,3,10
1515915625610410938,2,1,26.83,4,1,1,6
1515915625610410944,1,7,65.03,4,4,2,10
1515915625610412339,1,1,103.83,4,1,3,8
1515915625610421345,2,1,22.62,4,1,1,6
1515915625610421689,2,1,26.19,4,1,1,6
1515915625610424234,2,2,38.1,4,2,2,8
1515915625610443489,2,1,173.86,4,1,3,8
1515915625610445905,2,5,973.0,4,4,4,12
1515915625610446008,2,1,10.95,4,1,1,6
1515915625610446385,2,1,600.6,4,1,4,9
1515915625610448511,2,3,433.53,4,3,4,11
1515915625610452011,2,1,17.78,4,1,1,6
1515915625610452706,1,1,284.46,4,1,3,8
1515915625610455639,2,1,397.48,4,1,4,9
1515915625610460876,2,1,34.44,4,1,2,7
1515915625610461255,2,1,359.27,4,1,4,9
1515915625610462896,2,1,144.51,4,1,3,8
1515915625610464757,2,4,225.08,4,3,3,10
1515915625610471579,2,1,22.08,4,1,1,6
1515915625610476621,2,1,156.73,4,1,3,8
1515915625610477340,2,1,600.6,4,1,4,9
1515915625610483236,2,1,35.4,4,1,2,7
1515915625610486056,1,1,87.16,4,1,2,7
1515915625610487167,2,3,153.99,4,3,3,10
1515915625610490506,2,2,22.26,4,2,1,7
1515915625610499612,2,1,32.22,4,1,1,6
1515915625610503503,2,1,122.86,4,1,3,8
1515915625610504672,2,1,33.17,4,1,2,7
1515915625610510864,2,1,751.62,4,1,4,9
1515915625610513720,2,1,11.43,4,1,1,6
1515915625610525272,2,1,62.22,4,1,2,7
1515915625610532109,2,1,17.14,4,1,1,6
1515915625610532639,2,2,77.66,4,2,2,8
1515915625610534078,2,3,1087.79,4,3,4,11
1515915625610535145,2,1,28.68,4,1,1,6
1515915625610536797,2,1,38.83,4,1,2,7
1515915625610539935,2,1,259.38,4,1,3,8
1515915625610540242,2,1,86.03,4,1,2,7
1515915625610540376,2,1,214.1,4,1,3,8
1515915625610551148,2,2,528.8,4,2,4,10
1515915625610551182,2,2,301.3,4,2,4,10
1515915625610551946,2,1,28.89,4,1,1,6
1515915625610557317,2,1,486.81,4,1,4,9
1515915625610557414,1,1,418.48,4,1,4,9
1515915625610557677,2,2,18.7,4,2,1,7
1515915625610559276,2,1,68.73,4,1,2,7
1515915625610559457,2,1,38.83,4,1,2,7
1515915625610560866,2,2,428.2,4,2,4,10
1515915625610569116,2,1,183.49,4,1,3,8
1515915625610570448,1,1,609.6,4,1,4,9
1515915625610572386,2,3,626.29,4,3,4,11
1515915625610575526,2,1,38.44,4,1,2,7
1515915625610606458,1,2,1155.2,4,2,4,10
1515915625610615309,1,2,237.14,4,2,3,9
1515915625610713854,1,3,2285.12,4,3,4,11
1515915625610717408,1,2,711.31,4,2,4,10
1515915625610723370,1,2,58.44,4,2,2,8
1515915625610725765,1,1,53.21,4,1,2,7
1515915625610730132,1,1,143.97,4,1,3,8
1515915625610739518,1,1,35.87,4,1,2,7
1515915625610740123,1,1,9.95,4,1,1,6
1515915625610740427,1,1,37.3,4,1,2,7
1515915625610747952,1,1,9.35,4,1,1,6
1515915625610749318,1,1,29.22,4,1,1,6
1515915625610749484,1,3,1471.6200000000001,4,3,4,11
1515915625610750680,1,1,386.89,4,1,4,9
1515915625610760600,1,1,187.29,4,1,3,8
1515915625610761031,1,1,1.57,4,1,1,6
1515915625610768852,1,1,137.62,4,1,3,8
1515915625610771925,1,2,973.62,4,2,4,10
1515915625610773028,1,1,118.57,4,1,3,8
1515915625610773901,1,1,20.95,4,1,1,6
1515915625610775983,1,3,318.51,4,3,4,11
1515915625610778206,1,1,15.24,4,1,1,6
1515915625610782248,1,1,70.6,4,1,2,7
1515915625610784380,1,1,22.22,4,1,1,6
1515915625610787341,1,1,18.1,4,1,1,6
1515915625610787347,1,3,1606.9699999999998,4,3,4,11
1515915625610792170,1,2,186.34,4,2,3,9
1515915625610794275,1,1,12.4,4,1,1,6
1515915625610797356,1,1,80.03,4,1,2,7
1515915625610798706,1,1,26.98,4,1,1,6
1515915625610803323,1,1,614.6,4,1,4,9
1515915625610809913,1,1,609.6,4,1,4,9
1515915625610812312,1,1,13.63,4,1,1,6
1515915625610818607,1,1,21.11,4,1,1,6
1515915625610823630,1,1,30.95,4,1,1,6
1515915625610840656,1,1,64.48,4,1,2,7
1515915625610840996,1,1,26.17,4,1,1,6
1515915625610842399,1,1,60.83,4,1,2,7
1515915625610845519,1,1,32.22,4,1,1,6
1515915625610847452,1,1,215.41,4,1,3,8
1515915625610849515,1,1,228.62,4,1,3,8
1515915625610849842,1,1,167.0,4,1,3,8
1515915625610854927,1,1,64.48,4,1,2,7
1515915625610857612,1,5,2247.55,4,4,4,12
1515915625610861348,1,2,165.94,4,2,3,9
1515915625610862243,1,1,103.83,4,1,3,8
1515915625610863015,1,1,43.11,4,1,2,7
1515915625610864624,1,1,11.51,4,1,1,6
1515915625610867927,1,1,624.62,4,1,4,9
1515915625610872455,1,3,1399.56,4,3,4,11
1515915625610882281,1,8,233.76,4,4,3,11
1515915625610883014,1,1,397.48,4,1,4,9
1515915625610883795,1,1,29.22,4,1,1,6
1515915625610887728,1,2,524.73,4,2,4,10
1515915625610888200,1,3,502.86,4,3,4,11
1515915625610889141,1,1,43.17,4,1,2,7
1515915625610891524,1,1,397.48,4,1,4,9
1515915625610893077,1,1,12.56,4,1,1,6
1515915625610896690,1,1,38.83,4,1,2,7
1515915625610904971,1,1,490.54,4,1,4,9
1515915625610907256,1,1,352.68,4,1,4,9
1515915625610908229,1,1,57.13,4,1,2,7
1515915625610915291,1,1,65.71,4,1,2,7
1515915625610923010,1,2,831.08,4,2,4,10
1515915625610923167,1,1,80.03,4,1,2,7
1515915625610923552,1,1,53.4,4,1,2,7
1515915625610926750,1,2,18.74,4,2,1,7
1515915625610934783,1,1,397.48,4,1,4,9
1515915625610958274,1,1,72.83,4,1,2,7
1515915625610960936,1,1,38.83,4,1,2,7
1515915625610960950,1,1,136.35,4,1,3,8
1515915625610961094,1,1,15.08,4,1,1,6
1515915625610964009,1,1,19.27,4,1,1,6
1515915625610964122,1,1,292.83,4,1,4,9
1515915625610968056,1,1,51.43,4,1,2,7
1515915625610968614,1,2,453.68,4,2,4,10
1515915625610969212,1,1,292.83,4,1,4,9
1515915625610969297,1,1,187.29,4,1,3,8
1515915625610971402,1,1,75.89,4,1,2,7
1515915625610972689,1,1,38.83,4,1,2,7
1515915625610973155,1,4,268.0,4,3,3,10
1515915625610973497,1,1,12.22,4,1,1,6
1515915625610976222,1,3,1382.08,4,3,4,11
1515915625610977027,1,3,241.68,4,3,3,10
1515915625610986148,1,1,292.83,4,1,4,9
1515915625610986825,1,1,486.81,4,1,4,9
1515915625610987171,1,1,444.51,4,1,4,9
1515915625610991774,1,2,597.52,4,2,4,10
1515915625610995356,1,1,29.4,4,1,1,6
1515915625610997879,1,3,881.6500000000001,4,3,4,11
1515915625610999486,1,3,1444.6200000000001,4,3,4,11
1515915625611008742,1,1,38.83,4,1,2,7
1515915625611011782,1,1,15.08,4,1,1,6
